Months,CHN,SEA,EAS,USA,EUR,Total
0,-2000,-2100,-1200,400,-1200,-6100
1,-2800,-3700,0,-1000,0,-7500
2,-7600,1800,0,0,0,-5800
3,-2200,-5100,-1200,200,0,-8300
4,-5400,-3700,-900,0,0,-10000
5,-9400,2000,1000,-5800,0,-12200
6,6700,-2000,2800,-2600,-1200,3700
7,-2700,8900,0,0,0,6200
8,11900,-2300,0,-1000,-950,7650
9,-5800,0,0,-800,-2150,-8750
10,10500,7700,-1200,-4700,2900,15200
11,-6800,-600,0,-4700,750,-11350
12,5300,200,-1200,-800,0,3500
13,-2600,-2300,0,-2000,-950,-7850
14,8400,9800,-3000,20400,-11150,24450
15,-1000,-2300,4700,-10300,1700,-7200
16,7700,-600,0,-2000,11050,16150
17,-3000,-4300,0,-5900,2900,-10300
18,14100,7400,0,1200,-1200,21500
19,11100,-700,0,9000,0,19400
20,-2800,-2100,0,-1000,-950,-6850
21,6900,12200,0,12000,0,31100
22,-100,-3100,0,-5900,1950,-7150
23,10200,100,0,-2000,-950,7350
24,-100,9700,-1200,-3700,2900,7600
25,10200,200,100,7200,0,17700
26,-4200,100,2800,-3800,0,-5100
27,0,-800,0,10000,0,9200
28,6800,1100,0,8200,-10200,5900
29,-1600,0,0,200,-1200,-2600
30,-2000,-2100,0,-1000,12000,6900
31,-1900,-3000,0,-800,-1200,-6900
32,11000,-2300,-2400,-600,0,5700
33,-3700,10000,0,-1000,-950,4350
34,-5400,-1900,-1800,-1000,0,-10100
35,12600,-5400,4700,2700,750,15350
36,-1900,-2200,-1200,1400,-2150,-6050
37,9300,10600,0,-4900,2900,17900
38,-3700,-1300,-1200,-600,-1200,-8000
39,8700,100,0,22400,-12350,18850
40,-3500,9900,-1800,-1000,-950,2650
41,-4600,-2900,4700,-9500,13950,1650
42,-1900,-2900,-1200,-3700,1950,-7750
43,6100,900,0,-1000,-950,5050
44,-1000,9000,0,-3900,2900,7000
45,6000,1100,0,7100,1950,16150
46,-3200,-800,0,0,0,-4000
47,6000,100,0,-5800,-1200,-900
48,-1100,9900,-2400,1600,-1200,6800
49,7500,-2000,100,-2600,-1200,1800
50,-6200,-1800,2800,7400,-2150,50
51,6600,-2100,0,0,0,4500
52,-5900,-700,0,8100,1950,3450
53,16300,-9100,-1200,-800,-1900,3300
54,-7600,11400,-2100,8300,2900,12900
55,6800,-500,1900,-7700,1950,2450
56,-7900,-1800,1900,4600,-12350,-15550
57,12400,7600,-1200,-2700,2900,19000
58,-3500,-2200,-900,-1000,0,-7600
59,10100,-2200,1900,8200,12000,30000
60,-4600,9300,1900,-3800,0,2800
61,9500,-2300,0,-2000,0,5200
62,-1300,6800,0,-2000,0,3500
63,4100,500,0,-800,-1200,2600
64,600,7400,0,10000,0,18000
65,5200,200,0,-4000,-950,450
66,-400,-5200,-2400,1800,-2400,-8600
67,8700,0,0,8100,1950,18750
68,8200,9300,-3000,200,-1900,12800
69,-4600,-2200,4700,-10500,2900,-9700
70,5000,10000,-10200,6300,1950,13050
71,-2100,-5300,0,9200,-11150,-9350
72,5400,0,12000,-2900,2900,17400
73,-3500,9800,-10200,8200,0,4300
74,7500,-2100,-1200,1200,12000,17400
75,-3400,-800,-1800,-1000,0,-7000
76,9300,-2100,15500,-6400,0,16300
77,-4300,12100,-1200,1400,-1200,6800
78,7800,100,-2100,-800,0,5000
79,-400,-4600,1000,-4600,-1200,-9800
80,12000,-800,1600,9600,-1200,21200
81,-900,0,-900,-1000,0,-2800
82,12000,0,3800,-5600,-950,9250
83,-2700,12100,0,8200,-10200,7400
84,12500,-4600,0,-2900,1950,6950
85,8600,-1500,0,6300,-8250,5150
86,-7700,1200,0,0,12000,5500
87,-3300,12000,0,-1000,0,7700
88,7700,200,0,0,12000,19900
89,-6800,100,0,0,0,-6700
90,-4400,-2200,0,-1000,0,-7600
91,10100,-2100,-2400,400,0,6000
92,10100,-2300,0,-1000,0,6800
93,-1900,-2200,100,-2800,0,-6800
94,8200,-2700,2800,-5600,-1200,1500
95,-5100,-500,-1200,400,-1200,-7600
96,9900,7600,0,11000,0,28500
97,-2000,-3700,0,-1000,-950,-7650
98,2100,-5300,0,12200,-2150,6850
99,6000,-600,0,-2700,1700,4400
100,-1000,9800,0,-3900,1950,6850
101,6900,200,0,-1000,-950,5150
102,-6400,9400,0,0,-950,2050
103,6000,200,0,-5900,2900,3200
104,-5300,-2100,-10200,6300,1950,-9350
105,10100,8900,-1200,1200,0,19000
106,-9300,1200,10200,-1000,0,1100
107,10200,-3100,4700,-5600,0,6200
108,500,-5300,0,11000,0,6200
109,7500,10600,0,-4000,0,14100
110,-2100,-6000,-2400,3600,-1200,-8100
111,10800,-3700,-900,-1000,0,5200
112,-1900,8900,-200,-2600,-950,3250
113,10900,-2300,2800,-4800,-950,5650
114,-2900,9200,0,-2700,1700,5300
115,-2100,-4400,-1200,-4700,1950,-10450
116,11000,-3100,0,11000,0,18900
117,-800,11200,-1800,200,-1200,7600
118,8600,900,1900,-2600,-1200,7600
119,-2700,100,2800,8200,0,8400
120,7800,12100,0,-2000,-950,16950
121,500,-4500,0,-800,-2150,-6950
122,1200,-4600,0,8300,1700,6600
123,-1900,-3000,0,-2900,1950,-5850
124,11000,-3000,0,-1000,-950,6050
125,-2000,9800,0,-1000,-950,5850
126,-2800,-2100,0,7100,2900,5100
127,-4200,11300,0,-2700,750,5150
128,11000,-2300,-1200,-3800,0,3700
129,-3000,-1900,0,-1000,0,-5900
130,-5300,9200,0,10000,-950,12950
131,4400,300,0,-2700,750,2750
132,-7000,-2800,0,-5000,-950,-15750
133,-2000,7600,-1200,-2300,500,2600
134,11600,-4500,-1200,-800,0,5100
135,-4500,-2800,-900,-1000,-950,-10150
136,6700,300,1000,6200,0,14200
137,-1700,9700,1600,-6300,750,4050
138,11000,-2300,-3000,10200,-950,14950
139,-1900,9700,4700,-11500,1950,2950
140,6900,-1500,0,1200,-2150,4450
141,-5900,13000,0,7500,500,15100
142,8200,-2000,0,-6900,1950,1250
143,-6800,100,0,13400,-2400,4300
144,11000,-2300,0,-2000,-950,5750
145,-5800,-800,-10200,17300,1950,2450
146,4700,-1600,-1200,-2800,-950,-1850
147,-3600,9900,10200,-3900,1950,14550
148,10700,-4400,4700,-10300,750,1450
149,-2800,-3000,0,9200,-2150,1250
150,8200,-4200,-10200,7300,2900,4000
151,-7700,11300,0,-2000,-950,650
152,5300,-600,12000,-2000,-950,13750
153,-6300,-1200,-2400,-3500,2900,-10500
154,9400,9700,-2100,7300,1950,26250
155,-400,-4600,-200,-1400,-1200,-7800
156,7500,-2800,3800,-7600,0,900
157,300,-6900,1900,9200,0,4500
158,6700,9000,0,-1000,-950,13750
159,-1100,-5300,0,12000,-950,4650
160,10100,9700,0,-3900,2900,18800
161,-5300,-500,0,9100,1950,5250
162,11300,-6700,0,0,0,4600
163,-7800,9300,0,400,-2400,-500
164,10200,9700,0,12000,0,31900
165,-7000,400,0,-1000,0,-7600
166,5200,-600,0,1200,-2150,3650
167,-1300,7500,0,-1000,-950,4250
168,9300,-2100,0,-1700,1700,7200
169,-3100,6700,0,-2900,1950,2650
170,11600,-4600,0,-1000,-950,5050
171,-2600,-3100,0,0,0,-5700
172,6200,12000,-1200,-3700,1950,15250
173,-200,-2300,0,11200,-2150,6550
174,10200,12000,-2400,-2300,1700,19200
175,14200,-5400,-1800,0,0,7000
176,-2700,200,4700,-7600,0,-5400
177,9500,12100,-1200,1200,-950,20650
178,-3400,-700,1000,8200,-950,4150
179,7900,-3300,1900,-6700,2900,2700
180,-2000,-5300,-2400,-5500,1950,-13250
181,-2000,-4600,-2100,-600,-1200,-10500
182,8300,-2900,-1800,-1800,-1200,600
183,-4100,12100,5600,6400,0,20000
184,11200,-800,0,-2800,-1200,6400
185,-3500,12200,0,12000,-950,19750
186,10000,-2100,0,-1000,0,6900
187,-7600,300,0,-2900,1950,-8250
188,10800,6700,0,7100,1950,26550
189,-2700,-2200,0,-1800,-1200,-7900
190,11700,-2200,0,0,0,9500
191,-2900,-2800,0,9000,-950,2350
192,7400,9400,0,0,0,16800
193,5900,-1100,0,-2900,1950,3850
194,500,-4500,0,12000,-950,7050
195,-1300,-6100,0,-4900,2900,-9400
196,-4200,13000,0,200,-1200,7800
197,8500,-3100,0,-2000,0,3400
198,-2000,10000,0,0,0,8000
199,6900,100,0,-2000,0,5000
200,13100,-6800,0,11000,0,17300
201,-2000,9100,0,-800,-1200,5100
202,-2500,100,0,-800,-1200,-4400
203,7000,10600,0,-800,-2150,14650
204,-9500,1100,0,0,0,-8400
205,-3700,-4500,0,-5700,750,-13150
206,10100,9800,0,200,-3100,17000
207,-6700,-1400,0,8100,2900,2900
208,8400,-1300,0,-2700,-200,4200
209,-2900,9900,0,-2000,0,5000
210,9700,-4400,0,-2900,1950,4350
211,-2800,-2800,-1200,11200,-950,3450
212,7200,-4200,-1800,-4900,2900,-800
213,-2700,-2900,-5500,-1300,1950,-10450
214,4200,12300,0,1200,-1200,16500
215,1100,-6800,0,-3000,0,-8700
216,11100,-3100,12000,0,-950,19050
217,-2000,7500,0,11000,0,16500
218,9900,-5100,0,-4900,1950,1850
219,-3300,12000,0,-1000,-950,6750
220,-1800,-600,0,-3900,2900,-3400
221,10600,-4500,0,11000,0,17100
222,4300,12300,0,-1000,0,15600
223,-300,-5300,0,12000,0,6400
224,8400,9700,0,-1000,0,17100
225,-300,-5400,0,1200,-1200,-5700
226,7600,12000,0,-1000,0,18600
227,-5100,200,0,1400,-2400,-5900
228,10000,-4500,0,-800,-1200,3500
229,-5200,11300,-1200,1200,-950,5150
230,8700,100,0,200,-1200,7800
231,-4600,9800,0,-4900,1000,1300
232,5900,-2100,-1200,1200,-950,2850
233,-5900,200,-900,-3900,1950,-8550
234,7400,-2700,1000,-5700,2900,2900
235,200,-6800,1600,6500,1950,3450
236,10600,6800,0,-1000,0,16400
237,-1700,-2300,0,-1000,0,-5000
238,4400,-1500,-1200,12200,0,13900
239,-4300,6500,-900,-1000,0,300
240,6600,-2700,3800,-6600,0,1100
241,11500,5200,0,200,-1200,15700
242,-5900,-700,-1200,-2800,0,-10600
243,13300,-4500,-1200,200,-950,6850
244,-4500,9000,-3000,12400,-1200,12700
245,13000,-6800,4700,-10500,1950,2350
246,-1300,6800,0,0,-950,4550
247,4500,300,0,-4900,2900,2800
248,-1100,6700,-1200,12200,0,16600
249,1400,-3100,-1800,11000,0,7500
250,-3600,12400,3500,-7200,-1200,3900
251,8700,0,0,-3000,0,5700
252,-5900,12100,0,200,-1200,5200
253,10800,-4500,0,-1000,-950,4350
254,-5400,12400,-1200,11200,-950,16050
255,5300,-700,-2100,-2700,2900,2700
256,-7000,-2000,1000,-8700,1950,-14750
257,6000,12100,-7400,7400,0,18100
258,9000,-4500,0,-3000,0,1500
259,-3100,-4400,12000,-600,-2400,1500
260,-2800,-3700,0,-1000,0,-7500
261,10700,-3500,-1200,12200,0,18200
262,-3600,9100,-200,-3600,-950,750
263,11000,-4600,700,-6400,-2150,-1450
264,-7700,10700,-2100,-2700,1950,150
265,11600,-3700,-200,5500,2900,16100
266,-3700,10000,1000,-3800,-950,2550
267,6700,-2800,-5500,15800,-2150,12050
268,-2700,-3800,-1200,-2700,2900,-7500
269,1800,13300,0,-3900,1950,13150
270,-2800,-2200,12000,12000,0,19000
271,7000,200,0,-1000,0,6200
272,-4200,9700,-1200,400,-1200,3500
273,11900,-3100,-900,12000,0,19900
274,-5400,300,1000,-3800,0,-7900
275,7500,-2200,1600,-1600,-950,4350
276,-6600,12100,0,400,-3350,2550
277,12400,-4500,0,-4900,2900,5900
278,700,-3900,-1200,-1500,750,-5150
279,10000,-1400,-900,12000,-950,18750
280,-3400,200,-200,-3400,-2150,-8950
281,10900,9000,1600,-4300,1700,18900
282,-6900,400,-1800,-4900,1950,-11250
283,8400,-2200,3500,5800,-11150,4350
284,9300,9800,0,-3700,750,16150
285,-2800,-2200,0,0,12000,7000
286,9600,-800,0,7100,1950,17850
287,300,-4600,0,0,-950,-5250
288,6000,11400,0,-2000,-950,14450
289,-6300,-1900,-1200,9300,2900,2800
290,11700,7400,-1800,-3900,1950,15350
291,-300,-4500,4700,-5600,0,-5700
292,6900,-800,0,-3000,0,3100
293,-6400,-1700,0,1200,-1200,-8100
294,7500,-2700,0,11200,-1200,14800
295,-6800,11500,0,0,0,4700
296,6700,-1200,0,-600,-2400,2500
297,-5300,-2000,0,13200,-2150,3750
298,6900,12200,0,0,-950,18150
299,6900,-600,-1200,-2700,1950,4350
300,-7800,-500,0,-2900,1950,-9250
301,7700,10700,-1200,200,-950,16450
302,-1300,-4400,-900,-4900,2900,-8600
303,6800,-3100,-1400,-4300,1950,-50
304,300,-6800,1600,-2600,0,-7500
305,10800,-5300,-3000,10200,0,12700
306,200,4300,2900,-5600,0,1800
307,9300,-2200,4700,4400,0,16200
308,-2700,11400,0,200,-1200,7700
309,13100,-6900,0,-2000,0,4200
310,-1100,-2200,0,13200,-2150,7750
311,10100,9000,0,-1000,0,18100
312,-1600,-800,0,-5900,1950,-6350
313,10200,12100,0,0,0,22300
314,7800,-600,0,8100,1950,17250
315,-2900,10700,0,-3000,0,4800
316,-4900,0,0,-2000,0,-6900
317,-2000,-2800,0,-1000,0,-5800
318,7500,9900,0,12000,0,29400
319,-4600,-2700,0,-2000,0,-9300
320,8400,-1300,0,-1000,0,6100
321,200,5400,0,-1000,0,4600
322,10800,-5300,0,-3000,0,2500
323,-1000,-3000,0,0,0,-4000
324,8400,-2900,0,-1000,0,4500
325,-5400,10900,0,10000,0,15500
326,-1300,-6100,-1200,1400,-1200,-8400
327,4300,13000,0,8600,-12600,13300
328,-2700,-2900,-1200,200,-950,-7550
329,9300,9800,-2300,-2400,0,14400
330,-2700,-2300,2800,-2800,11050,6050
331,5300,-600,-1800,-3900,1950,950
332,-6800,12200,4700,-10500,1950,1550
333,8000,-4400,-1200,-800,-950,650
334,-4400,9900,-1200,7300,1950,13550
335,2700,200,-3000,7500,-7300,100
336,-5000,-700,700,-4600,0,-9600
337,10700,-4300,700,-3600,12000,15500
338,-1900,9000,-900,-3000,0,3200
339,8700,900,4700,6600,-1200,19700
340,7600,-600,-2400,-2600,0,2000
341,-3600,-2200,-2400,22800,-11400,3200
342,100,5400,-1800,0,0,3700
343,7000,200,2900,-5600,12000,16500
344,5300,-700,4700,-6600,-950,1750
345,1300,-4500,0,-1600,-3350,-8150
346,8500,12000,0,-2900,2900,20500
347,-200,-3900,0,7300,750,3950
348,8500,1100,-1200,-800,-950,6650
349,-2800,9900,-900,-800,-2150,3250
350,10200,-2200,1000,6300,2900,18200
351,-3000,-2800,2800,-6700,1000,-8700
352,5200,300,0,12000,-950,16550
353,-5000,12000,-11400,6500,2900,5000
354,4500,200,0,-3900,1950,2750
355,-3600,-2900,10800,200,0,4500
356,5600,-1800,0,-4000,0,-200
357,-4600,-1400,-2300,-200,-1200,-9700
358,9800,-5400,1900,-3600,-1200,1500
359,-5500,-1900,1000,9600,-2400,800
360,8600,9000,-7400,5400,0,15600
361,10800,-4600,-1200,-800,-950,3250
362,-3300,11300,0,-1000,-950,6050
363,8700,-800,12000,-2900,1950,18950
364,-1200,-4400,0,8100,1950,4450
365,7500,10700,0,-2000,-950,15250
366,-3600,-2900,0,-3900,2900,-7500
367,11600,-4400,0,-6700,750,1250
368,-5900,11300,0,-1000,0,4400
369,-5000,200,-1200,-600,-1200,-7800
370,12300,-4400,-2100,11400,-1200,16000
371,-2800,9000,1000,9400,-1200,15400
372,10100,-2300,2800,-3600,-2150,4850
373,5000,-2000,0,-2800,-2150,-1950
374,-5300,10000,0,-3900,1950,2750
375,-5300,-3000,0,-3900,1950,-10250
376,10100,-2200,0,10200,-3100,15000
377,-3300,12000,0,-3900,2900,7700
378,8200,-3000,0,-5900,1950,1250
379,-4400,-2200,-1200,9300,1950,3450
380,10200,9800,-2700,-800,-2150,14350
381,-4300,-1400,5600,-10300,1700,-8700
382,9800,-3400,0,12000,-950,17450
383,-5500,-2000,0,-2000,0,-9500
384,10800,7600,0,6300,-8250,16450
385,8400,-2900,0,10000,0,15500
386,-4200,200,-1200,-3300,11550,3050
387,9300,9000,0,-2800,-1200,14300
388,-100,-2300,-1200,1200,-950,-3350
389,8900,-4300,100,-4800,-950,-1050
390,1300,6600,2800,6500,1700,18900
391,12600,-2200,0,-4900,1000,6500
392,-2600,11400,-1200,200,-950,6850
393,7600,-2100,0,-4900,2900,3500
394,-1900,-2300,0,9300,750,5850
395,-3300,10500,-1200,600,-2400,4200
396,3200,1400,0,0,-950,3650
397,2800,5200,-1800,11000,0,17200
398,8400,-2200,4700,-9500,1000,2400
399,-1900,-3000,-1200,12200,-950,5150
400,6100,300,0,-4900,2900,4400
401,-4500,9000,0,-3900,1950,2550
402,-2800,-2100,-1200,12400,-2150,4150
403,-3600,-2200,-1200,-4500,1700,-9800
404,9300,-2100,-900,-1000,0,5300
405,1800,4400,3800,4400,-950,13450
406,8500,-2200,-1200,200,0,5300
407,9800,6900,-1800,-1000,-950,12950
408,-4600,-4400,4700,2500,2900,1100
409,-100,-3100,0,-4500,-450,-8150
410,8400,11300,-10200,9200,0,18700
411,-1200,-4400,0,-2000,0,-7600
412,9300,9800,12000,0,-950,30150
413,-3400,100,0,7100,1950,5750
414,-7700,11500,0,0,-950,2850
415,11600,-4500,0,5300,-7300,5100
416,-3300,12000,0,-1000,0,7700
417,9500,0,-10200,8200,12000,19500
418,-4500,100,0,0,0,-4400
419,11500,-4500,12000,-1000,0,18000
420,-3500,-2900,-1200,200,0,-7400
421,9800,-4200,0,-800,-1200,3600
422,-7600,-500,0,-2000,0,-10100
423,-4400,9900,0,0,0,5500
424,-400,-4600,0,200,-1200,-6000
425,9300,9000,-1200,200,0,17300
426,-4300,100,-900,-2000,0,-7100
427,8900,-5300,1000,-3800,-950,-150
428,-7700,12300,2800,-3800,-950,2650
429,8700,100,0,-5700,1700,4800
430,-3800,7600,-1200,-2700,1950,1850
431,13100,-7500,0,11000,0,16600
432,-4000,-4200,0,-1000,0,-9200
433,8300,-3600,0,-3000,0,1700
434,-2500,6200,-1200,13200,0,15700
435,10000,-5200,100,-5800,0,-900
436,-1700,8100,1600,-3600,0,4400
437,8800,-3400,-1200,1400,-1200,4400
438,500,-5400,0,19200,-10200,4100
439,13700,2100,-1100,-2600,-950,11150
440,3600,-6800,2800,-4800,0,-5200
441,9200,9100,-1200,-2700,13950,28350
442,-5100,-500,-1800,0,-950,-8350
443,-3700,9900,4700,2700,1700,15300
444,-5800,-700,-1200,200,0,-7500
445,-4500,-2200,0,10200,-10200,-6700
446,8400,9900,0,0,0,18300
447,-2000,-4400,0,0,12000,5600
448,7700,10600,0,0,0,18300
449,-2700,-1300,0,0,0,-4000
450,6500,-2100,0,0,0,4400
451,-4300,9000,0,200,-1200,3700
452,7300,-1800,0,-1000,0,4500
453,7400,9100,0,1200,-1200,16500
454,-6700,200,0,0,-950,-7450
455,6900,12000,0,-1000,-950,16950
456,-3600,-2100,0,-2700,1700,-6700
457,11700,7400,-1200,-3500,750,15150
458,-8400,400,-1800,-1000,-950,-11750
459,10900,8900,4700,-6400,-1200,16900
460,-2600,-3100,0,9300,750,4350
461,8400,9000,-1200,-800,-950,14450
462,-3500,-1400,0,-3900,1950,-6850
463,8400,11400,0,9100,1950,30850
464,-1000,-1400,-10200,8200,-950,-5350
465,7000,100,0,-3700,1700,5100
466,-2000,-2900,0,1400,-2400,-5900
467,7800,200,12000,-800,-1200,18000
468,-5100,12200,0,-1000,-950,5150
469,9500,100,-1200,10300,1950,20650
470,6400,-2000,-1800,0,-1900,700
471,-2900,-4600,4700,-8300,1700,-9400
472,-1800,-3100,0,-3700,750,-7850
473,8400,-2100,-11400,10400,-950,4350
474,6600,-2700,-1200,-4700,1950,-50
475,-1300,7700,-2100,200,-950,3550
476,12200,-7600,15800,-10500,2900,12800
477,500,6600,-1200,-3700,1950,4150
478,6800,200,-3300,11400,0,15100
479,-1200,-4500,-800,-3800,0,-10300
480,6800,12200,6300,-10200,0,15100
481,-3300,11300,-1200,21400,-10200,18000
482,9300,-2200,-1800,-1000,0,4300
483,-2600,100,4700,-8600,0,-6400
484,9100,9900,-1200,200,12000,30000
485,-4600,-2700,0,11000,0,3700
486,15600,-6800,0,-1000,0,7800
487,600,-5400,-1200,13200,0,7200
488,-4200,12100,-3000,200,0,5100
489,-3700,-2800,4700,-5600,0,-7400
490,-1200,6600,0,-2000,0,3400
491,-6000,200,-10200,9400,-1200,-7800
492,6800,5600,0,0,0,12400
493,-1800,-2200,0,-2000,-950,-6950
494,-5000,-600,12000,-1000,0,5400
495,5300,12100,0,-3900,1950,15450
496,-4800,0,0,-2000,-950,-7750
497,9500,12000,0,-4900,2900,19500
498,-1800,200,-10200,9200,0,-2600
499,8600,-700,12000,-1000,0,18900
500,-4300,1100,0,-2000,0,-5200
501,4300,400,0,11200,-1200,14700
502,-5900,100,-1200,-1800,0,-8800
503,7900,100,-2100,200,0,6100
504,-1100,-2200,1000,-3800,0,-6100
505,8400,-3000,2800,-4800,0,3400
506,-2300,-3500,0,0,0,-5800
507,8300,-5200,0,10000,0,13100
508,-5400,-1900,-2400,400,0,-9300
509,9600,11200,-3000,-1800,0,16000
510,11000,-2300,3800,-7600,0,4900
511,-3600,12200,700,-2400,-1200,5700
512,-1000,-3000,1900,-4800,0,-6900
513,7400,-2800,-1200,10200,-950,12650
514,11000,10600,-1800,-1000,-950,17850
515,-3300,0,4700,2500,2900,6800
516,11100,-700,0,-1000,-950,8450
517,-2900,-2100,-10200,17300,2900,5000
518,10800,7500,-1200,-800,0,16300
519,-4600,-2000,12000,-1000,0,4400
520,8500,-3000,0,-1000,0,4500
521,500,-4500,0,0,0,-4000
522,10900,8900,-1200,12200,0,30800
523,-3500,-600,-900,-1800,-1200,-8000
524,9800,8600,3800,-4400,-1200,16600
525,-5900,-500,0,-2000,0,-8400
526,-6200,-2100,-1200,-800,-950,-11250
527,-700,-7600,0,-1000,0,-9300
528,6600,9900,0,-3700,750,13550
529,-500,-5200,0,12200,-2150,4350
530,8400,-3000,0,-2700,1700,4400
531,-2800,9000,0,-1000,-950,4250
532,5700,-1000,-1200,200,-950,2750
533,-2700,9800,-900,9100,2900,18200
534,2800,-7700,3800,-8500,1950,-7650
535,7900,0,0,-2000,0,5900
536,-1100,6600,0,-2000,0,3500
537,4600,-4300,-1200,1200,0,300
538,-3000,6800,0,11000,0,14800
539,6700,-2000,0,0,0,4700
540,-3500,9000,0,-1000,0,4500
541,4500,100,0,-2000,0,2600
542,-2200,7600,0,0,0,5400
543,6700,-2900,-2400,12400,0,13800
544,-6900,12400,0,200,-1200,4500
545,7800,-2200,-1800,0,0,3800
546,-1300,-4500,1900,-3800,-950,-8650
547,11900,8100,700,-1600,0,19100
548,-3600,1100,1000,-7700,1950,-7250
549,7800,11300,1600,-1600,-950,18150
550,2700,-6800,0,-2900,2900,-4100
551,11200,12000,0,11000,0,34200
552,-4300,-600,0,-1000,0,-5900
553,10000,-2100,0,13200,-1200,19900
554,-2700,8900,0,0,0,6200
555,9500,100,0,0,0,9600
556,-6100,1100,0,0,0,-5000
557,10100,-2200,0,200,-1200,6900
558,2000,-7700,0,0,0,-5700
559,7400,-2900,0,-800,-1200,2500
560,-7200,-2000,0,-1000,-950,-11150
561,7000,12100,0,-800,-2150,16150
562,-2200,-4400,0,-3900,2900,-7600
563,-4000,-800,0,-3900,1000,-7700
564,10800,7500,0,0,-950,17350
565,-5100,200,0,-4700,1700,-7900
566,7600,8900,0,-4900,1950,13550
567,-4600,-2800,0,18200,-10200,600
568,5200,13000,-2400,400,0,16200
569,-5900,0,-1800,-2000,0,-9700
570,13100,-6800,4700,-7400,10800,14400
571,-1900,-3100,0,0,0,-5000
572,9500,100,0,11000,-950,19650
573,-1100,-3000,0,-2000,0,-6100
574,6000,12400,-1200,-3700,1950,15450
575,-2700,-2300,-1800,-3000,-950,-10750
576,9300,-2300,3500,1700,2900,15100
577,-4600,9100,-1200,200,0,3500
578,6000,200,100,-2800,0,3500
579,-2000,-4400,2800,18400,-10200,4600
580,9100,9800,0,-2000,0,16900
581,-300,-6100,0,-800,-1200,-8400
582,6600,-1200,0,-800,10800,15400
583,900,4500,0,12200,-1200,16400
584,7500,-2200,0,0,0,5300
585,12500,-5300,0,-1000,-950,5250
586,-2700,9800,0,0,-950,6150
587,-1000,-3000,0,-2900,2900,-4000
588,11900,8900,-1200,-3700,1950,17850
589,-1800,100,0,10400,-11400,-2700
590,-2700,100,-1200,200,0,-3600
591,11000,9000,0,-1000,11050,30050
592,-3600,-1300,-3000,400,-1200,-8700
593,-2700,9800,1900,-5500,750,4250
594,-1700,-700,2800,-3800,-950,-4350
595,-2300,-4200,0,-3900,2900,-7500
596,7000,12100,0,8200,-11150,16150
597,10300,-3100,-1200,-800,-950,4250
598,500,-2200,-1200,-3700,14900,8300
599,-1800,100,-3000,-2700,1950,-5450
600,9200,9900,2300,5800,0,27200
601,-5300,-2700,-3000,-800,0,-11800
602,200,-7500,3800,4600,-10200,-9100
603,-3600,-1300,3800,-6400,-1200,-8700
604,8500,9100,0,-2000,12000,27600
605,-1300,-4400,0,-1000,0,-6700
606,15800,-5400,0,10000,0,20400
607,-2700,10600,-1200,400,-1200,5900
608,7700,1000,0,12000,0,20700
609,-5200,10000,-1800,-2000,-950,50
610,500,-4600,4700,-4400,-2150,-5950
611,-2500,-800,0,-3900,2900,-4300
612,-3400,12100,0,-1000,-950,6750
613,7700,-600,0,-3900,2900,6100
614,-5100,12300,0,11200,-1200,17200
615,-5200,200,0,-1000,0,-6000
616,8200,-3600,0,12000,-950,15650
617,-4400,-2900,0,-1000,0,-8300
618,6700,-2100,-1200,-800,-950,1650
619,7900,0,0,-1700,1700,7900
620,-1100,9800,0,-3900,1950,6750
621,11500,-4400,0,0,0,7100
622,-2400,-800,0,11000,0,7800
623,9300,11300,0,0,0,20600
624,-2700,-1400,0,0,0,-4100
625,11400,-5300,0,0,0,6100
626,-2700,-2100,0,-800,-1200,-6800
627,11800,-2300,0,-2000,0,7500
628,-3300,11300,0,1200,-2150,7050
629,-3400,0,0,-1000,-950,-5350
630,-300,9800,0,-3900,2900,8500
631,8400,-2300,-10200,3500,750,150
632,-2500,-800,0,1200,-1200,-3300
633,12000,0,0,0,0,12000
634,-1800,0,12000,-1000,-950,8250
635,9500,12000,0,-1000,-950,19550
636,-2000,-2100,0,-2700,1700,-5100
637,-6000,300,0,-2900,1950,-6650
638,-4900,-800,0,-2000,-950,-8650
639,-1300,-3600,0,-2000,0,-6900
640,-3400,100,-10200,20500,750,7750
641,6900,-700,0,0,0,6200
642,-2800,-2200,0,-4700,750,-8950
643,6100,12100,9600,2400,0,30200
644,-1000,-2300,-900,0,-950,-5150
645,6800,200,3800,-5600,0,5200
646,8800,-4300,0,-3900,1950,2550
647,-2800,-2000,0,-1000,-950,-6750
648,8500,-2900,0,-2900,2900,5600
649,-4300,-3000,0,11000,0,3700
650,7500,9900,-10200,9600,-2400,14400
651,-3500,-2100,0,-800,-1200,-7600
652,13000,5200,12000,-1000,-950,28250
653,-3300,-700,0,-1000,0,-5000
654,11100,-800,0,-2900,1950,9350
655,-3500,300,0,0,-950,-4150
656,7500,10000,0,-3900,2900,16500
657,4200,-9100,0,200,-1200,-5900
658,-3600,9000,0,11000,0,16400
659,-1800,-2200,-1200,1200,-950,-4950
660,11200,11200,-1800,200,-1200,19600
661,-7000,400,3500,-8300,1950,-9450
662,-1900,9000,0,0,-950,6150
663,9900,-3500,0,-3900,2900,5400
664,-2100,-4400,-1200,-800,0,-8500
665,-2800,-3800,0,12000,0,5400
666,8900,-4400,-3000,-800,0,700
667,-2300,7600,4700,-6600,0,3400
668,7800,-3100,0,-2000,0,2700
669,-4400,9900,-3600,600,0,2500
670,-3600,-3000,-1800,-2000,0,-10400
671,-6000,200,3800,5600,-1200,2400
672,5300,12200,-200,-4400,-1200,11700
673,-5900,12200,400,-1200,-1200,4300
674,11000,-2200,1000,16400,-11150,15050
675,-4800,-5100,1900,-3600,-2150,-13750
676,11900,-2300,-1200,-4500,12750,16650
677,-2500,11200,-12300,5700,750,2850
678,8600,100,1000,-3800,-950,4950
679,-5200,100,2800,-8700,1950,-9050
680,10800,7500,10800,-2700,1950,28350
681,-3700,-2000,-900,7000,-950,-550
682,11000,-2300,-200,-6300,1700,3900
683,-5100,-700,2800,-6700,1950,-7750
684,8300,-2100,-2400,10400,-950,13250
685,-2700,9700,-2100,-1600,-2150,1150
686,10700,-4500,100,5500,1700,13500
687,-3600,-2900,4700,-9500,1950,-9350
688,10100,-2200,1900,7200,-950,16050
689,0,11200,-10200,10200,-950,10250
690,5800,400,-10200,4300,2900,3200
691,-3600,9900,12000,9100,1950,29350
692,11000,-2200,-1200,-2800,0,4800
693,-1000,-2300,12000,200,-1200,7700
694,9300,-3100,0,12000,0,18200
695,-1000,-2200,0,-3000,0,-6200
696,9300,12000,0,0,0,21300
697,-2800,-2900,0,11000,0,5300
698,11100,-2300,0,-1000,0,7800
699,-4600,10100,0,-1000,0,4500
700,-3300,-800,-1200,200,0,-5100
701,-3100,-4400,-900,0,0,-8400
702,9400,-2300,3800,-6600,0,4300
703,12700,8900,0,13200,-1200,33600
704,-4500,300,-1200,200,0,-5200
705,-1000,-2300,-1200,200,-950,-5250
706,7100,11300,-900,0,0,17500
707,-4300,1100,-200,-5500,1950,-6950
708,-3700,-2200,2800,-2800,-950,-6850
709,-5400,-2900,0,-4900,2900,-10300
710,10700,-4500,-1200,1200,0,6200
711,-2700,-2900,-1800,9200,-1200,600
712,7600,9800,2300,-4200,0,15500
713,-1300,7600,-900,-1000,0,4400
714,7800,-700,1000,8200,0,16300
715,-2800,-2200,2800,-2800,0,-5000
716,6600,-1900,0,-3000,0,1700
717,-2900,6800,-1200,400,-1200,1900
718,8400,-2100,0,12200,-1200,17300
719,-6800,-700,0,-1000,0,-8500
720,7900,12000,0,0,-950,18950
721,-3500,100,0,-2000,-950,-6350
722,6900,12300,0,-3900,2900,18200
723,-6900,-400,0,8100,1950,2750
724,9300,-1300,-1200,400,-1200,6000
725,-3800,-4500,0,-1000,0,-9300
726,7000,100,-900,-2000,-950,3250
727,-3600,-3700,1000,-2600,-2150,-11050
728,4200,1000,-7400,3700,1700,3200
729,-400,6800,0,-5900,1950,2450
730,8500,-2200,-11400,10400,0,5300
731,-7700,-600,12000,-2000,-950,750
732,6700,10700,0,-1800,-2150,13450
733,-2700,-2100,12000,-3900,2900,6200
734,9000,-4300,0,-2900,1950,3750
735,-300,-5400,0,12000,0,6300
736,10800,-3000,-10200,8200,0,5800
737,-4300,9800,-1200,-800,0,3500
738,10700,-1900,-900,0,0,7900
739,4300,10800,13000,-4800,0,23300
740,-5200,-1300,2800,-1600,-1200,-6500
741,11500,-4400,0,-1000,0,6100
742,-5200,9200,0,-2000,-950,1050
743,7300,-4600,-1200,1400,-1200,1700
744,-300,6600,0,9300,750,16350
745,7500,400,0,-4900,1950,4950
746,-6200,-3500,0,-2000,-950,-12650
747,6700,10800,-1200,200,0,16500
748,-4300,-3000,-2100,-800,-950,-11150
749,11700,-4500,1000,-5700,2900,5400
750,-1300,10000,2800,5300,1950,18750
751,9900,-5100,0,0,0,4800
752,-1300,7500,0,-1000,0,5200
753,9800,-4300,-1200,11200,0,15500
754,-3700,9200,-900,0,0,4600
755,12400,-6000,-500,-2200,-1200,2500
756,8400,10600,1000,6200,0,26200
757,2000,-7700,1000,-3800,0,-8500
758,4200,-500,2800,-4800,0,1700
759,-2600,9700,0,-2800,-1200,3100
760,10100,-2200,0,-2800,-1200,3900
761,-2100,6600,-2400,1600,-1200,2500
762,12500,-4600,-12300,21400,-950,16050
763,2300,8100,1000,-6700,1950,6650
764,10200,1000,14800,-3800,-950,21250
765,-2400,0,0,-5900,1950,-6350
766,0,12000,-1200,-3700,1950,9050
767,-4400,100,-900,11000,-950,4850
768,-3600,-2100,1000,-7700,2900,-9500
769,10200,9000,2800,-3800,0,18200
770,-1200,-2100,0,11000,0,7700
771,-8000,-2100,0,-3000,0,-13100
772,-6600,11300,-1200,13200,0,16700
773,9300,-2300,0,0,0,7000
774,700,9700,0,-2000,0,8400
775,10200,100,-1200,12200,0,21300
776,-2800,-2200,-3000,-800,0,-8800
777,6700,-2200,2300,-3200,0,3600
778,8400,-3000,-2100,-1800,0,1500
779,-1100,-2200,2600,-7400,0,-8100
780,10200,9000,-900,-1000,0,17300
781,-900,-800,1000,8200,0,7500
782,-5300,1000,2800,-4800,0,-6300
783,-100,9700,-1200,200,0,8600
784,8400,-2200,-1800,12000,0,16400
785,-5800,200,4700,-6600,0,-7500
786,10400,-1600,0,11000,0,19800
787,-6200,1100,-1200,-800,0,-7100
788,-6800,12200,0,-1000,0,4400
789,12700,-9000,0,0,0,3700
790,10100,-2300,0,12000,0,19800
791,-6700,-700,-1200,200,0,-8400
792,-4000,0,-900,0,0,-4900
793,8500,12100,1000,-3800,0,17800
794,-200,-2300,1600,-1600,0,-2500
795,10700,-5200,-1200,-1800,0,2500
796,-5000,200,-11100,10200,0,-5700
797,10900,-2200,3800,-7600,0,4900
798,-2700,11400,10800,1200,0,20700
799,8500,-2300,0,-1000,0,5200
800,2100,-4600,0,-1000,0,-3500
801,11800,9000,0,12000,0,32800
802,-2800,-2300,0,-2000,0,-7100
803,0,0,0,-2000,0,-2000
804,8600,12100,0,200,-1200,19700
805,600,-2300,0,0,0,-1700
806,-5900,-600,-1200,200,0,-7500
807,-1300,-4400,-900,-1000,0,-7600
808,-2800,-2200,2600,-6400,0,-8800
809,-4100,11300,0,200,-1200,6200
810,8500,200,0,-2000,0,6700
811,-3600,-2200,0,0,-950,-6750
812,8400,9800,0,11000,0,29200
813,-5200,300,0,-2900,1950,-5850
814,8500,-2200,0,12200,-2150,16350
815,-200,-2200,0,-3900,2900,-3400
816,9200,-2900,0,0,0,6300
817,-500,-5100,-1200,200,0,-6600
818,6000,12300,-1800,0,0,16500
819,-1000,-2200,4700,-6600,0,-5100
820,11600,-4500,-2400,1400,0,6100
821,-2800,9000,-900,-1000,0,4300
822,-1900,-3700,1000,-2800,0,-7400
823,10100,-1300,2800,-2800,0,8800
824,-4300,12200,0,11000,0,18900
825,-4200,-600,0,0,0,-4800
826,-5100,13100,0,-1000,0,7000
827,9300,-2300,0,12200,-1200,18000
828,-1100,-2300,0,0,0,-3400
829,6700,-400,0,-2000,0,4300
830,7900,100,-1200,200,-950,6050
831,-300,7400,0,-2000,-950,4150
832,-6100,500,0,-2700,1700,-6600
833,-5400,-1900,0,-4900,1950,-10250
834,4500,200,0,-1600,-2400,700
835,-3800,-5200,-2400,2600,-1200,-10000
836,7700,-2100,-1800,0,-950,2850
837,300,6800,4700,5400,-950,16250
838,8500,-2200,0,-2500,-450,3350
839,-1200,-2100,0,-2000,-950,-6250
840,9300,9100,-10200,5300,1950,15450
841,-1100,-2200,0,-5900,1950,-7250
842,6900,11200,10800,-1700,1950,29150
843,6500,-2000,-900,-800,-2150,650
844,-2100,-4500,1000,5300,2900,2600
845,11700,7400,2800,2500,-8250,16150
846,-200,-3100,0,-3000,12000,5700
847,10200,-700,-11400,10400,0,8500
848,-1900,-2200,0,-1000,0,-5100
849,8300,9900,0,-800,-1200,16200
850,-3000,-4200,10800,-1800,0,1800
851,-1200,6700,-1800,-2000,-950,750
852,-1200,-4500,4700,6600,-1200,4400
853,11900,-3100,0,-2900,1950,7850
854,-2700,10500,0,-1000,-950,5850
855,-1900,-1300,0,-4900,2900,-5200
856,11000,9800,0,10000,0,30800
857,-4400,-700,0,-800,-1200,-7100
858,-3600,10800,0,-1000,0,6200
859,11600,-5300,0,12000,-950,17350
860,400,-4500,0,-2000,0,-6100
861,-5100,-700,-1200,-1700,1950,-6750
862,-1900,9800,0,-4700,750,3950
863,10100,-3000,0,-2000,0,5100
864,-2800,-1400,0,0,0,-4200
865,9200,9200,0,-1000,0,17400
866,-2600,-2300,0,11000,0,6100
867,-2200,-4500,0,-2000,0,-8700
868,-4300,11400,0,12200,-1200,18100
869,6100,200,-2100,-800,0,3400
870,-5200,12300,1900,-2800,-950,5250
871,11600,-5300,700,-3600,0,3400
872,-1400,-4300,0,-3900,1950,-7650
873,6700,-2000,0,-5900,1950,750
874,-2600,9000,-2400,-600,0,3400
875,9700,-4300,-3000,12400,-1200,13600
876,-3400,-3800,3800,-7400,-1200,-12000
877,6700,10700,2600,4600,0,24600
878,-2800,-2000,-2400,1800,-2400,-7800
879,11000,8900,-2100,200,-950,17050
880,-900,100,-200,9400,0,8400
881,10600,-4400,3800,-8500,1000,2500
882,400,7500,1900,6200,-950,15050
883,11900,-3900,-1200,-3700,2900,6000
884,-2600,100,-2100,-2700,1950,-5350
885,-5200,12100,3800,-7600,-950,2150
886,-7500,200,-1200,9300,2900,3700
887,-5300,-2100,-1800,-3000,0,-12200
888,-5300,10000,3500,6600,0,14800
889,11000,-3000,-1200,200,0,7000
890,8600,100,-1800,11000,0,17900
891,-2600,-600,3500,-5400,0,-5100
892,5600,11100,0,12000,0,28700
893,-3600,-2000,-10200,8400,-1200,-8600
894,10000,-5300,0,0,0,4700
895,-7600,200,0,0,0,-7400
896,9000,-4300,12000,-1000,0,15700
897,-3500,9000,0,0,0,5500
898,11500,-4500,0,-4000,0,3000
899,-6200,9200,-1200,1800,-3600,0
900,6700,-2200,-1200,1200,0,4500
901,-1300,-4500,-1800,-1000,-950,-9550
902,10100,8900,4700,-6600,-950,16150
903,-8400,-4900,-1200,9300,1950,-3250
904,9400,9700,-900,-2900,1950,17250
905,1000,-6800,1000,-3800,-950,-9550
906,2500,11700,2800,-5700,2900,14200
907,-7600,-600,-1200,-3700,1950,-11150
908,7500,10000,-3600,10800,-1200,23500
909,-4400,-2100,-3000,1400,-1200,-9300
910,8200,-5900,2600,7800,-1200,11500
911,-6200,11600,1000,-4800,-950,650
912,9800,-5100,1000,7400,-11150,1950
913,4300,-10000,4700,-9500,2900,-7600
914,13000,4500,-10200,5300,1950,14550
915,-4400,-2200,0,-2000,12000,3400
916,11700,-5400,10800,9400,-10200,16300
917,-3300,12100,0,-800,-1200,6800
918,3500,-600,0,-1000,12000,13900
919,-1800,9700,0,200,-2150,5950
920,11700,-4600,0,-1800,-2150,3150
921,-3000,9200,0,-2700,1700,5200
922,11700,-5400,0,9100,1000,16400
923,10200,11300,0,-1000,0,20500
924,-6900,1200,0,-4900,1950,-8650
925,8500,9800,0,0,-950,17350
926,-1300,-5200,0,9100,2900,5500
927,8400,-2000,0,0,0,6400
928,-2100,7500,0,-1000,0,4400
929,10100,-2900,0,0,0,7200
930,-4400,12200,0,12000,0,19800
931,7500,-3600,0,-1000,0,2900
932,11500,-3600,0,0,0,7900
933,-2700,9800,0,0,0,7100
934,-7600,-400,0,0,0,-8000
935,7200,12000,-1200,-1800,0,16200
936,-1200,-2900,0,-2000,0,-6100
937,4300,13100,-1800,-2800,-1200,11600
938,-1900,-2200,4700,-4400,-1200,-5000
939,10100,-3100,0,-1000,0,6000
940,-3500,-2100,0,7200,-11150,-9550
941,9200,-2200,0,-1000,-950,5050
942,-1600,12000,0,-4500,500,6400
943,7600,-500,0,-5700,12750,14150
944,-5900,200,0,10200,-11150,-6650
945,10100,9800,-1200,-1600,-1200,15900
946,-1800,-2300,-1200,-600,9850,3950
947,10800,-2100,-2100,-4500,750,2850
948,-6000,-600,-200,-5500,1950,-10350
949,6900,300,100,9200,-1900,14600
950,-3600,9900,5600,-10500,1950,3350
951,11000,-2300,0,-3900,2900,7700
952,-3400,200,-11400,9400,-950,-6150
953,8300,-2000,0,9100,2900,18300
954,-5000,100,0,-3900,1950,-6850
955,9200,-2900,12000,-1000,0,17300
956,-400,-4400,0,20200,-10200,5200
957,8600,11200,0,-1000,0,18800
958,-1600,0,-1200,200,12000,9400
959,8400,12200,-3000,-600,-1200,15800
960,-7700,400,-5500,3800,-1200,-10200
961,4400,300,-1200,-800,0,2700
962,-800,-6700,0,-1000,-950,-9450
963,-2700,-2100,8100,1200,-950,3550
964,5200,-600,5600,-9500,2900,3600
965,-1300,-4400,-1200,-5700,1950,-10650
966,8400,9800,0,0,0,18200
967,-3700,-2800,-3000,10200,0,700
968,11000,9800,4700,-6600,0,18900
969,7600,-2100,0,1200,-1200,5500
970,-3200,-800,0,11000,0,7000
971,4400,100,0,0,-950,3550
972,-4700,7800,0,-1000,0,2100
973,-3600,-2100,0,9300,750,4350
974,13400,-5400,0,0,-950,7050
975,10200,100,0,-3700,1700,8300
976,-1300,6100,0,-3000,0,1800
977,11800,-8100,-1200,-3800,0,-1300
978,-4400,-2800,-3300,2800,-3350,-11050
979,7900,12000,1000,9200,-950,29150
980,-1100,-3000,-200,-6500,2900,-7900
981,-2600,12200,-6700,-100,1000,3800
982,6600,-2200,-900,-1000,-950,1550
983,-3700,-1900,1000,-8700,2900,-10400
984,9400,8900,14800,-4500,750,29350
985,-2100,-4500,0,11000,0,4400
986,-1900,9700,0,-1000,0,6800
987,9400,-700,-1200,12200,0,19700
988,-1300,-4500,0,0,0,-5800
989,8400,10000,0,0,0,18400
990,10900,-3800,0,12000,0,19100
991,-3600,-2100,0,-1000,0,-6700
992,-1900,9800,0,0,0,7900
993,-3000,7800,0,-1000,0,3800
994,-5900,-700,0,-1000,0,-7600
995,13400,-4600,0,-1000,0,7800
996,-1800,100,0,-800,-1200,-3700
997,12000,11200,0,-2000,0,21200
998,11100,0,-2400,-600,-950,7150
999,-5500,-2100,-1800,0,0,-9400
1000,-2600,9800,3500,1700,1950,14350
1001,1900,-6800,-900,-3000,-950,-9750
1002,-2700,-3000,1000,-6300,500,-10500
1003,11400,-4300,1600,-3600,0,5100
1004,-1200,6700,0,21400,-11400,15500
1005,-4500,-2000,0,-2000,-950,-9450
1006,-4600,-2600,0,-1000,11050,2850
1007,-6300,9100,0,-2900,2900,2800
1008,-4300,-2200,0,7100,1950,2550
1009,4400,12200,-1200,-1800,0,13600
1010,-7000,-2100,-900,0,0,-10000
1011,10300,-2300,1000,7200,0,16200
1012,-3700,9200,2800,-2800,0,5500
1013,9400,-2200,0,-2000,0,5200
1014,9500,-800,0,0,0,8700
1015,-4700,10100,0,12200,-1200,16400
1016,8600,-3100,-1200,-800,0,3500
1017,400,8300,0,0,0,8700
1018,9900,-3700,0,-2000,-950,3250
1019,-4500,-1300,-1200,-800,-950,-8750
1020,7900,100,-2100,-2700,2900,6100
1021,-4500,9000,1000,-6500,750,-250
1022,6000,100,1600,9400,0,17100
1023,5300,11300,-1800,-2000,0,12800
1024,-3800,-3700,-6700,4800,0,-9400
1025,9300,-2100,-1200,1200,0,7200
1026,-3700,-2900,11100,-1000,0,3500
1027,8600,0,1000,-2600,-1200,5800
1028,-3600,9000,2800,-2800,0,5400
1029,10200,-1400,0,9000,-950,16850
1030,-4300,-800,0,200,-1200,-6100
1031,-1700,100,0,-2900,1950,-2550
1032,14100,7400,0,12000,-950,32550
1033,-5200,-600,0,-3900,2900,-6800
1034,11100,-6400,0,-4000,0,700
1035,-1300,-4500,-2400,2400,0,-5800
1036,10600,4400,-900,-2000,0,12100
1037,-5000,0,1000,-3600,-1200,-8800
1038,14800,-7700,2800,9200,0,19100
1039,-1900,8900,0,-1000,-950,5050
1040,11500,-5300,0,-2000,0,4200
1041,-1000,9800,0,-3900,1950,6850
1042,4800,800,0,9100,1950,16650
1043,-3300,11300,-1200,-800,0,6000
1044,-600,-7500,0,0,0,-8100
1045,-2700,-1400,0,11000,0,6900
1046,7700,9000,0,0,0,16700
1047,-3600,-2300,-1200,200,0,-6900
1048,-900,9700,-1800,-2000,0,5000
1049,9000,-3000,4700,-7600,0,3100
1050,-4200,12200,-1200,-1800,0,5000
1051,3600,200,0,-800,-1200,1800
1052,400,7600,0,0,0,8000
1053,7400,-4300,0,9200,-1200,11100
1054,-4700,-3500,0,400,-2400,-10200
1055,11000,-1400,0,200,-2150,7650
1056,-6700,10500,0,-3000,0,800
1057,3400,1200,0,-2900,1950,3650
1058,-6000,300,0,-1000,-1900,-8600
1059,6000,11300,0,6100,2900,26300
1060,-7000,-1200,-10200,7300,1950,-9150
1061,8200,-4400,0,0,-950,2850
1062,-4300,-3000,12000,-4900,2900,2700
1063,6300,-700,0,-1000,0,4600
1064,-6000,12200,-1200,1200,0,6200
1065,10700,-6100,-1800,12000,0,14800
1066,-4800,9400,4700,-7400,-1200,700
1067,7600,-2800,0,-1000,0,3800
1068,-6300,-2000,0,-1000,0,-9300
1069,11000,9000,0,-1800,-2150,16050
1070,-4500,-2000,0,1200,-2150,-7450
1071,8600,-2300,0,9100,2900,18300
1072,8400,9900,0,-5900,1000,13400
1073,-2800,-3000,0,1200,-2150,-6750
1074,8600,200,0,-2900,2900,8800
1075,-400,-4500,0,8100,1950,5150
1076,10100,8200,0,0,0,18300
1077,-4200,900,0,-2000,0,-5300
1078,12000,12000,0,-2000,0,22000
1079,-900,0,0,-1000,0,-1900
1080,-2700,0,0,11000,0,8300
1081,10100,-2100,0,-800,-1200,6000
1082,-2800,-2900,-1200,400,-1200,-7700
1083,12500,-4600,0,-400,-4550,2950
1084,-4300,100,0,-1000,0,-5200
1085,10000,9100,0,-2900,1950,18150
1086,7400,-1900,0,-3000,-950,1550
1087,2900,5100,0,-4900,1950,5050
1088,11600,-5300,-1200,-1800,-1900,1400
1089,-1700,0,-3000,9700,500,5500
1090,5900,10600,4700,-9500,1950,13650
1091,-400,-3700,0,8100,1000,5000
1092,9300,9900,-10200,10200,-950,18250
1093,-3500,-3000,0,-4700,1700,-9500
1094,-900,0,12000,-3900,1950,9150
1095,7700,12200,0,12000,0,31900
1096,-1800,-2200,0,-5900,1950,-7950
1097,10200,-700,0,11400,-11400,9500
1098,-8600,-300,0,-1000,0,-9900
1099,8400,-1300,0,0,11050,18150
1100,-1300,7600,0,12000,-950,17350
1101,-3200,-800,-1200,-2700,2900,-5000
1102,4900,-2000,-900,-2700,750,50
1103,-4100,100,1900,-2800,0,-4900
1104,11800,9700,700,-2600,0,19600
1105,-900,-800,-1200,-800,0,-3700
1106,6800,200,0,-1000,0,6000
1107,-2200,-3600,-1800,12000,0,4400
1108,10600,-5300,3500,-5400,0,3400
1109,-2800,-2000,0,-1000,0,-5800
1110,6100,-500,0,-800,-1200,3600
1111,-300,7400,0,-1000,0,6100
1112,-2000,-4500,0,13200,-2150,4550
1113,10100,8900,0,-1000,0,18000
1114,-2900,-2200,0,-3900,1950,-7050
1115,5100,-500,-1200,-800,0,2600
1116,2000,5100,-1800,-4900,1950,2350
1117,11000,-3000,700,-1600,0,7100
1118,-2000,10000,2800,-5600,-1200,4000
1119,-6700,-700,-1200,200,0,-8400
1120,-6900,12400,-3300,400,0,2600
1121,8900,-7600,-200,8400,-950,8550
1122,-2000,8400,1000,-3800,-950,2650
1123,13200,-5300,-500,-5300,2900,5000
1124,-1800,-700,100,3300,1950,2850
1125,5200,12200,4400,-6200,-1200,14400
1126,-400,-4500,-1800,0,0,-6700
1127,10100,-2300,4700,5400,0,17900
1128,-200,9000,0,-3000,0,5800
1129,12300,7700,0,8000,0,28000
1130,-4400,-2900,-2400,1400,0,-8300
1131,-1300,-4300,-1800,-2000,0,-9400
1132,-4600,-2700,3500,6600,0,2800
1133,1800,5400,0,-1000,0,6200
1134,11000,-3000,-2100,21400,-10200,17100
1135,-3600,9800,1000,-2600,-1200,3400
1136,-5000,-700,1600,-3600,0,-7700
1137,5200,200,0,-1000,11050,15450
1138,-3600,9100,0,-1000,0,4500
1139,-2700,-1300,-1200,-1500,750,-5950
1140,10800,7500,-900,12200,-2150,27450
1141,8600,-1500,1000,-7700,2900,3300
1142,-3500,1000,2800,7600,-11400,-3500
1143,-6700,12100,-2400,400,-950,2450
1144,8700,100,0,-1000,11050,18850
1145,-1200,-2200,-900,-3900,2900,-5300
1146,10000,-2900,-1400,6700,1950,14350
1147,-4500,-2100,1600,-2600,0,-7600
1148,9300,-2200,-3000,-1800,0,2300
1149,-1800,9000,2900,-6600,0,3500
1150,9500,0,700,9600,-1200,18600
1151,-1200,9900,2800,-3600,-1200,6700
1152,8700,100,0,0,-950,7850
1153,500,-2200,0,-1000,0,-2700
1154,12700,-3100,0,5100,1950,16650
1155,-1700,100,0,11400,-12350,-2550
1156,-1700,12000,-2400,-2300,1700,7300
1157,-200,-2200,-1200,200,11050,7650
1158,12000,0,-1800,-3000,0,7200
1159,-2600,100,1700,-8300,1950,-7150
1160,-1800,-2200,4700,3400,-950,3150
1161,-2600,-700,0,-3700,1700,-5300
1162,-4600,-2100,-1200,200,0,-7700
1163,-1800,-2200,0,10000,-950,5050
1164,12700,9700,-3000,200,0,19600
1165,-2700,-600,4700,-10500,1950,-7150
1166,-2900,-2700,0,10400,-3350,1450
1167,5300,13100,-1200,-3700,2900,16400
1168,1200,-6800,0,-1000,-950,-7550
1169,300,-4500,-1800,11000,0,5000
1170,-4500,-2800,3500,-8300,1950,-10150
1171,12600,-5400,0,11000,-950,17250
1172,-2700,12100,-10200,6300,2900,8400
1173,500,-5400,0,-1800,-1200,-7900
1174,7400,-2000,12000,-1000,0,16400
1175,-300,7400,0,0,0,7100
1176,-1100,-4600,-2400,12400,0,4300
1177,-5200,13200,-1800,-1000,0,5200
1178,10600,-4400,3500,-4400,0,5300
1179,-400,7400,-1800,-1000,0,4200
1180,11900,-3100,-5500,4800,-1200,6900
1181,-4200,0,0,0,0,-4200
1182,-4100,12100,-1200,-1800,-950,4050
1183,-1800,100,9900,1200,0,9400
1184,-3700,9900,1000,-6700,1950,2450
1185,8900,-4400,2800,9200,-950,15550
1186,200,-7400,0,-2900,2900,-7200
1187,13200,-7600,0,7200,-10200,2600
1188,-200,9700,-1200,400,-1200,7500
1189,-2600,-700,0,-800,10800,6700
1190,400,6700,0,-3000,0,4100
1191,8700,100,0,0,0,8800
1192,600,9700,0,-1000,-950,8350
1193,-7700,-600,0,-2000,-950,-11250
1194,-3300,12000,0,10300,1700,20700
1195,12600,-2300,0,-3900,1950,8350
1196,-2700,12200,0,-1000,0,8500
1197,-4100,100,0,-1000,0,-5000
1198,4400,-700,0,0,0,3700
1199,-700,-5800,0,12000,0,5500
1200,11000,-2200,0,-1000,0,7800
1201,-3800,-2700,-1200,200,0,-7500
1202,9200,-3700,-900,0,0,4600
1203,-7500,13100,3800,-5600,0,3800
1204,-400,-5200,0,-1000,0,-6600
1205,5200,13100,0,-1000,0,17300
1206,-100,-3100,0,-1000,0,-4200
1207,6800,200,-1200,11200,0,17000
1208,9300,9800,0,-1800,-1200,16100
1209,-5200,200,0,2400,-2400,-5000
1210,7500,-2000,0,0,-950,4550
1211,1400,-4600,0,0,0,-3200
1212,9100,-2900,0,-2900,1950,5250
1213,-2400,-1600,0,0,-1900,-5900
1214,10300,12900,0,-3900,2900,22200
1215,-3700,-2100,0,-3900,1950,-7750
1216,14100,-4500,0,12000,0,21600
1217,-1900,8200,-1200,-2500,750,3350
1218,-4300,200,0,0,0,-4100
1219,-1900,-1400,-9200,6600,-1200,-7100
1220,-1800,9800,1900,-2800,0,7100
1221,7700,-700,0,0,-950,6050
1222,1500,-2300,12000,0,0,11200
1223,7700,300,0,-4900,1950,5050
1224,500,7500,0,-1000,-950,6050
1225,-2600,0,0,-2700,1700,-3600
1226,-2500,-700,0,-2000,0,-5200
1227,6800,300,0,-1000,0,6100
1228,-2200,7600,0,12000,0,17400
1229,-8900,-2400,0,-2000,0,-13300
1230,10100,-2200,0,0,0,7900
1231,-1200,-4600,0,-2000,0,-7800
1232,-3300,100,0,-2000,0,-5200
1233,2100,9500,0,13200,-1200,23600
1234,1400,-4600,0,200,-1200,-4200
1235,3500,12300,0,0,-950,14850
1236,-3800,-5200,0,-2000,-950,-11950
1237,9400,-2300,0,-2700,1700,6100
1238,-4300,9700,0,-4900,1950,2450
1239,6900,-600,-10200,10400,-2150,4350
1240,-5400,-2100,0,0,-950,-8450
1241,12600,6600,12000,-3900,2900,30200
1242,-5200,300,0,-3700,750,-7850
1243,6600,-2100,-2400,-600,0,1500
1244,-1100,6600,0,-4000,-950,550
1245,11000,-1400,-4200,10600,-10200,5800
1246,-4300,-1500,3500,-11300,1950,-11650
1247,9300,-1300,-3000,-600,9850,14250
1248,-2900,10000,-6400,900,1700,3300
1249,11800,-3100,-200,-5600,0,2900
1250,-2700,-2300,14800,7400,-11150,6050
1251,9300,12100,0,-3000,0,18400
1252,-3500,-3000,0,-5900,13950,1550
1253,12600,-2300,0,11000,-950,20350
1254,-5100,12100,0,-3900,2900,6000
1255,10100,-3000,0,-4000,0,3100
1256,-6400,-900,0,12200,-1200,3700
1257,12500,-5300,-1200,-1800,0,4200
1258,-2600,-2200,-1800,11000,0,4400
1259,8400,-3000,4700,-5600,0,4500
1260,-4300,12200,0,12000,0,19900
1261,-2300,-5000,0,-3000,0,-10300
1262,6600,10000,0,0,0,16600
1263,6000,400,0,12000,0,18400
1264,-6800,200,0,-1000,0,-7600
1265,-1200,7500,0,-1000,0,5300
1266,5900,-2100,-1200,-600,-1200,800
1267,600,-5400,0,-2000,0,-6800
1268,7800,-800,-1200,200,0,6000
1269,-5000,12100,-900,-1000,-950,4250
1270,9200,-2200,1000,-3600,-2150,2250
1271,-1100,9800,2800,4300,1950,17750
1272,8300,-1900,-1200,-4700,2900,3400
1273,5200,-500,0,0,0,4700
1274,-1800,-2200,0,-2000,0,-6000
1275,8400,9700,-1200,11400,-1200,27100
1276,-5100,100,0,1200,-1200,-5000
1277,10700,-5200,-1800,10000,-950,12750
1278,-5000,100,3500,-5400,0,-6800
1279,-5300,11500,0,-2900,1950,5250
1280,6000,1000,0,-1000,-950,5050
1281,5800,-2100,0,-2900,2900,3700
1282,-2200,-5200,0,11000,0,3600
1283,400,-4500,-1200,-800,0,-6100
1284,3500,11400,-1800,0,0,13100
1285,6200,100,3500,6600,0,16400
1286,-4300,-3100,0,0,0,-7400
1287,5000,10800,0,0,0,15800
1288,-4400,-2100,0,0,0,-6500
1289,11200,-7400,0,-1000,0,2800
1290,-6800,-500,0,0,0,-7300
1291,10800,6700,0,400,-2400,15500
1292,-5900,1000,0,-1000,0,-5900
1293,6100,11300,-1200,200,0,16400
1294,-1800,-2200,-3000,-800,-950,-8750
1295,10000,-3000,4700,-9600,-950,1150
1296,-6000,13200,0,-3900,1950,5250
1297,6500,-1900,0,-3700,1700,2600
1298,-7000,-1900,0,16400,-11400,-3900
1299,9300,-3000,-1200,600,-2400,3300
1300,-6600,100,-4200,400,-950,-11250
1301,8500,-2200,3800,-7600,11050,13550
1302,-6200,9100,3800,-11500,1950,-2850
1303,7600,-2300,0,-3900,1950,3350
1304,-2600,-2200,0,-3000,-950,-8750
1305,9300,11300,0,8100,1950,30650
1306,6900,300,0,3300,-7300,3200
1307,-2800,-2200,0,11200,-1200,5000
1308,7000,12100,0,-1800,10800,28100
1309,-1900,-2900,0,-4000,-950,-9750
1310,8400,-2100,-2400,13400,-950,16350
1311,-1100,-1400,-900,-4900,2900,-5400
1312,7700,-1400,1000,4300,1950,13550
1313,-4200,900,2800,-3800,0,-4300
1314,10100,9800,0,-2000,0,17900
1315,-2800,-2000,0,20200,-10200,5200
1316,9200,-3000,-1200,-800,0,4200
1317,-1600,0,0,-3000,0,-4600
1318,11700,-3100,0,0,12000,20600
1319,-8600,13200,0,-3800,-1200,-400
1320,11500,-4600,-1200,12200,0,17900
1321,3700,-7700,100,-2800,0,-6700
1322,11600,-4500,2800,-6800,-950,2150
1323,-2700,-600,0,1200,-2150,-4250
1324,11000,8900,0,-5900,2900,16900
1325,-1000,-2300,0,8100,1950,6750
1326,9800,10100,0,-2000,0,17900
1327,-1900,-3000,0,-1000,0,-5900
1328,6200,200,0,21400,-11400,16400
1329,-3300,12100,0,-2000,0,6800
1330,9900,-2100,0,0,12000,19800
1331,-3400,12200,-1200,8400,-11150,4850
1332,7600,-2200,0,-2000,-950,2450
1333,-5000,100,0,-3700,12750,4150
1334,9300,-3100,0,-3900,2900,5200
1335,-3400,200,0,-3000,0,-6200
1336,10800,9900,-1200,-600,-1200,17700
1337,8400,-2000,-1800,11000,0,15600
1338,-7700,100,4700,-6400,-2150,-11450
1339,9400,-3000,-2400,-600,0,3400
1340,-2000,-2100,-2100,-4700,1950,-8950
1341,8700,12100,1000,-2800,-950,18050
1342,-500,-4500,2800,4300,2900,5000
1343,10000,-2900,0,-1000,0,6100
1344,-2900,-2000,0,-2000,0,-6900
1345,10200,8900,0,11000,0,30100
1346,-5000,100,-1200,200,0,-5900
1347,6800,100,0,9000,0,15900
1348,-5800,11300,-1800,0,0,3700
1349,15400,-8300,4700,6400,0,18200
1350,-5300,-500,0,0,0,-5800
1351,6100,-600,0,-1000,0,4500
1352,-7100,-2100,0,0,0,-9200
1353,5300,12200,0,-2000,0,15500
1354,500,-5300,-1200,13400,-1200,6200
1355,-5200,10700,-1200,200,0,4500
1356,11400,-4400,-900,0,-950,5150
1357,8400,-2900,-200,-3600,-950,750
1358,1300,-5400,1600,-6500,2900,-6100
1359,10700,7700,-2100,200,-950,15550
1360,-2000,-2900,3800,-10500,2900,-8700
1361,9100,7700,0,0,0,16800
1362,-5000,-800,0,-1000,0,-6800
1363,1500,9700,0,11000,0,22200
1364,10200,0,0,0,0,10200
1365,-4200,200,0,12000,0,8000
1366,6900,12300,-1200,-800,0,17200
1367,-2800,-2200,-1200,200,0,-6000
1368,-1100,-2100,-2700,-1000,0,-6900
1369,11600,-5300,5600,-6200,-2400,3300
1370,-1400,-5200,0,-3000,0,-9600
1371,7400,10000,0,-2000,0,15400
1372,-4200,200,0,12000,-950,7050
1373,-1000,8900,0,-3000,-950,3950
1374,-2800,-2900,0,-3900,2900,-6700
1375,-5900,13100,0,-3900,1950,5250
1376,12500,-4600,0,10000,0,17900
1377,-400,-5300,0,-2000,0,-7700
1378,8400,-2200,0,-2000,0,4200
1379,-3600,-3000,-1200,11200,0,3400
1380,10700,7600,-1800,-1000,0,15500
1381,-1900,-3100,3500,-7400,0,-8900
1382,-5900,200,-1200,200,0,-6700
1383,10500,7000,-1800,-2000,0,13700
1384,-4500,-2200,4700,5400,0,3400
1385,8300,-2000,0,0,0,6300
1386,-3800,7600,0,9000,0,12800
1387,-1900,-3000,-2400,2800,-2400,-6900
1388,9200,9900,-900,11000,0,29200
1389,-2200,-5200,1900,-2800,-950,-9250
1390,9000,-4400,1900,-3800,0,2700
1391,-3300,11300,0,-3900,1950,6050
1392,-4400,-2100,0,9200,-10200,-7500
1393,-2800,9900,0,-2700,750,5150
1394,7000,-800,0,-1000,0,5200
1395,-6800,11400,-1200,200,12000,15600
1396,1700,1300,0,0,0,3000
1397,-3600,-2300,0,12000,0,6100
1398,10800,7400,0,0,0,18200
1399,-5400,-2000,0,0,0,-7400
1400,7500,-2800,0,-2000,0,2700
1401,-500,-4500,0,-800,-1200,-7000
1402,11500,6800,0,200,-1200,17300
1403,11500,-4500,-1200,1200,-950,6050
1404,-4900,11200,100,-3800,0,2600
1405,10000,-5300,1600,-5500,1950,2750
1406,-2700,-3000,0,-4900,1950,-8650
1407,8300,9800,-1200,8400,-10200,15100
1408,-5900,-600,0,0,0,-6500
1409,8600,6400,-1800,-1000,12000,24200
1410,-2700,-2200,4700,-5600,0,-5800
1411,9100,6700,0,11000,0,26800
1412,10200,-3900,0,200,-1200,5300
1413,-1600,5400,0,0,0,3800
1414,6000,300,0,-1800,-1200,3300
1415,-3400,-3100,0,-1000,-950,-8450
1416,3500,13000,0,-3900,1950,14550
1417,-1200,-5300,-1200,-800,0,-8500
1418,6700,10000,-10200,6500,750,13750
1419,400,-4500,0,-2000,0,-6100
1420,6000,11300,0,-800,-1200,15300
1421,-2600,-3000,12000,-1000,-950,4450
1422,7500,10800,-2400,-600,-950,14350
1423,-1100,-3800,-900,8100,2900,5200
1424,8900,-3500,1000,-5500,750,1650
1425,-1200,-4500,2800,-2800,0,-5700
1426,10100,8900,0,11000,-950,29050
1427,-4300,10600,-1200,400,-1200,4300
1428,9200,-1200,-900,-2900,1950,6150
1429,-1300,7600,3800,5600,-2150,13550
1430,10100,-2900,0,-1300,-700,5200
1431,-1300,-4400,0,-2800,-1200,-9700
1432,10100,9800,0,2400,-3350,18950
1433,5700,-3600,0,0,-950,1150
1434,-3900,-4200,0,9100,1000,2000
1435,-4900,0,-1200,-2700,2900,-5900
1436,7900,12000,0,-2900,1000,18000
1437,-6100,-400,0,-1800,-1200,-9500
1438,-5200,10700,-1200,-4500,-200,-400
1439,11600,-5200,-1800,10300,750,15650
1440,9100,-2100,1900,-3800,-950,4150
1441,-6800,-400,2800,-6700,1950,-9150
1442,6900,12100,0,-3700,750,16050
1443,-2800,-2200,0,-4000,-950,-9950
1444,11600,7400,-2400,9500,2900,29000
1445,-4400,-3000,-900,-2000,-1900,-12200
1446,10100,-2200,1900,3300,1950,15050
1447,-3600,-2200,700,-4300,1700,-7700
1448,8600,10400,0,-2000,-950,16050
1449,-3800,-3500,0,6100,2900,1700
1450,11000,9800,0,-5900,1950,16850
1451,-200,-3100,0,11000,0,7700
1452,10200,200,0,-1800,-1200,7400
1453,-1700,0,-1200,-800,0,-3700
1454,6800,12300,-900,10000,-950,27250
1455,-5400,-2000,-200,-2400,-2150,-12150
1456,9200,-2200,2800,3300,2900,16000
1457,-1900,-3000,0,-3700,750,-7850
1458,-3500,-2900,0,-800,-1200,-8400
1459,6100,12900,0,11000,0,30000
1460,-6800,300,0,9200,-11150,-8450
1461,-4400,-2200,-1200,12200,-950,3450
1462,10700,-5200,-1800,-3700,1700,1700
1463,-12900,700,3500,-7300,13950,-2050
1464,11600,7400,0,0,-950,18050
1465,3500,300,0,-2000,0,1800
1466,-3000,-5100,0,-3900,1950,-10050
1467,10100,-3100,-1200,13400,-2150,17050
1468,-1100,7500,-1800,-3900,2900,3600
1469,10500,-7500,3500,-8200,-1200,-2900
1470,-6000,100,-1200,12400,-1200,4100
1471,7600,9100,-1800,-1000,0,13900
1472,-2600,9700,3500,-6400,-950,3250
1473,10300,100,0,-4900,1950,7450
1474,6800,11300,-1200,12400,-2150,27150
1475,-4500,-1100,-1800,-3900,2900,-8400
1476,8400,-2900,3500,6800,-2150,13650
1477,-3500,-2300,0,-800,-1200,-7800
1478,10700,7500,0,-3900,1950,16250
1479,-10500,-500,0,11000,-1900,-1900
1480,13600,-8900,-11400,3500,2900,-300
1481,-5100,11200,-1800,-3500,-450,350
1482,11000,-2300,3500,-4000,-3350,4850
1483,-9400,-600,1800,7300,1950,1050
1484,6200,12100,0,-1800,-1200,15300
1485,9200,-2100,12000,-4900,1950,16150
1486,-2100,7500,0,0,-950,4450
1487,10800,-5400,0,7100,1950,14450
1488,-3600,-2100,0,7200,-11150,-9650
1489,7900,0,-1200,-3700,2900,5900
1490,-5100,-600,-900,-2700,12750,3450
1491,8500,9800,-200,-4600,0,13500
1492,-4500,-2100,2800,-3600,-2150,-9550
1493,10900,9800,0,10000,-950,29750
1494,-400,-5300,0,-2700,1700,-6700
1495,11500,-4300,0,5100,1950,14250
1496,-2800,-3000,-1200,400,-1200,-7800
1497,9100,9000,-1800,8200,-11150,13350
1498,-1200,-4500,3500,-9100,750,-10550
1499,8400,-2200,0,-800,9850,15250
1500,-6900,12500,0,-3700,1700,3600
1501,9800,-5300,0,-2000,-950,1550
1502,11700,7500,0,10000,-950,28250
1503,-1000,-2200,0,-3900,2900,-4200
1504,6900,11300,0,19300,-9200,28300
1505,-1000,-2200,0,-800,9850,5850
1506,6000,-700,-1200,-2700,2900,4300
1507,3600,4400,-900,-4900,1950,4150
1508,7600,1100,1000,-7800,0,1900
1509,-400,6600,1600,-400,-1200,6200
1510,10200,-2300,-2400,-1600,0,3900
1511,-900,11300,-12000,21200,-950,18650
1512,-3400,100,16700,-6400,-1200,5800
1513,-300,9900,0,-4700,750,5650
1514,11800,-2200,0,0,-950,8650
1515,-1800,-2300,0,7100,1950,4950
1516,-5100,-600,0,-800,-1200,-7700
1517,-5200,100,-1200,9300,1950,4950
1518,-2200,-4200,-2700,-3700,750,-12050
1519,7800,12100,5600,-8600,0,16900
1520,-5000,-700,0,1200,-1200,-5700
1521,13000,-5900,0,11200,-2150,16150
1522,-1900,-2900,-1200,-800,-950,-7750
1523,13900,-6700,0,10300,1700,19200
1524,-2600,-700,0,-3900,1000,-6200
1525,-2900,9300,0,0,-950,5450
1526,8600,-2200,0,-2900,2900,6400
1527,-1100,9000,0,9100,1950,18950
1528,-3000,-4400,0,0,0,-7400
1529,-400,7600,0,-2000,0,5200
1530,12600,-3100,0,1400,-2400,8500
1531,-1900,-2200,0,0,0,-4100
1532,10200,12200,0,12000,-950,33450
1533,-1900,-3100,0,-1000,0,-6000
1534,-1200,6700,0,-3700,750,2550
1535,-3800,-1100,0,-1000,-950,-6850
1536,-6200,9100,0,-3900,1950,950
1537,-5900,-600,0,-600,-3350,-10450
1538,10400,-5700,-1200,-1700,2900,4700
1539,1300,6700,-1800,-3700,-200,2300
1540,9200,-2800,4700,-11600,0,-500
1541,-5100,100,-1200,-1700,1950,-5950
1542,-1900,9900,0,10000,-950,17050
1543,7900,-800,-1200,-4700,2900,4100
1544,-4500,10000,-2100,10200,0,13600
1545,3600,200,-200,-5600,0,-2000
1546,-1800,9000,1600,9600,-1200,17200
1547,5200,1000,-1800,-1000,0,3400
1548,-1000,-2300,4700,5400,-950,5850
1549,7700,-1400,0,-800,-1200,4300
1550,-4500,-1300,-10200,8200,-950,-8750
1551,6600,10000,0,9100,2900,28600
1552,-5400,-2000,0,-3700,750,-10350
1553,4300,-500,12000,0,0,15800
1554,-3500,-2300,0,-1000,0,-6800
1555,13300,-4500,0,0,-950,7850
1556,-3500,9700,0,11000,-950,16250
1557,7900,-700,0,-2900,2900,7200
1558,-1000,-2300,0,-2900,1950,-4250
1559,12000,12000,0,0,0,24000
1560,-900,0,0,-3000,0,-3900
1561,8400,300,0,-1800,-1200,5700
1562,-1000,-2200,-3600,13800,-1200,5800
1563,7300,-1800,-1800,-1000,0,2700
1564,-4400,-3000,2900,-5600,0,-10100
1565,13300,-4600,4700,-6600,-950,5850
1566,-3300,11300,0,-800,-1200,6000
1567,11700,-4600,0,-7900,1950,1150
1568,-2700,11400,0,-1000,-950,6750
1569,11000,-2300,0,-3900,2900,7700
1570,-2600,-800,0,8000,0,4600
1571,-1800,9800,0,-1000,0,7000
1572,1700,1300,0,10000,0,13000
1573,-1500,-6800,0,-2000,0,-10300
1574,-1800,-3100,0,12000,0,7100
1575,5100,100,0,-2000,0,3200
1576,-1300,-5100,0,-2000,0,-8400
1577,4400,12200,-1200,12200,0,27600
1578,-2700,-2100,0,-2000,0,-6800
1579,10700,6600,0,-1000,0,16300
1580,-6000,300,0,-1000,0,-6700
1581,7700,-2300,-2400,-600,0,2400
1582,-2000,9800,0,1200,-1200,7800
1583,7700,-500,100,9200,0,16500
1584,-2000,-3000,2800,-2800,-950,-5950
1585,3500,13100,0,0,-950,15650
1586,-6800,200,0,-5900,2900,-9600
1587,11000,-2200,0,200,-2150,6850
1588,-400,-4600,0,10300,1700,7000
1589,3300,-2800,0,-2000,0,-1500
1590,1500,-9800,0,-1000,-950,-10250
1591,12200,5200,0,-800,-2150,14450
1592,-4200,-700,-1200,-2700,2900,-5900
1593,9200,9000,-900,-4900,1950,14350
1594,-7600,200,-200,-1600,0,-9200
1595,11600,-5400,2800,8200,0,17200
1596,-400,7500,0,0,0,7100
1597,6900,-800,0,-1000,0,5100
1598,-6200,10000,-1200,13200,0,15800
1599,9500,-2300,-900,-1000,0,5300
1600,-900,12000,1000,-2800,0,9300
1601,10200,100,2800,-2800,0,10300
1602,-2800,9900,0,-1800,-1200,4100
1603,7000,0,0,0,0,7000
1604,-4300,-600,0,-1000,-950,-6850
1605,6900,200,0,9000,0,16100
1606,-5300,9900,0,-500,-450,3650
1607,7600,-2000,0,-1000,-950,3650
1608,-4100,0,-1200,-2700,2900,-5100
1609,9900,-2200,0,0,-950,6750
1610,-5000,-800,-1200,12200,-950,4250
1611,7700,0,-900,-2900,1950,5850
1612,7800,200,3800,-9500,2900,5200
1613,-1900,9800,0,-1000,0,6900
1614,7800,200,0,-2000,0,6000
1615,-500,-4600,0,12000,0,6900
1616,11000,-2200,-1200,400,-1200,6800
1617,-1800,-800,0,12000,0,9400
1618,10100,-2200,0,-1000,0,6900
1619,-2000,9900,-1200,-800,0,5900
1620,9400,-3100,0,0,0,6300
1621,-3400,100,-1800,-1000,0,-6100
1622,-4400,12300,4700,-6400,-1200,5000
1623,12500,-4600,-1200,-800,0,5900
1624,-2600,200,0,200,-1200,-3400
1625,11000,-3000,0,0,-950,7050
1626,-2800,-2100,0,11000,-950,5150
1627,-1900,-2100,-1200,-3500,1700,-7000
1628,7800,12200,-900,-2900,1950,18150
1629,-6900,-600,1000,-4600,-1200,-12300
1630,-1000,-2200,2800,-4800,-950,-6150
1631,8300,9000,-11400,9400,-950,14350
1632,-4200,1000,0,-2900,2900,-3200
1633,9200,-2300,12000,-6900,1950,13950
1634,-4300,-3000,0,-800,-1200,-9300
1635,7800,100,0,-3000,0,4900
1636,-6200,-300,0,12200,-2150,3550
1637,6100,12900,0,-800,-2150,16050
1638,-4100,100,0,9100,2900,8000
1639,5200,-500,0,-5900,1950,750
1640,-7700,1100,0,-5000,-950,-12550
1641,11600,-6000,0,1200,-2150,4650
1642,-5100,1800,0,6300,1700,4700
1643,8500,-3800,-10200,7300,1950,3750
1644,-8500,1100,0,-1000,-950,-9350
1645,5600,10200,12000,-3000,0,24800
1646,-1800,-2300,0,-3700,750,-7050
1647,13300,-5400,0,-2700,750,5950
1648,-300,-4600,0,11000,0,6100
1649,11800,-3100,0,-3000,-950,4750
1650,-1900,9700,0,200,-2150,5850
1651,7700,-500,0,8100,2900,18200
1652,-2700,9800,-1200,-2800,-950,2150
1653,11800,-3000,-900,-2900,2900,7900
1654,8500,1000,-200,-4600,0,4700
1655,-2800,9800,-8600,18600,0,17000
1656,11000,-2300,-2100,-800,0,5800
1657,0,-800,13000,-4800,0,7400
1658,-1800,100,1600,-2600,0,-2700
1659,12400,7600,-2100,7400,-10200,15100
1660,-3300,0,700,-2600,0,-5200
1661,8500,-700,1900,-4800,0,4900
1662,-7500,100,-1800,-1000,12000,1800
1663,400,-6100,4700,14600,-10200,3400
1664,-5500,11800,0,200,-1200,5300
1665,4200,-2700,0,-2000,0,-500
1666,-500,-4300,0,0,11050,6250
1667,6000,-600,0,12000,0,17400
1668,-6700,11400,0,-3900,1950,2750
1669,8300,-1300,0,-2000,-950,4050
1670,-2600,9800,0,-3700,1700,5200
1671,10200,-2300,0,-800,-1200,5900
1672,-2700,-2900,-1200,-600,-1200,-8600
1673,5900,400,0,-800,-2150,3350
1674,8000,6900,-1200,12600,-2400,23900
1675,-5600,-3300,0,-4900,1950,-11850
1676,4900,-2800,-1800,-1000,-1900,-2600
1677,-4100,-800,4700,-9500,2900,-6800
1678,10300,5400,0,-2900,1000,13800
1679,-400,-5200,-10200,19200,0,3400
1680,-3500,-3000,0,-3900,1950,-8450
1681,6500,10000,-1200,-3700,1950,13550
1682,8500,-2200,9600,-200,-3350,12350
1683,-2900,7600,-900,-4900,2900,1800
1684,12200,-6700,3800,6600,-2150,13750
1685,-6200,9200,0,0,0,3000
1686,8700,-700,0,-5900,1950,4050
1687,-2000,-4600,-1200,13400,-2150,3450
1688,14000,4300,-1800,-3900,2900,15500
1689,600,-3100,1900,8200,0,7600
1690,7700,12200,2800,6400,-11150,17950
1691,2800,-6800,0,-1000,-950,-5950
1692,6700,11500,0,-2900,14900,30200
1693,-3000,-4400,0,-2900,1950,-8350
1694,-2700,-3000,0,11000,0,5300
1695,8600,9700,-2400,-1600,0,14300
1696,-2900,-2000,-900,-800,-1200,-7800
1697,-5100,10600,-200,-1600,0,3700
1698,8300,-1300,2800,-2800,0,7000
1699,600,7400,0,-3000,0,5000
1700,7600,-600,-10200,9200,0,6000
1701,-5000,-700,12000,-1000,0,5300
1702,6800,10700,0,-2000,0,15500
1703,700,-2300,-1200,-800,0,-3600
1704,10200,11200,-900,-2000,0,18500
1705,-1800,0,1000,-3600,-1200,-5600
1706,6900,12100,1600,7400,0,28000
1707,-4200,-600,-1200,-1800,0,-7800
1708,6200,100,-11100,9200,-950,3450
1709,-5900,1000,1000,-5800,-950,-10650
1710,-5300,400,1600,-5500,2900,-5900
1711,7500,-2200,12000,-4900,1950,14350
1712,-1800,-2200,-1200,200,0,-5000
1713,7000,0,-900,-1800,-1200,3100
1714,-4200,200,1000,9200,0,6200
1715,11800,-2300,1600,-3600,0,7500
1716,-4300,-700,0,11000,0,6000
1717,12600,-2200,0,1200,-1200,10400
1718,-2000,-2100,0,-1000,0,-5100
1719,8800,12000,-1200,13200,-950,31850
1720,-2700,-700,0,0,0,-3400
1721,10000,-1300,-1800,-2700,750,4950
1722,6100,200,4700,-5600,-950,4450
1723,-1900,-3000,-10200,5300,2900,-6900
1724,-1000,-2200,0,-4000,0,-7200
1725,6800,12000,-2400,2600,-1200,17800
1726,-2800,-2900,10200,0,0,4500
1727,5700,-2000,4700,5400,-950,12850
1728,-3900,-4200,0,-1800,-1200,-11100
1729,-6900,400,0,-3900,1950,-8450
1730,10800,6700,0,-3000,-950,13550
1731,-400,-4500,-1200,-2700,2900,-5900
1732,10900,-5400,0,12000,0,17500
1733,100,5500,-1200,-1800,0,2600
1734,7600,-3000,-900,-1000,0,2700
1735,-2700,9000,1000,9200,0,16500
1736,-6800,100,2800,-3800,0,-7700
1737,-3500,9800,0,-1000,0,5300
1738,9800,-4400,0,-1000,0,4400
1739,1100,4300,-1200,12400,-1200,15400
1740,3800,-2400,0,-1000,0,400
1741,-500,7400,0,-1000,-950,4950
1742,7500,-3000,0,-2000,0,2500
1743,5900,9000,0,-1700,750,13950
1744,-1900,-2200,0,9200,-11150,-6050
1745,-1300,7600,0,-2900,2900,6300
1746,9900,-5300,0,0,12000,16600
1747,-1900,-2100,0,-1000,0,-5000
1748,9200,6600,0,0,0,15800
1749,-2800,-2200,-1200,-800,0,-7000
1750,11600,-5300,-900,-800,-1200,3400
1751,-7000,10000,3800,-6400,-1200,-800
1752,9900,-6000,-1200,400,-2150,950
1753,-5900,12300,0,-1800,-1200,3400
1754,12100,-6800,-1200,-2700,1950,3350
1755,-2000,7500,0,11000,-1900,14600
1756,11500,-5200,-3000,-2700,2900,3500
1757,-3400,-600,4700,3500,1950,6150
1758,6900,12100,0,-1000,-950,17050
1759,-4500,-2000,0,-2900,2900,-6500
1760,6900,11400,0,11000,0,29300
1761,-8800,-1000,0,-1000,0,-10800
1762,-400,6600,0,1200,-1200,6200
1763,9300,-2200,0,12000,0,19100
1764,7000,12100,0,-1000,-950,17150
1765,-5300,-2700,0,0,-950,-8950
1766,8400,-3800,0,-3900,2900,3600
1767,-1500,6200,-2100,-1700,1950,2850
1768,7300,-4400,-3000,-800,0,-900
1769,-5800,100,5600,-6600,0,-6700
1770,15600,4300,0,-3000,0,16900
1771,-1800,-800,-1200,-400,-2400,-6600
1772,10300,11300,-900,-1000,0,19700
1773,6400,-2000,1900,9200,0,15500
1774,-4400,10700,1900,-3800,-950,3450
1775,-300,-4500,-1200,200,-950,-6750
1776,7500,-3800,0,7100,2900,13700
1777,-2700,10600,0,-2700,750,5950
1778,700,-400,-1200,6400,-10200,-4700
1779,10100,9800,-1200,200,0,18900
1780,-3000,-4400,100,-2800,12000,1900
1781,-5000,11200,2800,-3800,0,5200
1782,8400,-2000,0,12200,-1200,17400
1783,8500,-2200,-1200,-800,0,4300
1784,-6100,9200,-900,-1000,-950,250
1785,11600,-4500,1900,-5800,-950,2250
1786,-6800,12400,700,-4500,2900,4700
1787,8200,-5200,0,7100,1950,12050
1788,1300,-4600,0,200,-1200,-4300
1789,8300,9200,0,0,0,17500
1790,-5100,-600,0,12000,0,6300
1791,7500,10800,0,-1000,0,17300
1792,-700,-6600,0,-1000,0,-8300
1793,12100,-8200,0,-1000,0,2900
1794,-6800,200,0,-3000,0,-9600
1795,7800,11200,0,-1000,0,18000
1796,-4500,-2700,0,1200,-1200,-7200
1797,8900,-4200,0,12000,0,16700
1798,-5900,13000,0,-2000,-950,4150
1799,6600,-2800,-1200,400,-1200,1800
1800,-4500,10000,-900,-2900,1950,3650
1801,-7100,-1900,1000,-6700,1950,-12750
1802,7700,9900,2800,-3800,0,16600
1803,-400,-5400,0,-2000,0,-7800
1804,7800,0,-1200,11400,-10200,7800
1805,-4800,11200,0,12200,-1200,17400
1806,10200,-3100,-1200,200,12000,18100
1807,-4600,10900,-900,-1000,-950,3450
1808,5300,100,-4200,-1600,0,-400
1809,-4100,0,5600,-8500,1950,-5050
1810,13200,-4500,-2100,200,-950,5850
1811,-2000,-3700,1000,-7700,2900,-9500
1812,6600,-1100,2800,-3800,0,4500
1813,12600,7400,0,9000,0,29000
1814,-900,-800,0,-1000,0,-2700
1815,8500,-800,0,10000,0,17700
1816,-4500,10800,0,-1800,-1200,3300
1817,4400,-2200,0,0,0,2200
1818,-4400,-400,0,-1000,0,-5800
1819,7800,12100,0,11000,0,30900
1820,700,-2300,0,200,-1200,-2600
1821,7600,200,0,-2000,0,5800
1822,-2400,0,0,-2800,-1200,-6400
1823,9300,200,-2400,400,-950,6550
1824,400,-4400,-1800,-1000,-950,-7750
1825,6900,-600,4700,3500,2900,17400
1826,-100,-2300,0,-4900,1950,-5350
1827,9300,0,0,-3000,0,6300
1828,-2800,9800,0,1200,-1200,7000
1829,8400,-2300,-1200,9200,0,14100
1830,-2600,-3800,-1200,-800,-950,-9350
1831,6600,-1200,-2100,12200,0,15500
1832,-2100,6600,2000,-10500,1950,-2050
1833,6000,-500,-500,-3400,-950,650
1834,-4300,1100,-8300,2500,2900,-6100
1835,5300,11400,2600,-5400,0,13900
1836,-2200,-3500,0,-1000,0,-6700
1837,7100,-700,12000,-1000,0,17400
1838,300,-4500,0,11000,0,6800
1839,6900,12300,0,-1000,0,18200
1840,-5900,-800,0,11000,0,4300
1841,9800,-4300,0,0,0,5500
1842,-5200,9900,0,11000,0,15700
1843,12400,-5300,-1200,200,0,6100
1844,12600,-2300,-1800,1200,-1200,8500
1845,-5100,11300,1900,-2800,0,5300
1846,10400,0,2800,-2600,-1200,9400
1847,-800,0,0,0,0,-800
1848,8500,12100,0,-1000,0,19600
1849,-3800,-2000,-1200,200,-950,-7750
1850,13300,-4600,0,12000,-950,19750
1851,-4100,100,-1200,-2700,2900,-5000
1852,-2500,-800,0,-3900,1950,-5250
1853,-3400,100,-1100,-2600,0,-7000
1854,-3700,9800,2800,-1600,-1200,6100
1855,8700,0,0,-1000,0,7700
1856,15800,-4600,0,-1000,0,10200
1857,-3600,-1400,-1200,200,0,-6000
1858,3300,1300,-1800,12000,0,14800
1859,1400,7400,4700,-6600,0,6900
1860,-5300,-2100,0,-1000,0,-8400
1861,-5200,-2100,0,-1000,0,-8300
1862,1200,-7600,0,0,0,-6400
1863,8400,-2100,0,11000,0,17300
1864,-3400,11400,-1200,-800,0,6000
1865,7800,100,0,-1000,0,6900
1866,-2700,12100,-1200,200,0,8400
1867,9300,-2200,-900,0,0,6200
1868,-3600,-2200,1000,-3800,0,-8600
1869,2600,-400,1600,-1600,0,2200
1870,-1200,-5300,0,-1000,0,-7500
1871,8400,10600,-10200,9200,0,18000
1872,-2500,-800,0,1400,-2400,-4300
1873,10200,0,10800,200,0,21200
1874,1300,7400,-2100,200,-950,5850
1875,12000,0,-200,-2600,-950,8250
1876,-900,-700,1900,-5700,2900,-2500
1877,6800,300,-200,-6500,1950,2350
1878,-2000,7400,2800,-2800,0,5400
1879,-2700,-2100,-1200,-600,-1200,-7800
1880,-6100,-500,-900,12000,0,4500
1881,400,-4400,-200,-2600,0,-6800
1882,13000,4500,2800,9800,-4550,25550
1883,-6800,300,0,-1000,-950,-8450
1884,10300,-2300,0,-2900,2900,8000
1885,-5200,11300,-1200,8300,1000,14200
1886,-3400,100,-2100,1200,-950,-5150
1887,8400,-2300,1900,-5700,2900,5200
1888,-1900,9900,1900,-7700,1950,4150
1889,9200,-3800,-1200,1200,0,5400
1890,-4500,-2000,-900,-1000,0,-8400
1891,5100,1100,1000,9200,0,16400
1892,-6700,12200,2800,-4800,0,3500
1893,5900,-2200,0,13400,-2400,14700
1894,-2900,-1900,0,0,0,-4800
1895,7700,-3000,0,-3000,-950,750
1896,-4900,0,0,200,-2150,-6850
1897,10600,-4300,0,-3900,2900,5300
1898,400,7600,0,-4700,-200,3100
1899,4300,-500,-1200,11600,-11400,2800
1900,-3600,-2100,0,-4900,1950,-8650
1901,10200,8900,0,-1700,11800,29200
1902,-4500,-1900,0,200,-1200,-7400
1903,9300,-2300,0,8100,1950,17050
1904,-500,7600,0,200,-3100,4200
1905,6200,-1400,0,-4500,500,800
1906,-5500,-1900,-10200,7500,750,-9350
1907,8600,9000,0,0,-950,16650
1908,-2900,-1200,12000,-3900,1950,5950
1909,7700,12200,0,0,-950,18950
1910,1300,-5400,0,-5900,1950,-8050
1911,9300,-2200,0,-4900,1950,4150
1912,11500,-5200,-1200,12200,-950,16350
1913,-3700,-1100,-1800,-5900,2900,-9600
1914,6100,10500,4700,-9300,750,12750
1915,-4500,-2100,0,-1800,-1200,-9600
1916,12400,-3600,-1200,11200,0,18800
1917,-3900,6600,0,-3000,-950,-1250
1918,3400,-500,-11400,21400,0,12900
1919,12300,5300,-3000,-4700,1950,11850
1920,-2600,-3900,16700,-5200,-3350,1650
1921,-5100,900,0,-3700,1700,-6200
1922,8300,9900,-1200,-600,-2150,14250
1923,-3700,-3100,-900,8200,-2150,-1650
1924,7400,7600,3800,-7300,750,12250
1925,-5100,300,0,-4900,1950,-7750
1926,8500,-3800,-11400,23600,-1200,15700
1927,-400,8300,-1200,-3700,1000,4000
1928,10800,-2000,11100,-2000,-950,16950
1929,9200,9000,1000,5300,2900,27400
1930,-1700,-3100,2800,-7500,750,-8750
1931,-1200,-1200,0,200,-2150,-4350
1932,6100,11300,-1200,-4700,1950,13450
1933,-4400,-3000,0,12000,-950,3650
1934,8300,10800,-1200,-5700,1950,14150
1935,-4100,-700,0,9100,2900,7200
1936,9200,-2300,-3000,-1800,0,2100
1937,1200,-4400,3500,-6400,0,-6100
1938,-500,7500,-900,11000,0,17100
1939,6000,-700,1000,-4800,0,1500
1940,9400,-2300,1600,8400,0,17100
1941,-3500,12200,-1200,2400,-1200,8700
1942,-1900,-3100,-1800,12200,-1200,4200
1943,6000,200,4700,-5600,0,5300
1944,1100,5300,-1200,200,-950,4450
1945,10200,-2300,0,-1000,-950,5950
1946,-1800,-700,0,-3900,2900,-3500
1947,8600,-700,0,7100,1950,16950
1948,-5100,13000,-1200,1600,-2400,5900
1949,-3100,-4400,-900,-3000,0,-11400
1950,-5300,-2800,-200,-2600,-950,-11850
1951,8800,0,2800,-3800,0,7800
1952,-2800,-2100,0,10000,-950,4150
1953,-5900,12100,0,-3900,1950,4250
1954,7700,-600,0,-4900,2900,5100
1955,-4500,-2800,0,12000,0,4700
1956,4900,10900,0,-2000,0,13800
1957,-4400,-2100,0,-1000,0,-7500
1958,9300,-2100,0,11000,0,18200
1959,-1300,-5300,0,-2000,0,-8600
1960,11700,-5300,-1200,200,0,5400
1961,8300,9200,-900,-1800,-1200,13600
1962,-5800,200,1000,-2400,-2400,-9400
1963,-5200,0,1600,-1600,-950,-6150
1964,7600,9800,0,11000,0,28400
1965,9200,-2100,0,-3900,1950,5150
1966,-6000,11300,0,0,-1900,3400
1967,3300,1400,0,9100,2900,16700
1968,-3600,-2200,-1200,-2700,1950,-7750
1969,10900,-5400,-1800,0,-950,2750
1970,-1300,-4400,4700,-10500,2900,-8600
1971,4400,-600,0,0,0,3800
1972,-4100,12100,0,-1000,0,7000
1973,8400,-2200,0,11000,0,17200
1974,11000,-2300,0,-1000,0,7700
1975,-4400,10700,0,11000,0,17300
1976,-7700,1100,0,-1000,0,-7600
1977,7500,-2100,0,0,0,5400
1978,-4000,12000,0,-1000,0,7000
1979,7900,0,0,-1000,0,6900
1980,-900,100,0,0,0,-800
1981,5000,400,0,0,0,5400
1982,-1800,-2200,0,-1800,-1200,-7000
1983,7500,-2200,-1200,-800,0,3300
1984,-3800,-5100,0,0,0,-8900
1985,11600,-4600,0,-2800,-1200,3000
1986,-600,-5200,0,10200,-10200,-5800
1987,7400,9900,0,-1000,-950,15350
1988,-4800,-5100,0,-2000,12000,100
1989,10200,8900,0,-2900,1950,18150
1990,-6200,-2000,0,-1000,-950,-10150
1991,11700,-4500,0,-4900,2900,5200
1992,-8400,12200,-1200,-800,0,1800
1993,9300,-3000,0,0,0,6300
1994,9200,9800,-1800,10400,-2400,25200
1995,-2700,-3000,1900,-3800,0,-7600
1996,-3700,9900,2800,10400,-1200,18200
1997,9900,-4500,0,-1000,-950,3450
1998,7000,-800,0,0,-950,5250
1999,-2000,9700,0,-2900,2900,7700
2000,8400,-2200,-1200,9300,1950,16250
2001,-200,8900,0,0,0,8700
2002,12000,0,0,0,0,12000
2003,-5400,400,0,-3000,0,-8000
2004,7900,12100,-1200,1400,-1200,19000
2005,2800,-6900,-900,0,0,-5000
2006,9200,-2100,1000,-3800,-950,3350
2007,-5200,-600,2800,-2400,-2400,-7800
2008,9400,-2200,-10200,6300,1950,5250
2009,-100,9700,-1200,-1600,-2150,4650
2010,11100,-800,-1200,-5700,1950,5350
2011,-900,0,12000,9200,-11150,9150
2012,8400,-500,-1800,-2900,2900,6100
2013,-1900,10600,4700,-11500,13950,15850
2014,12500,-4600,-1200,1200,0,7900
2015,-2600,-3000,0,-2000,0,-7600
2016,1400,-3100,-1200,11200,0,8300
2017,-3600,12200,0,0,0,8600
2018,9400,-2200,-900,12000,0,18300
2019,-5900,12000,3800,-6600,0,3300
2020,-4200,0,0,0,0,-4200
2021,8500,200,0,-3000,0,5700
2022,-2600,-2200,0,200,-1200,-5800
2023,11100,0,0,11000,0,22100
2024,-1700,0,0,-800,-2150,-4650
2025,-2500,0,0,-2000,0,-4500
2026,11100,0,-1200,-3500,750,7150
2027,7600,400,-1200,-2600,-2150,2050
2028,-4300,-2200,-2100,-2700,1950,-9350
2029,2600,-7500,1000,8200,0,4300
2030,-5900,0,1600,-7500,1950,-9850
2031,10200,-3000,-1800,-3900,1950,3450
2032,-1100,9700,4700,4600,-1200,16700
2033,-1600,0,0,0,0,-1600
2034,11100,12100,0,8200,-11150,20250
2035,-3600,100,0,12000,-950,7550
2036,8400,-2100,-10200,6300,2900,5300
2037,-6900,200,0,-4900,13950,2350
2038,-5000,-700,0,-2000,0,-7700
2039,700,-2300,12000,1200,-1200,10400
2040,6100,12200,0,-1000,0,17300
2041,2800,-6800,0,-2000,0,-6000
2042,8300,-3000,-1200,200,0,4300
2043,-6000,200,0,-3000,0,-8800
2044,11600,-5200,0,0,0,6400
2045,-5800,12100,0,-2000,0,4300
2046,-3300,100,0,12200,-1200,7800
2047,6600,500,0,0,0,7100
2048,-1000,9700,0,-1000,-950,6750
2049,7000,0,0,-2000,-950,4050
2050,-3500,-2200,0,-2700,1700,-6700
2051,5000,-600,0,9300,750,14450
2052,-3500,-2100,0,-1000,0,-6600
2053,10700,-4400,0,0,-950,5350
2054,13000,3700,0,-1000,0,15700
2055,-400,-3700,0,-5900,1950,-8050
2056,11800,-3100,-1200,1400,-1200,7700
2057,-1400,7700,-1800,-3700,750,1550
2058,-5800,-800,4700,6400,0,4500
2059,-3700,10000,-1200,-800,0,4300
2060,12500,-5400,0,0,-950,6150
2061,-6100,200,0,10000,-950,3150
2062,10000,7400,0,-5900,1950,13450
2063,-2700,-3000,0,-3900,2900,-6700
2064,-3300,12000,0,-1000,0,7700
2065,0,0,0,11000,0,11000
2066,10200,12000,0,-1000,0,21200
2067,-4400,400,0,-2000,0,-6000
2068,8200,-4400,0,11000,0,14800
2069,500,-5400,0,-800,-1200,-6900
2070,11200,0,0,-1000,0,10200
2071,-1800,-700,0,-1000,0,-3500
2072,-1000,9800,0,-1000,0,7800
2073,8500,200,-1200,-800,0,6700
2074,-4100,12000,-11400,8600,-1200,3900
2075,-5500,-3600,-1800,-1000,0,-11900
2076,-7800,1200,16700,-6600,0,3500
2077,6000,1100,0,200,-2150,5150
2078,-5000,0,0,-3000,-950,-8950
2079,10900,-4600,0,-1500,500,5300
2080,-2800,-2900,-1200,9300,1950,4350
2081,6200,100,-900,-1000,-950,3450
2082,-2800,9900,1900,-2800,0,6200
2083,10800,-5300,1900,6300,1950,15650
2084,700,-2300,0,-2000,-950,-4550
2085,11100,11200,0,-3700,1700,20300
2086,-2700,100,0,-800,-1200,-4600
2087,6900,12200,-1200,12200,-950,29150
2088,-4100,100,-1200,200,0,-5000
2089,10900,-2300,-1800,-3900,1950,4850
2090,-4500,-2000,4700,-7600,-950,-10350
2091,7500,-2000,0,-3700,1700,3500
2092,-3600,-3000,-1200,200,0,-7600
2093,8600,-700,0,10000,-950,16950
2094,-8500,1200,0,-1800,-2150,-11250
2095,9800,7600,-1200,-1700,2900,17400
2096,-2900,-4400,-1800,7100,1950,-50
2097,6900,-1500,4700,-6600,0,3500
2098,-4600,-1200,0,10000,0,4200
2099,10700,5900,-1200,1400,-1200,15600
2100,-5900,1000,0,12000,0,7100
2101,7800,200,0,0,-950,7050
2102,-4400,9800,0,0,0,5400
2103,8300,-2700,0,-3900,1950,3650
2104,10200,-2300,0,-1000,-950,5950
2105,-4400,-2000,0,-3900,2900,-7400
2106,7600,9100,0,-800,-1200,14700
2107,-5800,-600,0,10000,0,3600
2108,11400,8500,-1200,-800,0,17900
2109,-4200,-600,-900,-800,-1200,-7700
2110,10800,-4500,1000,-3600,-1200,2500
2111,-4400,300,1600,-3600,-950,-7050
2112,7700,11400,-1200,-800,0,17100
2113,-7600,1000,-900,-5900,1950,-11450
2114,10800,-4400,1000,10400,-2150,15650
2115,-4300,-700,2800,-5700,2900,-5000
2116,7000,100,0,11000,-950,17150
2117,-3600,-2900,0,-2000,0,-8500
2118,5300,13000,0,11500,-450,29350
2119,-6900,300,0,0,-950,-7550
2120,10200,-2300,0,-3900,1950,5950
2121,8200,-2000,0,0,0,6200
2122,-7600,-700,0,-2900,1950,-9250
2123,14200,-4600,-1200,9300,1950,19650
2124,-5400,10000,0,0,0,4600
2125,-2700,-3000,0,-2000,0,-7700
2126,10600,-4400,-1200,-800,0,4200
2127,8700,11200,0,200,-1200,18900
2128,-2700,-2300,-1800,11000,0,4200
2129,10000,-2200,3500,-6400,0,4900
2130,-5900,11400,0,-1000,0,4500
2131,10200,-2200,-1200,-800,0,6000
2132,1400,8900,-900,0,0,9400
2133,-5200,1100,1000,-4800,0,-7900
2134,13300,-4600,1600,9400,0,19700
2135,9400,-600,0,-1000,0,7800
2136,-4300,100,0,0,0,-4200
2137,13400,7400,0,-1000,0,19800
2138,-3400,-700,0,11000,0,6900
2139,10300,-700,-1200,-1800,0,6600
2140,-6200,-1100,-900,0,0,-8200
2141,-900,9700,1000,-3600,-1200,5000
2142,3200,600,2800,-2600,-1200,2800
2143,-2900,-4400,0,-2000,-950,-10250
2144,6000,-600,-1200,200,0,4400
2145,-4200,100,0,-3900,1950,-6050
2146,9200,10000,-1200,10200,0,28200
2147,-2800,-2200,-900,-2700,750,-7850
2148,9800,-5200,1000,-2600,-1200,1800
2149,-8500,400,2800,-2800,-950,-9050
2150,7300,-5100,0,11000,0,13200
2151,-4800,7800,-1200,-2700,1950,1050
2152,-7100,-1900,0,-5900,1950,-12950
2153,11000,-3000,0,13400,-2400,19000
2154,8400,9800,0,-600,-2400,15200
2155,-2100,-4400,0,-1000,-950,-8450
2156,4000,9400,0,0,0,13400
2157,-1800,-2200,0,8100,1950,6050
2158,11600,6700,0,-800,-3100,14400
2159,-2000,-4400,0,-2700,1700,-7400
2160,9200,-2900,0,-4700,750,2350
2161,-300,6600,0,-2000,-1900,2400
2162,6100,200,0,-2900,2900,6300
2163,-5400,10100,0,8100,1000,13800
2164,9500,-2300,0,-2000,-950,4250
2165,-4500,8200,-1200,-4700,2900,700
2166,7800,900,-3000,7500,750,13950
2167,-2700,-3100,4700,-5400,-2150,-8650
2168,9100,10100,0,-3900,2900,18200
2169,-8700,300,-1200,11200,-950,650
2170,13400,7400,-1800,-2000,0,17000
2171,8700,0,4700,3500,1950,18850
2172,-4200,-700,0,-1000,-950,-6850
2173,-3400,200,0,8100,2900,7800
2174,7500,10000,0,0,0,17500
2175,7600,-2100,0,-1000,0,4500
2176,1300,-4600,0,12000,0,8700
2177,10200,-700,0,-1000,0,8500
2178,-1900,-3100,0,-3000,0,-8000
2179,9400,1000,-2400,11600,-10200,9400
2180,-5300,9900,-1200,200,0,3600
2181,12200,-7600,-1800,0,12000,14800
2182,-2500,0,4700,-6600,0,-4400
2183,10900,9000,0,0,0,19900
2184,-1700,-1600,0,-2000,0,-5300
2185,13200,-2800,0,-800,-1200,8400
2186,-4200,10500,-1200,14400,-1200,18300
2187,-4200,900,-900,0,0,-4200
2188,-5400,-2200,1000,-4800,-950,-12350
2189,-6100,9900,2800,-3800,0,2800
2190,6100,100,0,-3900,1950,4250
2191,8400,-3800,0,200,-2150,2650
2192,-6300,-1000,-1200,-4500,1700,-11300
2193,8600,-2300,-1200,-800,0,4300
2194,-5900,-600,-900,-1000,-950,-9350
2195,8300,10800,-1400,7600,-950,24350
2196,-4300,-3000,2800,-5700,2900,-7300
2197,5500,-2200,-12000,5300,1950,-1450
2198,-2500,9700,4700,-6600,0,5300
2199,-3700,-2000,12000,-2800,-1200,2300
2200,10600,-6000,0,-600,-2400,1600
2201,9800,-3500,0,11200,-1200,16300
2202,-500,5800,0,-1800,-2150,1350
2203,-10200,400,-1200,13400,-1200,1200
2204,9100,7600,-1200,-2700,1950,14750
2205,-2600,-3000,-900,12000,-1900,3600
2206,11600,-4500,1000,-7700,2900,3300
2207,9300,9900,2800,-6700,1000,16300
2208,-2500,-1600,0,0,-950,-5050
2209,7700,13100,0,-3900,2900,19800
2210,-200,-2300,0,8100,1950,7550
2211,6800,400,-1200,-3500,750,3250
2212,-3000,7700,0,12000,0,16700
2213,3400,-400,0,-4000,0,-1000
2214,-1000,-2200,-2400,1400,0,-4200
2215,7600,-2200,-1800,11000,0,14600
2216,-1200,7400,4700,-6600,0,4300
2217,9100,-3000,-1200,200,0,5100
2218,-6600,12100,-900,-1000,0,3600
2219,9400,-1500,1000,-3800,0,5100
2220,-5300,1100,2800,7200,0,5800
2221,11600,7500,0,0,0,19100
2222,5800,-2000,0,-2000,0,1800
2223,-1900,-2300,0,-2000,0,-6200
2224,9000,-5300,0,12000,0,15700
2225,-4100,100,0,-800,-1200,-6000
2226,10200,8900,0,-2000,0,17100
2227,2000,-4400,0,200,-1200,-3400
2228,11500,-5200,0,12000,-950,17350
2229,-2600,12000,0,0,-950,8450
2230,7500,9100,0,-2700,1700,15600
2231,-1800,-1400,0,-2900,1950,-4150
2232,9900,-5100,0,0,0,4800
2233,-4300,200,0,-1000,-950,-6050
2234,-6300,9300,0,-1000,-950,1050
2235,5300,-700,-1200,10500,1700,15600
2236,-5300,10800,0,-2900,1950,4550
2237,8500,-3100,-1200,200,0,4400
2238,-3500,-1300,-1800,200,-1200,-7600
2239,10000,-3000,4700,-5600,0,6100
2240,400,-4500,0,-1000,0,-5100
2241,-2800,9800,0,0,-950,6050
2242,10600,-5200,0,-3900,1950,3450
2243,9300,-2900,-2400,12400,-950,15450
2244,-4300,9800,-900,-3700,1700,2600
2245,-1100,-3000,700,-2600,0,-6000
2246,5900,300,1900,-4800,0,3300
2247,-1200,7500,-1200,200,0,5300
2248,10100,-2100,-900,11000,0,18100
2249,-6000,11300,2600,-6400,0,1500
2250,4900,-2100,0,0,0,2800
2251,-3600,-2100,0,11000,0,5300
2252,11000,9800,0,-1000,0,19800
2253,-6800,-1500,0,12000,0,3700
2254,8000,-3500,0,0,0,4500
2255,8000,12000,0,0,0,20000
2256,-2700,-3000,-1200,200,0,-6700
2257,7700,300,-900,0,0,7100
2258,-3600,9000,3800,-5600,0,3600
2259,12400,-3600,0,0,0,8800
2260,-8600,-400,0,0,0,-9000
2261,10200,-2300,-1200,200,0,6900
2262,-2700,9800,0,0,0,7100
2263,8700,-800,-1200,400,-1200,5900
2264,-1800,100,-900,-1000,0,-3600
2265,10100,-2200,1000,-2600,-1200,5100
2266,-5200,12200,2800,-3800,-950,5050
2267,-2700,-2100,-1200,-600,-2150,-8750
2268,7800,100,-1200,-2500,1700,5900
2269,-100,-2300,-2400,-3500,1000,-7300
2270,8400,-500,-1800,11000,0,17100
2271,7800,100,2000,-10500,1950,1350
2272,2200,-4600,5600,-6600,-950,-4350
2273,8500,12200,-2400,8500,2900,29700
2274,-3400,-700,-900,-800,-1200,-7000
2275,8500,-2100,-200,6600,-10200,2600
2276,-600,-4400,2800,6200,0,4000
2277,-6000,400,0,-2000,-950,-8550
2278,7700,-2300,0,8400,-350,13450
2279,-800,5300,0,6300,-7300,3500
2280,-2400,-800,0,-3700,12750,5850
2281,10200,-3100,0,-1000,0,6100
2282,-2600,12100,0,0,11050,20550
2283,13200,-4500,0,-3800,-1200,3700
2284,-3500,10500,-1200,-1300,-450,4050
2285,10000,-3700,-1800,-2000,-950,1550
2286,700,9700,4700,1700,750,17550
2287,-3600,200,-10200,7200,0,-6400
2288,-5900,-600,0,-4900,1000,-10400
2289,-800,-6500,10800,-600,-2150,750
2290,11800,7400,0,-2900,2900,19200
2291,-300,-3000,-1200,6300,1950,3750
2292,-4300,11400,0,11400,-12350,6150
2293,11600,-4400,-3000,-4700,2900,2400
2294,-4300,100,4700,-6600,11050,4950
2295,-2700,8900,0,-1000,0,5200
2296,5800,-1900,0,-4900,1950,950
2297,-4500,-2000,-1200,11200,-950,2550
2298,6200,12200,-2100,-2700,2900,16500
2299,-2700,-2200,1000,9200,0,5300
2300,-5100,100,2800,-3800,0,-6000
2301,8700,-1500,0,-1000,0,6200
2302,-2900,-1200,-1200,11200,0,5900
2303,10700,-4400,-900,-800,-1200,3400
2304,-1900,8900,1000,9400,-1200,16200
2305,11000,-2300,1600,-5600,0,4700
2306,-900,-800,0,-1800,-2150,-5650
2307,-4600,10100,0,1200,-1200,5500
2308,9200,-1300,0,9100,1950,18950
2309,-300,-5300,0,-3000,-1900,-10500
2310,10200,-2300,0,-4700,1700,4900
2311,0,11200,0,-3500,-450,7250
2312,7700,100,-1200,10600,-12350,4850
2313,600,9000,0,-3900,1950,7650
2314,9400,1000,-1800,-2000,11050,17650
2315,1300,-4500,4700,-9500,1950,-6050
2316,300,-5300,0,-4900,1950,-7950
2317,-5100,300,0,22200,-11150,6250
2318,-900,8900,0,-5900,2900,5000
2319,-1100,-2200,0,-2900,13950,7750
2320,-1700,0,0,12200,-1200,9300
2321,7700,12200,-1200,-1800,0,16900
2322,-1700,100,0,-1800,-1200,-4600
2323,11800,-2200,0,1200,-1200,9600
2324,-100,-3100,0,9000,-950,4850
2325,-1800,0,0,400,-2400,-3800
2326,-3600,200,0,-1700,750,-4350
2327,7900,12100,0,-2000,-1900,16100
2328,-2600,-2200,-1200,-3700,2900,-6800
2329,-5300,-400,-1200,8600,-13300,-11600
2330,-4500,-1100,-1800,-4900,1950,-10350
2331,3500,-1300,4700,-8300,13700,12300
2332,-5300,-1100,-10200,6300,1950,-8350
2333,4100,-2900,0,-1000,-1900,-1700
2334,-3900,8500,12000,-3900,2900,15600
2335,15400,-10700,0,-3900,1950,2750
2336,-4300,-1400,0,11200,-2150,3350
2337,10000,-6100,-2400,-4500,2900,-100
2338,-6800,12300,-11400,23600,-1200,16500
2339,6900,100,-1800,0,0,5200
2340,7500,10000,13000,-3800,0,26700
2341,1400,-6200,2600,-5400,-950,-8550
2342,10900,-1400,2800,-3800,-950,7550
2343,-7000,12400,-10200,7300,2900,5400
2344,9300,-3100,0,-3900,1950,4250
2345,-3500,9800,10800,200,0,17300
2346,6800,300,-1800,0,0,5300
2347,-1900,9700,4700,6400,0,18900
2348,-3500,-3000,0,0,0,-6500
2349,9200,-2100,0,-1000,0,6100
2350,6000,12200,0,0,0,18200
2351,-3600,-2100,0,11000,0,5300
2352,-4400,-2100,-1200,1200,0,-6500
2353,6100,-600,0,0,0,5500
2354,8200,-2000,-1200,400,-1200,4200
2355,-1700,9700,-2100,-800,0,5100
2356,11700,-2200,-900,1400,-2400,7600
2357,-3300,-800,4700,-5600,0,-5000
2358,9300,200,0,-1000,-950,7550
2359,-5900,300,-1200,200,0,-6600
2360,2700,12300,-2100,-3700,1950,11150
2361,-2100,-4400,2600,-8300,1950,-10250
2362,10400,-800,-12000,8200,0,5800
2363,-2600,-800,3500,-6400,0,-6300
2364,5800,13200,-1200,-800,0,17000
2365,-3600,-3100,11100,-1000,0,3400
2366,7000,1000,-200,18600,-10200,16200
2367,-4100,-800,2800,-2800,0,-4900
2368,6900,900,0,-1000,12000,18800
2369,-2500,-6600,0,-1000,0,-10100
2370,11000,-2200,0,0,0,8800
2371,9000,-5300,0,11000,0,14700
2372,-5900,-500,0,200,-1200,-7400
2373,6200,12100,0,0,0,18300
2374,-3500,200,0,-1000,-950,-5250
2375,10100,-2100,0,-1000,-950,6050
2376,-4600,10000,0,-2900,2900,5400
2377,10200,-3100,0,-2900,1950,6150
2378,-5300,-2100,0,-1000,0,-8400
2379,6000,12300,0,-1000,0,17300
2380,-7600,-700,0,12200,-1200,2700
2381,9900,-3500,0,-1000,0,5400
2382,200,-6800,-1200,200,0,-7600
2383,11700,-5300,-900,-1000,0,4500
2384,7300,-2600,2600,-4400,0,2900
2385,-1900,9700,0,-1000,0,6800
2386,-2700,-3800,0,-2800,-1200,-10500
2387,10100,10600,0,-1000,0,19700
2388,1900,-7700,0,-1000,0,-6800
2389,9300,200,0,12200,-2150,19550
2390,-400,5800,-1200,-800,-950,2450
2391,10100,-1300,0,-3900,2900,7800
2392,8100,6900,-2700,-2900,1950,11350
2393,-6800,100,5600,-7600,0,-8700
2394,-2800,9000,-1200,200,0,5200
2395,9400,-2300,0,11000,0,18100
2396,-3600,9800,-1200,400,-1200,4200
2397,10800,-4500,-900,12000,0,17400
2398,-900,11200,1000,-3800,-950,6550
2399,7700,200,2800,-4600,-1200,4900
2400,-2400,0,-1200,-2700,1950,-4350
2401,12600,9700,0,11000,-950,32350
2402,-2600,-600,0,-2900,2900,-3200
2403,6000,300,0,-1000,0,5300
2404,-2100,7500,0,-3000,0,2400
2405,-1000,-2300,0,-3000,0,-6300
2406,9300,-700,-3300,12400,0,17700
2407,-1100,-2100,1000,-1600,-1200,-5000
2408,8500,-2200,2800,-3600,-1200,4300
2409,-5100,11400,0,-2000,-950,3350
2410,-5300,-1300,0,10200,-10200,-6600
2411,2200,-5400,0,-3900,1950,-5150
2412,9300,100,0,-1000,11050,19450
2413,-100,9700,0,-3900,2900,8600
2414,10200,-700,-1200,200,0,8500
2415,-7000,400,-1200,11200,0,3400
2416,-4400,-2200,100,-2800,0,-9300
2417,12400,7400,2800,-6800,0,15800
2418,-2200,-5100,0,1600,-3600,-9300
2419,-3000,-4300,0,0,0,-7300
2420,-4300,-3000,0,-1000,-950,-9250
2421,10100,9700,0,20200,-11150,28850
2422,-4300,-3000,0,-3900,1950,-9250
2423,11600,7500,0,-1700,12750,30150
2424,-3500,-1300,0,0,-950,-5750
2425,8900,8400,0,-4900,2900,15300
2426,-1400,-4400,0,-4900,1950,-8750
2427,12500,6700,-10200,10200,0,19200
2428,200,-6700,0,-1000,0,-7500
2429,-2600,-3100,12000,0,0,6300
2430,-900,12100,-1200,-800,0,9200
2431,8300,-2900,0,-800,-1200,3400
2432,-1700,12100,-3000,11200,0,18600
2433,12100,-7400,4700,-5600,-950,2850
2434,-4900,100,-1200,-800,0,-6800
2435,-2000,9700,-1200,-3700,1950,4750
2436,-3400,-1500,-3000,200,-950,-8650
2437,-2100,8400,3800,-10500,2900,2500
2438,8500,-2200,-200,-3600,0,2500
2439,-2700,100,1600,8400,0,7400
2440,10200,8900,-900,0,0,18200
2441,-5100,200,1000,7200,0,3300
2442,8300,9800,2800,-4800,0,16100
2443,-1200,-4600,-1200,200,0,-6800
2444,-2000,-2900,0,11000,0,6100
2445,9900,-5200,0,-2000,0,2700
2446,-3700,10000,-2400,13600,-1200,16300
2447,11000,-2200,-1800,0,0,7000
2448,2800,4300,4700,-6600,0,5200
2449,-1100,-2200,0,-2000,0,-5300
2450,13200,-5400,-1200,-800,0,5800
2451,-2800,9100,-3000,1400,-1200,3500
2452,1300,-4500,4700,6400,0,7900
2453,-2800,9800,0,-1000,-950,5050
2454,-5000,-1400,0,-2000,-950,-9350
2455,-2200,8400,0,-5700,1700,2200
2456,-1800,-2300,-2400,10900,-450,3950
2457,11100,-800,-12300,11600,-1200,8400
2458,-2700,12200,1000,-3800,-950,5750
2459,11000,-2200,13000,-1400,-2400,18000
2460,-5300,9900,3500,-10300,1950,-250
2461,-400,-4600,0,0,-1900,-6900
2462,-1100,-3000,0,-4900,2900,-6100
2463,9300,-2900,-1200,10500,-200,15500
2464,-1400,7600,-1800,0,-950,3450
2465,-1000,-2300,1900,6300,2900,7800
2466,11000,9000,2800,-5700,1950,19050
2467,-1800,0,0,-3000,-950,-5750
2468,-1900,-2200,-1200,-1500,1700,-5100
2469,13300,7400,0,11000,0,31700
2470,-900,-700,0,-2000,-950,-4550
2471,-4200,100,0,1400,-2400,-5100
2472,-3400,12100,0,9100,1950,19750
2473,400,-4500,-1200,-800,-1900,-8000
2474,-1200,-2800,0,-3900,2900,-5000
2475,12500,-4600,-3000,-3700,1950,3150
2476,-2900,9200,4700,-5600,-950,4450
2477,-4000,0,0,7100,2900,6000
2478,-2100,9900,0,0,0,7800
2479,400,-6100,0,10000,0,4300
2480,7600,-1300,-1200,200,0,5300
2481,1000,4500,-1800,0,0,3700
2482,10000,-2200,3500,6600,0,17900
2483,-2700,-2900,0,-1800,-1200,-8600
2484,-1700,9700,-1200,200,0,7000
2485,-1200,-2100,0,-1000,0,-4300
2486,-4200,-600,-1800,-1000,0,-7600
2487,6900,11400,3500,-7400,0,14400
2488,-2000,10800,0,0,0,8800
2489,9300,-2200,-2400,10400,0,15100
2490,-4200,100,-2400,400,0,-6100
2491,7600,-3100,-2700,12200,-1200,12800
2492,-4300,200,3800,-6600,0,-6900
2493,10000,9900,3500,-6400,-950,16050
2494,-5200,300,-900,-1000,0,-6800
2495,10000,-4500,1000,-5700,1950,2750
2496,-5000,100,2800,8200,-950,5150
2497,5900,-500,0,-2900,2900,5400
2498,-3500,-2200,0,-1000,0,-6700
2499,9400,9700,0,12000,0,31100
2500,-2700,-600,0,0,0,-3300
2501,-4600,-2000,0,11000,0,4400
2502,8400,-2000,0,0,0,6400
2503,4300,12400,0,0,0,16700
2504,-300,-4600,0,-1000,0,-5900
2505,11300,-7600,0,0,0,3700
2506,-6700,-1500,0,0,0,-8200
2507,-1300,8500,0,-4000,0,3200
2508,8300,-3000,-1200,1400,-1200,4300
2509,5200,12400,0,-800,-1200,15600
2510,-2800,-2200,0,-1000,0,-6000
2511,-3300,11300,0,-1000,0,7000
2512,4000,-1000,-10200,8200,-950,50
2513,-1000,-3000,0,0,-950,-4950
2514,4300,200,0,-3900,2900,3500
2515,-2100,-5300,12000,-2900,1950,3650
2516,6700,10700,0,-2000,0,15400
2517,200,-7400,0,0,0,-7200
2518,8900,-4500,0,11000,0,15400
2519,-4000,11200,-2100,200,0,5300
2520,11300,-7500,1000,-2800,0,2000
2521,-3500,9800,2800,-2800,0,6300
2522,11800,-3000,-1200,-800,0,6800
2523,10000,9100,0,-3800,-1200,14100
2524,-3400,200,-1200,200,0,-4200
2525,5300,12200,-900,10000,0,26600
2526,1200,-4600,1000,-2800,0,-5200
2527,9400,-700,2800,-4800,0,6700
2528,-4400,10600,0,-1000,0,5200
2529,9500,0,0,-1000,0,8500
2530,-4400,-600,0,10000,0,5000
2531,8600,200,-1200,400,-1200,6800
2532,-4400,9900,0,-2000,0,3500
2533,10700,-4600,0,-1000,-950,4150
2534,-4100,100,0,-1000,0,-5000
2535,8700,-800,0,10300,750,18950
2536,0,0,0,-2900,1950,-950
2537,10200,0,-1200,-800,0,8200
2538,-4300,12200,-900,-1600,-2400,3000
2539,5700,-2600,1000,10400,-1200,13300
2540,-4000,-3300,2800,-2800,-950,-8250
2541,-3400,-2300,0,-1000,0,-6700
2542,5900,-3000,0,-2900,1950,1950
2543,1100,-6700,0,0,-1900,-7500
2544,12400,6700,0,9100,2900,31100
2545,-4300,200,-1200,-2700,1950,-6050
2546,-3600,-3000,0,-2000,-950,-9550
2547,6700,10000,-1200,-3700,2900,14700
2548,-500,-5300,-900,0,0,-6700
2549,5000,-2000,1000,8200,0,12200
2550,-500,7700,2800,-3800,0,6200
2551,7100,-800,0,-2000,0,4300
2552,-7700,12100,0,200,-1200,3400
2553,11700,-4500,0,-2000,0,5200
2554,300,6800,0,11000,0,18100
2555,8700,100,0,400,-2400,6800
2556,500,-3100,0,-1000,0,-3600
2557,10900,9100,0,8200,-11150,17050
2558,-5100,300,0,0,-950,-5750
2559,9400,10600,0,-2900,2900,20000
2560,-2500,-800,-1200,-2500,12750,5750
2561,-1800,200,0,-3000,0,-4600
2562,8600,12100,-1200,200,-950,18750
2563,600,-2200,-1800,-800,-1200,-5400
2564,12400,-4400,4700,-10500,1950,4150
2565,2200,-4600,0,11000,-950,7650
2566,-900,-1500,0,-4700,1700,-5400
2567,-4300,1100,0,9200,-10200,-4200
2568,3700,5100,0,-2000,0,6800
2569,-3500,-1600,0,-2000,11050,3950
2570,-200,-1400,0,0,-950,-2550
2571,12000,11200,0,-4900,2900,21200
2572,-1800,100,0,9100,1950,9350
2573,-100,-2300,0,-2000,0,-4400
2574,-7000,12300,0,-3000,0,2300
2575,-5800,200,0,12000,0,6400
2576,-4200,0,0,-800,-1200,-6200
2577,-100,-2300,-1200,-1800,0,-5400
2578,9100,-2100,0,12000,0,19000
2579,-3400,-700,0,-1000,0,-5100
2580,5300,0,0,-4000,0,1300
2581,-1100,-2900,0,1200,-1200,-4000
2582,6900,12900,0,-1000,0,18800
2583,-1000,-2300,0,-2000,-950,-6250
2584,10300,0,0,200,-1200,9300
2585,-6900,-600,-1200,-2700,1950,-9450
2586,10000,-3700,-3000,12200,-950,14550
2587,-200,-3900,4700,-8500,2900,-5000
2588,7500,1200,0,-1000,0,7700
2589,4500,12000,-10200,9200,0,15500
2590,-1900,-2300,0,-1000,0,-5200
2591,-1200,-6100,0,-1800,-1200,-10300
2592,11400,-3600,10800,1200,0,19800
2593,-6000,11400,-3000,-800,-950,650
2594,13900,-6700,1900,-4800,0,4300
2595,-5000,-1600,2800,-5700,1950,-7550
2596,-5300,10900,0,10000,-950,14650
2597,7000,100,-2400,7700,-7300,5100
2598,-3700,9900,-1800,0,0,4400
2599,12200,-7600,1900,-2800,12000,15700
2600,-3400,200,2800,-5800,0,-6200
2601,9900,6600,0,-2000,0,14500
2602,7500,-2000,0,-1000,0,4500
2603,-2100,7600,0,10000,0,15500
2604,400,-5400,-1200,200,0,-6000
2605,10300,-800,-900,-2000,0,6600
2606,-2000,10000,1000,6400,-10200,5200
2607,6600,-1900,2800,-2800,12000,16700
2608,1300,7500,0,-800,-1200,6800
2609,-100,-3100,0,-1000,0,-4200
2610,-200,-3000,-2400,13400,0,7800
2611,-3700,10000,0,-1000,0,5300
2612,10000,-2200,1000,-1600,-1200,6000
2613,-300,7500,700,-2600,0,5300
2614,-1900,-3100,0,-1000,-950,-6950
2615,2100,-6200,0,200,-1200,-5100
2616,-6100,13000,-1200,-3700,1950,3950
2617,4500,200,0,13200,-2150,15750
2618,500,-4600,-1800,-2900,2900,-5900
2619,-2000,9100,4700,-6600,-950,4250
2620,11600,-4500,0,0,-950,6150
2621,-3700,-2100,0,-3900,2900,-6800
2622,7700,11500,0,-3700,750,16250
2623,-6400,-2100,0,12400,-2400,1500
2624,-5300,10100,-1200,-1800,0,1800
2625,7800,-800,0,-1000,-950,5050
2626,-1700,-3100,0,-800,-1200,-6800
2627,4300,12900,0,12000,-950,28250
2628,-2800,-2200,0,-2900,1950,-5950
2629,8700,-800,0,-3900,1950,5950
2630,-900,-2300,-1200,200,-950,-5150
2631,8400,-2100,-1800,-2900,2900,4500
2632,-3400,12200,4700,2500,1950,17950
2633,12500,-4600,0,0,0,7900
2634,-2700,300,0,9200,-10200,-3400
2635,5600,-2500,0,-1000,0,2100
2636,-4100,12100,0,-1000,12000,19000
2637,6700,-2000,-2400,-600,0,1700
2638,-6100,-2700,0,0,0,-8800
2639,7000,100,1000,-7800,0,300
2640,-4400,8300,700,-1400,-1200,2000
2641,8400,-500,-1200,12200,0,18900
2642,10900,-2200,-1800,-2000,0,4900
2643,-4300,-700,4700,-7600,0,-7900
2644,8500,-2200,0,1200,-1200,6300
2645,-2000,9800,0,9000,0,16800
2646,5200,-700,-1200,200,-950,2550
2647,-4100,-1500,-2400,13400,0,5400
2648,5900,13100,0,-2900,1950,18050
2649,-7000,-1000,-1800,0,-950,-10750
2650,8100,-4300,4700,-8500,2900,2900
2651,-1700,-7300,0,-1000,0,-10000
2652,8000,-4200,0,9200,-10200,2800
2653,-7800,-600,0,0,0,-8400
2654,10800,7500,0,-1000,12000,29300
2655,-2000,-4600,0,1400,-2400,-7600
2656,8300,9000,0,-2000,0,15300
2657,-5200,-2900,0,-1000,-950,-10050
2658,11800,-4600,0,-1000,0,6200
2659,-8600,11400,-2400,-5500,1950,-3150
2660,8800,0,-2100,2400,-2150,6950
2661,-3600,9900,1000,-8700,2900,1500
2662,7700,-2200,-1400,12800,-1200,15700
2663,-2500,11300,3800,-7600,0,5000
2664,9200,-2200,-200,-3600,-950,2250
2665,-4200,12200,2800,8200,0,19000
2666,8300,-2900,0,-1000,-950,3450
2667,-4500,-1200,0,-3900,2900,-6700
2668,11600,-6200,0,8100,1950,15450
2669,-6900,1100,0,-2000,0,-7800
2670,8300,-2100,-1200,12200,0,17200
2671,-4400,8900,-3000,-1800,0,-300
2672,11800,-4600,3500,6600,0,17300
2673,-4300,10400,0,0,0,6100
2674,4400,1100,-900,-2800,-1200,600
2675,-2300,-4200,1000,6400,-10200,-9300
2676,9600,12000,1600,-2200,-2400,18600
2677,-4500,-2000,0,200,10800,4500
2678,8700,-800,0,-4000,-950,2950
2679,-4200,100,-1200,-800,0,-6100
2680,-4500,200,-900,9100,1000,4900
2681,9100,9800,1000,-4800,-950,14150
2682,5300,100,1600,-5300,1700,3400
2683,-4300,-2100,0,-2900,1950,-7350
2684,9300,-2300,0,11200,-2150,16050
2685,-7700,400,0,-3900,2900,-8300
2686,2600,-1200,0,11000,-950,11450
2687,-6200,-1100,0,-2000,0,-9300
2688,7800,12100,0,-2700,750,17950
2689,-2100,-4500,0,9000,-950,1450
2690,7700,-700,-2400,-500,2900,7000
2691,-3500,-2200,-900,-2000,0,-8600
2692,10000,-4600,-200,-4600,0,600
2693,-3500,9700,1000,-3800,0,3400
2694,11100,-1600,4700,4400,0,18600
2695,-4300,1000,-2400,1400,0,-4300
2696,7700,12300,-900,11000,0,30100
2697,-4900,0,1000,-3800,0,-7700
2698,8100,-2000,2800,-2800,0,6100
2699,-2700,-3000,-10200,6200,0,-9700
2700,11700,-4500,0,1400,-2400,6200
2701,-2200,-4400,0,-2000,0,-8600
2702,7400,-2800,12000,-4000,-950,11650
2703,1200,5200,0,11200,-2150,15450
2704,14000,-5400,0,-2700,1700,7600
2705,-3300,11200,-1200,-2700,1000,5000
2706,8300,-2000,0,-3000,-950,2350
2707,-3400,100,-2400,-2500,2900,-5300
2708,9700,7800,0,8100,1950,27550
2709,-3300,-700,-1800,-1000,0,-6800
2710,12500,7400,4700,-6600,0,18000
2711,-1800,100,0,10000,0,8300
2712,8600,11400,-1200,-800,0,18000
2713,1400,-4600,0,-2000,0,-5200
2714,9400,12200,-1800,12200,-1200,30800
2715,300,-5200,4700,-7600,0,-7800
2716,6900,300,0,11000,-950,17250
2717,-200,-2200,0,200,-2150,-4350
2718,5000,12500,0,-4900,2900,15500
2719,-2100,-4600,0,-5900,1950,-10650
2720,9500,-2300,-10200,9400,-1200,5200
2721,-2800,-2900,0,-800,-1200,-7700
2722,8400,-3000,0,-1000,-950,3450
2723,-4300,-600,12000,-2000,0,5100
2724,6700,10800,0,-3900,1950,15550
2725,-4500,-3000,-1200,11600,-3350,-450
2726,6200,12200,0,-5900,2900,15400
2727,-2700,-2200,-12600,11600,-950,-6850
2728,11100,0,-3000,-800,0,7300
2729,-5400,9800,16700,-8500,1950,14550
2730,7000,100,-12000,9200,-950,3350
2731,-5100,100,4700,-9500,2900,-6900
2732,3900,-1900,12000,0,0,14000
2733,-5000,-600,-1200,-800,0,-7600
2734,9300,-2200,-10200,22200,0,19100
2735,-2700,-2200,0,-1000,0,-5900
2736,8500,9000,12000,1200,-1200,29500
2737,-4300,300,-1200,-800,0,-6000
2738,10400,-6600,-1800,1200,-2150,1050
2739,-6000,12300,4700,-5400,-1200,4400
2740,6900,-600,0,-3900,1950,4350
2741,-3600,-2000,0,-1000,-950,-7550
2742,5900,9800,0,-2700,750,13750
2743,-5400,-2000,-10200,9200,0,-8400
2744,8700,-3100,12000,-4900,1950,14650
2745,6700,-2100,-1200,200,-950,2650
2746,-300,-2100,-1200,-2700,2900,-3400
2747,6500,9000,-900,-3000,0,11600
2748,-500,-4400,1900,-2600,-1200,-6800
2749,11100,-2300,1900,9200,0,19900
2750,-700,4400,0,-1000,-950,1750
2751,-2800,-2000,0,-1000,0,-5800
2752,10100,9000,0,-2900,1950,18150
2753,-1000,-2200,0,11000,-950,6850
2754,6800,10700,0,-3900,2900,16500
2755,-2800,-1200,-2400,-1600,0,-8000
2756,9300,9700,-2100,1400,-1200,17100
2757,2200,-5400,-900,11200,-1200,5900
2758,8500,-600,3500,-6400,0,5000
2759,-7700,1200,-3000,1400,-1200,-9300
2760,10700,6800,4700,-6600,-950,14650
2761,-8300,300,-1200,200,-950,-9950
2762,12400,-4500,0,8100,2900,18900
2763,-3600,9900,-13200,7500,1950,2550
2764,9300,-3000,4700,-5600,0,5400
2765,-5300,300,12000,0,0,7000
2766,8900,7600,-10200,9200,0,15500
2767,11400,-7400,0,0,0,4000
2768,-6900,-2200,0,-1000,0,-10100
2769,10700,6800,12000,0,0,29500
2770,-5500,-2600,0,0,0,-8100
2771,8300,-4500,0,-800,-1200,1800
2772,-7500,10500,0,0,0,3000
2773,8400,-1300,0,-2000,0,5100
2774,-2800,9900,0,-2000,-950,4150
2775,9400,-2200,0,-2000,-950,4250
2776,-3500,11400,0,-3900,2900,6900
2777,10100,-3000,0,-3900,1950,5150
2778,8700,12900,0,10000,0,31600
2779,-1800,-700,-1200,200,0,-3500
2780,-4300,1100,-900,-2000,0,-6100
2781,12100,-6700,1000,5400,-10200,1600
2782,8700,-800,2800,-3800,0,6900
2783,-4100,100,0,-1000,0,-5000
2784,9100,-2100,-11400,8600,10800,15000
2785,1300,5900,0,0,0,7200
2786,-500,-3600,0,-2000,0,-6100
2787,6000,-500,10800,400,-1200,15500
2788,5200,12200,0,-1000,0,16400
2789,-5300,-3000,-3900,200,-950,-12950
2790,6200,12900,5600,4400,0,29100
2791,-3300,0,0,-500,-450,-4250
2792,9500,-700,-10200,8200,-950,5850
2793,-5400,-1100,-2100,-1700,1950,-8350
2794,11000,-2300,1000,-3800,0,5900
2795,1100,-5300,14800,-6700,1950,5850
2796,6000,-500,-1200,200,-950,3550
2797,-1000,9800,0,-2900,2900,8800
2798,-2800,-2100,0,-2000,0,-6900
2799,8700,12100,-11400,22400,0,31800
2800,-200,-2300,-900,-2000,0,-5400
2801,10300,0,-200,-2200,-2400,5500
2802,0,-800,14800,-3600,-1200,9200
2803,8600,100,0,200,-1200,7700
2804,-2800,-2200,0,-1000,-950,-6950
2805,7400,10100,0,-4900,1950,14550
2806,-5400,-1900,-1200,-600,-3100,-12200
2807,11900,-3100,0,9100,2900,20800
2808,-4600,-4400,-3000,-3700,1950,-13750
2809,10800,-4600,4700,-6600,-950,3350
2810,-3000,8600,0,-3900,2900,4600
2811,5300,200,0,10000,0,15500
2812,-4500,-2200,0,0,0,-6700
2813,-2000,7600,0,21200,-10200,16600
2814,4300,-1300,0,0,0,3000
2815,-1800,9800,-1200,-800,12000,18000
2816,9900,-3600,-1200,200,0,5300
2817,-5100,200,-3000,200,0,-7700
2818,3400,11600,4700,-6400,-1200,12100
2819,1400,-4600,-900,200,-1200,-5100
2820,6900,12200,1000,-3800,0,16300
2821,-4300,100,2800,-3800,-950,-6150
2822,8700,100,0,-4900,1950,5850
2823,-8700,600,-1200,-800,-950,-11050
2824,7800,100,0,9300,1700,18900
2825,-7700,200,-10200,10200,0,-7500
2826,9200,-2300,0,0,-950,5950
2827,-6000,-1400,12000,0,0,4600
2828,7400,-3600,0,-2900,1950,2850
2829,100,5400,0,-1000,0,4500
2830,5200,-700,0,-3900,1950,2550
2831,-1900,-2100,0,0,0,-4000
2832,8600,-3100,0,-1000,0,4500
2833,-3000,6900,0,12000,0,15900
2834,-10300,400,0,-1000,0,-10900
2835,10800,7600,0,-1000,0,17400
2836,-6800,200,-1200,200,0,-7600
2837,12900,5300,0,-1000,0,17200
2838,8100,-5900,-1800,-800,-1200,-1600
2839,-700,-5700,3500,-4400,0,-7300
2840,7700,-700,0,10000,0,17000
2841,-3100,6900,-2400,1600,-1200,1800
2842,10200,-2200,-900,1200,-1200,7100
2843,-1600,3800,-200,-2600,-950,-1550
2844,6600,10100,1000,-4800,0,12900
2845,-1800,-2300,4700,-8300,750,-6950
2846,13900,-6700,0,0,-950,6250
2847,-5000,11300,0,6100,1950,14350
2848,13900,-9300,-2400,1600,-2150,1650
2849,-6100,11600,-900,-4900,2900,2600
2850,5300,-600,1900,5300,1950,13850
2851,400,7400,-500,-3400,0,3900
2852,6300,0,-1800,-3000,0,1500
2853,-4500,9100,4700,4400,0,13700
2854,4800,-1700,-1200,-2800,0,-900
2855,-6200,-2000,0,9000,0,800
2856,5100,12300,0,-1000,0,16400
2857,500,-6200,0,-2000,0,-7700
2858,9200,10700,-1200,12200,0,30900
2859,-600,-6800,-12000,8200,0,-11200
2860,10100,9000,4700,-5600,0,18200
2861,-8100,-2400,0,-3000,0,-13500
2862,8700,11300,12000,-2000,0,30000
2863,-6200,-1200,0,-1000,0,-8400
2864,7600,9800,-1200,9400,-1200,24400
2865,-7700,-300,0,-1000,0,-9000
2866,7500,-2100,0,-800,-2150,2450
2867,-5400,9900,0,11200,-1200,14500
2868,5800,-2200,0,-3900,1950,1650
2869,-1800,-3000,0,-2000,-950,-7750
2870,7900,0,0,-4900,1950,4950
2871,11600,6700,0,0,-950,17350
2872,-5300,-1300,-1200,-4700,2900,-9600
2873,10100,-3000,-900,8100,1950,16250
2874,-500,-4500,-200,-4600,0,-9800
2875,12400,6600,700,8400,0,28100
2876,-1200,-4400,1000,-2800,0,-7400
2877,6800,-2900,2800,8200,0,14900
2878,-2500,4600,0,200,-1200,1100
2879,13400,7400,0,12000,0,32800
2880,-7100,-2700,0,-1000,0,-10800
2881,11700,6700,0,-2000,0,16400
2882,-3500,-2300,-1200,1200,0,-5800
2883,13900,-7500,0,-800,-1200,4400
2884,-6800,12200,0,0,0,5400
2885,14100,-5300,0,-1000,0,7800
2886,6300,7900,0,-2000,-950,11250
2887,-1100,-2900,-1200,-2700,1950,-5950
2888,-5000,-800,-900,-1000,-950,-8650
2889,16500,5100,-200,7500,2900,31800
2890,6100,100,2800,-2800,0,6200
2891,1300,6700,0,-1000,0,7000
2892,8500,100,-1200,-800,0,6600
2893,-3500,9800,-900,13400,-2400,16400
2894,9400,-600,1000,-3800,0,6000
2895,-4200,12000,2800,-1600,-1200,7800
2896,8300,-2100,0,9200,-11150,4250
2897,-5900,0,0,-1000,-950,-7850
2898,6900,12300,0,-2700,13700,30200
2899,-5900,100,-2400,-1500,1950,-7750
2900,10400,12000,0,0,-950,21450
2901,-4300,0,-1800,-800,-2150,-9050
2902,8300,-2100,4700,-9500,2900,4300
2903,400,-4500,0,9100,1950,6950
2904,13100,-7500,0,-1000,0,4600
2905,-1600,0,0,-1000,0,-2600
2906,-2600,-800,0,11000,0,7600
2907,12000,12000,0,-1800,-1200,21000
2908,12000,12000,-2400,1400,0,23000
2909,-2600,200,-900,-1000,-950,-5250
2910,-4200,100,-200,-3600,0,-7900
2911,-1100,-2200,2800,-5700,1950,-4250
2912,-6800,300,0,0,-950,-7450
2913,6000,400,0,7100,2900,16400
2914,-9400,400,-1200,200,0,-10000
2915,-8600,400,-900,9000,0,-100
2916,8900,-4200,-200,-400,-1200,2900
2917,7100,0,2800,-2800,0,7100
2918,-4500,-2800,0,-2000,0,-9300
2919,7400,-2800,0,-2000,0,2600
2920,-1000,10600,0,11000,0,20600
2921,7800,-1500,0,400,-2400,4300
2922,-5800,900,-1200,-800,0,-6900
2923,11700,7400,0,200,-1200,18100
2924,-2900,-5200,100,-4800,-950,-13750
2925,7600,-2100,2800,-4800,-950,2550
2926,-400,-4500,-10200,7500,750,-6850
2927,8400,9000,0,-3900,1950,15450
2928,-600,-4500,0,-600,-3350,-9050
2929,8700,-700,10800,-2700,2900,19000
2930,12400,7500,0,9100,1000,30000
2931,-2600,-800,-1200,-800,0,-5400
2932,12400,6700,0,-4700,750,15150
2933,-2000,-2100,1000,8400,-2150,3150
2934,8300,-2200,1900,-6500,1700,3200
2935,-2600,9800,0,-1000,-950,5250
2936,12600,-2300,0,-800,-2150,7350
2937,-4200,11300,0,-4900,1950,4150
2938,500,-2100,0,8100,1950,8450
2939,10600,7800,0,200,-1200,17400
2940,-4100,-1500,0,7100,1950,3450
2941,-4800,-4300,0,-2700,-200,-12000
2942,-5500,-1000,-11400,9400,0,-8500
2943,-2800,9200,0,8100,1950,16450
2944,11600,-4600,-1200,1200,-950,6050
2945,300,4400,10200,-3900,2900,13900
2946,14800,-6800,4700,-6600,0,6100
2947,-4500,9200,0,0,0,4700
2948,-5800,-700,0,-800,-1200,-8500
2949,500,7400,0,13200,-1200,19900
2950,400,-4600,0,0,0,-4200
2951,11100,-700,0,0,-950,9450
2952,10100,9000,0,-1000,-950,17150
2953,-2600,0,0,-2700,1700,-3600
2954,-2200,7700,0,-2900,1950,4550
2955,-3300,0,0,-3000,-950,-7250
2956,11000,-4700,-1200,400,-2150,3350
2957,-6100,14100,0,8100,2900,19000
2958,-7200,-2100,-1200,-2700,1950,-11250
2959,-1600,5300,-3000,-800,0,-100
2960,10200,-3100,3500,-6400,0,4200
2961,1000,-7500,-900,0,0,-7400
2962,5200,12200,1000,8200,0,26600
2963,-6800,-600,1600,-3600,0,-9400
2964,-3500,9900,-2400,400,0,4400
2965,8500,-2200,-900,12000,0,17400
2966,-6800,100,1000,-2800,0,-8500
2967,5900,9900,2800,9200,0,27800
2968,-2900,-5200,0,-1800,-1200,-11100
2969,8500,-2200,0,200,-1200,5300
2970,-1900,-2200,0,0,0,-4100
2971,11900,8900,-1200,-1800,-950,16850
2972,-900,0,0,0,-950,-1850
2973,8400,12100,-1800,-4900,2900,16700
2974,-3600,-2200,3500,-10300,1950,-10650
2975,10800,-4400,0,-1000,0,5400
2976,-2800,-3000,0,-4000,0,-9800
2977,9500,0,0,12000,0,21500
2978,14900,6700,0,-2800,-1200,17600
2979,-1800,100,-1200,11200,0,8300
2980,9500,12000,1000,-2600,-1200,18700
2981,-3300,-700,1900,-4600,-2150,-8850
2982,-8700,1200,-1200,11200,-950,1550
2983,-4400,-2000,0,-2900,1950,-7350
2984,6700,-2900,0,-3700,750,850
2985,-1000,-2300,-1200,11200,-950,5750
2986,8400,-2200,-1800,-3900,2900,3400
2987,-1200,6800,1900,3300,1950,12750
2988,11000,-2300,2800,-3800,0,7700
2989,-1800,-800,0,11000,0,8400
2990,11100,12100,0,200,-1200,22200
2991,6800,300,0,0,0,7100
2992,-7500,12200,0,11000,0,15700
2993,-6900,300,0,-800,-2150,-9550
2994,-3600,-2100,0,0,-950,-6650
2995,11700,-4600,0,-4900,2900,5100
2996,-3500,-2200,0,-2500,-450,-8650
2997,10900,-3000,0,-1000,0,6900
2998,-5300,-400,0,0,-950,-6650
2999,7700,-1400,0,12200,-1200,17300
3000,-1900,9000,0,-2700,750,5150
3001,11500,-4500,0,-1000,-950,5050
3002,-2400,-5700,0,-2700,750,-10050
3003,7600,9900,0,0,-950,16550
3004,-8700,1500,-1200,8300,1950,1850
3005,7700,8900,-1200,-1700,1950,15650
3006,-3500,-2100,-2100,400,-2150,-9450
3007,7800,-800,1000,-7700,1950,2250
3008,-4500,10600,2800,-6700,2900,5100
3009,3500,-1300,0,11000,0,13200
3010,700,-8100,0,200,-1200,-8400
3011,12000,4500,0,-1000,0,15500
3012,-2100,-4400,0,10000,-950,2550
3013,11700,-5400,-1200,1400,-1200,5300
3014,-3600,9900,0,-4900,1950,3350
3015,7900,-800,-1800,-4900,1950,2350
3016,-5900,12200,4700,-5400,-1200,4400
3017,11600,-6100,0,8000,0,13500
3018,-6200,10100,-12600,11800,-2150,950
3019,4800,-1800,-900,-1000,-950,150
3020,-8100,-1800,13000,-6700,2900,-700
3021,1200,7500,2800,-5700,1950,7750
3022,9000,-5200,0,-1000,0,2800
3023,-1800,-2200,0,-2000,0,-6000
3024,11000,8900,0,10000,0,29900
3025,-6800,200,0,-2000,0,-8600
3026,8500,9900,0,9200,-1200,26400
3027,-4400,-2900,0,1200,-1200,-7300
3028,6100,12200,0,8200,-11150,15350
3029,9000,-4400,0,-1800,-2150,650
3030,1900,5200,-1200,-3700,14900,17100
3031,12200,-8500,0,-6700,750,-2250
3032,-4500,-2100,-4800,1800,-950,-10550
3033,9600,12000,-12000,9200,-950,17850
3034,-4500,-2800,3800,-11300,1700,-13100
3035,-400,7600,1000,-6700,1950,3450
3036,5300,-700,14800,-4800,0,14600
3037,11000,9800,0,-1000,-950,18850
3038,-2600,0,0,10000,-950,6450
3039,8600,200,0,-5900,2900,5800
3040,-2500,12000,-10200,19300,1950,20550
3041,8600,0,0,-3000,0,5600
3042,-7700,300,12000,-2000,0,2600
3043,6100,100,-1200,200,0,5200
3044,-2300,-4400,-900,10000,0,2400
3045,5800,-2000,3800,-8400,-1200,-2000
3046,-2900,-5200,-2400,13400,0,2900
3047,9400,-3100,-900,-2000,0,3400
3048,700,9700,-200,-2600,0,7600
3049,9300,-1400,2800,-4800,0,5900
3050,-4100,900,0,10000,0,6800
3051,9500,12100,-2400,-600,0,18600
3052,-2700,200,-2100,10400,-1200,4600
3053,11900,-2300,700,-3600,0,6700
3054,9100,10000,-2300,-2400,-950,13450
3055,-3300,100,3800,-8600,0,-8000
3056,11200,0,-1100,-4500,1950,7550
3057,-1800,100,3800,-6400,-2150,-6450
3058,-1900,-2200,2800,6300,2900,7900
3059,8700,100,-1200,-1800,0,5800
3060,-900,-700,0,11000,0,9400
3061,-4200,100,0,0,0,-4100
3062,-2700,12200,0,12000,0,21500
3063,7600,-2200,0,-2000,0,3400
3064,-1000,-2200,0,11000,0,7800
3065,9500,100,0,-1000,0,8600
3066,-3800,-2100,0,8200,-10200,-7900
3067,500,-5300,0,-1000,0,-5800
3068,10900,-2300,0,-3000,0,5600
3069,-100,-3100,-1200,2600,9600,7800
3070,1400,9700,-900,0,0,10200
3071,10200,200,1000,-4800,-950,5650
3072,-1800,9800,2800,-2600,-2150,6050
3073,2100,-4500,0,-3900,2900,-3400
3074,-1700,-1500,0,-3700,-200,-7100
3075,300,-3500,0,11200,-2150,5850
3076,-5000,11300,0,-4900,2900,4300
3077,-200,-2200,0,-3700,750,-5350
3078,-1900,-2200,0,12000,-950,6950
3079,-3500,12200,0,-1800,-1200,5700
3080,10800,-5400,0,-3700,750,2450
3081,-4200,200,0,11000,-1900,5100
3082,-3300,12000,0,-4900,2900,6700
3083,0,0,0,-2900,1950,-950
3084,11100,0,0,11200,-2150,20150
3085,-1800,100,0,-3900,2900,-2700
3086,11200,0,0,0,0,11200
3087,-200,-2200,0,12000,-950,8650
3088,-1800,-700,0,0,-950,-3450
3089,-5100,200,0,-3700,1700,-6900
3090,6000,300,0,-1700,750,5350
3091,-6000,12300,-1200,-800,0,4300
3092,-4400,-2100,0,0,-950,-7450
3093,-3500,-6500,0,12000,0,2000
3094,5700,-2700,0,-4900,1950,50
3095,7700,-3100,0,0,-950,3650
3096,-1200,-3700,0,-3900,2900,-5900
3097,10700,6700,-1200,-800,0,15400
3098,600,-4600,-3000,-800,0,-7800
3099,2000,-7600,4700,-6400,-1200,-8500
3100,11600,6600,0,12000,0,30200
3101,-400,-2000,0,-3000,0,-5400
3102,3500,11400,0,-1800,-1200,11900
3103,-2600,-3100,-2400,15800,-2400,5300
3104,-1200,7400,-1100,-2600,-950,1550
3105,-1700,100,2800,-5600,-2150,-6550
3106,-2000,9000,-4200,-2500,1950,2250
3107,8700,0,3800,-8300,750,4950
3108,-4700,-2000,1900,-4800,-950,-10550
3109,5800,10000,1900,13500,-8250,22950
3110,1400,-4600,0,-4900,1950,-6150
3111,4800,9100,-11400,8400,-950,9950
3112,-1700,-2300,0,-4700,13700,5000
3113,7800,11200,0,-2500,-450,16050
3114,-2200,-5200,12000,0,0,4600
3115,10900,-1300,0,8000,-950,16650
3116,-7600,11500,0,10200,-10200,3900
3117,11000,-2300,0,-4900,1950,5750
3118,-2800,-2200,0,-3700,12750,4050
3119,10900,9800,0,-800,-1200,18700
3120,-5800,-700,0,0,-950,-7450
3121,9400,12100,0,-2000,-950,18550
3122,-6900,-500,0,7300,1700,1600
3123,4200,1300,0,-2700,750,3550
3124,-1800,-2200,0,9200,-2150,3050
3125,9800,-5300,0,-1000,0,3500
3126,600,600,0,-4900,1950,-1750
3127,-3500,-2200,-2400,400,-1900,-9600
3128,-7000,10100,-900,8100,2900,13200
3129,8400,-2900,1900,-6700,1950,2650
3130,-3500,-2200,700,-4600,-950,-10550
3131,12500,-4500,0,-3900,2900,7000
3132,-1900,9000,-900,11000,0,17200
3133,6300,100,1000,-4800,0,2600
3134,-500,7400,2800,9200,0,18900
3135,10300,-3100,0,-1000,0,6200
3136,-4300,100,-1200,200,0,-5200
3137,6800,12300,0,11000,0,30100
3138,6600,-2800,-1200,1200,0,3800
3139,-3500,-1400,-900,0,0,-5800
3140,13300,-5400,1000,9200,0,18100
3141,-4500,-3000,2800,-3800,0,-8500
3142,10100,9100,0,200,-1200,18200
3143,-5200,1000,0,-1000,0,-5200
3144,10300,-2300,0,0,0,8000
3145,-1100,8900,-1200,12400,-1200,17800
3146,9100,-2100,0,0,0,7000
3147,-400,-4600,0,0,-950,-5950
3148,10100,9100,0,0,0,19200
3149,-4600,-2000,0,-3900,1950,-8550
3150,4300,300,0,200,-2150,2650
3151,-2600,8900,0,-2900,2900,6300
3152,7900,0,0,0,0,7900
3153,-2500,11300,-1200,-1800,0,5800
3154,8600,900,-1800,-2000,0,5700
3155,-4400,200,4700,-5600,0,-5100
3156,8300,-2100,-1200,-1800,0,3200
3157,-5300,-2100,0,-2000,0,-9400
3158,8500,-3900,0,11200,-1200,14600
3159,-2300,-4300,-1200,12200,0,4400
3160,5400,12200,-900,-3000,-950,12750
3161,-1300,-5300,1000,-3800,0,-9400
3162,8300,-1300,1600,-5500,1950,5050
3163,-4400,9100,0,-2000,-950,1750
3164,4300,400,0,-3900,2900,3700
3165,-300,6600,0,11000,0,17300
3166,10600,-3400,0,-600,-2400,4200
3167,-6300,-2900,0,-1000,0,-10200
3168,7600,-2100,0,11000,0,16500
3169,9200,9000,0,0,-950,17250
3170,-4000,-4300,0,0,0,-8300
3171,7700,9100,0,-3900,1950,14850
3172,-1700,-2300,0,-3700,750,-6950
3173,4100,-2200,0,-1800,-1200,-1100
3174,-2600,8900,0,-1000,0,5300
3175,8400,-2100,0,12000,-950,17350
3176,-5200,12200,0,-1800,-1200,4000
3177,11900,-3100,0,0,-950,7850
3178,-1800,100,0,7100,2900,8300
3179,7800,11300,-1200,-2500,750,16150
3180,-6900,1200,-1800,-1000,0,-8500
3181,500,-4600,4700,-8600,0,-8000
3182,10600,-4300,-1200,2400,-2150,5350
3183,-5200,-3700,-1200,11200,-950,150
3184,14100,-3700,-1800,-2900,2900,8600
3185,-1800,11300,3500,-9300,1950,5650
3186,8300,-2000,-1200,12200,0,17300
3187,-5000,100,-11100,9200,0,-6800
3188,11100,8900,1000,-3800,0,17200
3189,8500,200,13600,-1400,-1200,19700
3190,-3400,12200,0,-1800,-1200,5800
3191,8900,-4500,0,-800,-1200,2400
3192,-1800,-2300,0,0,-950,-5050
3193,9500,-800,0,11000,-950,18750
3194,-1700,100,-1200,-2700,1000,-4500
3195,8600,12200,0,-4900,2900,18800
3196,-3700,-2100,-14400,8700,1950,-9550
3197,-4200,200,3800,-6400,-2150,-8750
3198,-3300,100,11100,-3900,2900,6900
3199,7700,0,4700,-6600,0,5800
3200,-3700,-2000,-1200,-800,0,-7700
3201,7500,-2100,0,22200,-10200,17400
3202,-3300,-700,0,-1000,0,-5000
3203,9900,-5400,-1200,-1800,12000,13500
3204,-3400,12100,-900,1200,-1200,7800
3205,8200,-2000,1000,-3600,-1200,2400
3206,-5300,-2300,2800,-3800,-950,-9550
3207,11800,9800,0,0,0,21600
3208,5400,-700,0,-3900,1950,2750
3209,1900,-6900,0,11000,-950,5050
3210,-1700,12100,0,-3900,2900,9400
3211,7700,-700,-1200,-800,0,5000
3212,-100,-2300,0,1200,-1200,-2400
3213,4200,12300,0,10000,0,26500
3214,500,-4600,0,-2000,-950,-7050
3215,-1200,-4500,0,-2000,0,-7700
3216,6700,-600,0,-2900,1950,5150
3217,-5900,100,0,-3000,-950,-9750
3218,12200,5400,0,-1700,1700,17600
3219,-4100,-800,0,-2000,0,-6900
3220,-2500,0,-1200,12200,0,8500
3221,11100,12000,-900,-2800,-1200,18200
3222,-2700,100,1000,-4800,0,-6400
3223,11700,-5400,2800,9200,-950,17350
3224,-5200,400,0,-1000,0,-5800
3225,10700,-4300,0,-4900,1950,3450
3226,-2800,-3000,0,-2000,-950,-8750
3227,2600,2900,0,7300,1700,14500
3228,-4500,-2900,0,10200,-10200,-7400
3229,-5300,-2000,0,-2800,-1200,-11300
3230,10500,4600,0,0,12000,27100
3231,-1000,-2300,0,-1000,-950,-5250
3232,6900,11500,0,-1000,0,17400
3233,-5300,-2300,0,11000,-950,2450
3234,7400,-2200,0,-3900,1950,3250
3235,-3200,11200,0,-3900,2900,7000
3236,10900,-2200,0,0,0,8700
3237,-4300,12100,0,-2000,0,5800
3238,5300,-800,0,-1000,0,3500
3239,-600,-4300,0,12200,-1200,6100
3240,6700,9900,0,-1000,0,15600
3241,-5800,100,0,0,0,-5700
3242,8400,9800,0,-2000,0,16200
3243,-2500,-700,-1200,1200,0,-3200
3244,10800,-2200,0,12000,0,20600
3245,-5100,11400,0,0,0,6300
3246,6100,200,-1200,-800,0,4300
3247,-4300,-2100,-1800,0,0,-8200
3248,9100,-1300,1900,-2800,0,6900
3249,-7100,-2800,2800,-2800,0,-9900
3250,12600,-4600,0,0,0,8000
3251,-1100,-2200,0,0,0,-3300
3252,11100,11200,0,0,0,22300
3253,-5100,100,0,-1000,0,-6000
3254,6900,12100,0,1200,-1200,19000
3255,-2800,-2100,0,-800,-1200,-6900
3256,11900,-2300,0,0,-950,8650
3257,-1800,0,0,0,-950,-2750
3258,10100,-3000,0,-3900,2900,6100
3259,-5200,300,0,-3700,750,-7850
3260,7600,9800,0,-1000,0,16400
3261,500,-5400,0,-1000,0,-5900
3262,-4300,100,0,11000,-950,5850
3263,-5900,200,0,0,-950,-6650
3264,7600,8300,0,-3900,2900,14900
3265,5600,-100,0,9300,750,15550
3266,-2900,-5200,0,200,-1200,-9100
3267,11600,-4600,0,0,0,7000
3268,-3200,-800,0,-1000,0,-5000
3269,7500,12300,0,1200,-2150,18850
3270,-2600,-3100,0,0,-950,-6650
3271,5200,13100,0,-2900,2900,18300
3272,9200,-3000,0,-2900,1950,5250
3273,-5000,1000,0,-2000,0,-6000
3274,9300,-3000,0,0,0,6300
3275,2000,-4500,-1200,11200,0,7500
3276,6000,11300,0,-1000,0,16300
3277,-3400,100,0,-1800,-1200,-6300
3278,8900,-5100,0,-800,-1200,1800
3279,-1200,8400,0,0,-950,6250
3280,6200,-700,0,-1800,-1200,2500
3281,-1100,-2200,0,-3900,1950,-5250
3282,-1600,12000,-1200,8400,-12100,5500
3283,9900,-3000,-2100,-2700,2900,5000
3284,-8600,400,1000,-6700,1950,-11950
3285,16300,-9100,1600,7600,1800,18200
3286,-2500,12000,-2100,-3700,1950,5650
3287,-1800,-3000,1000,-2800,12000,5400
3288,8400,200,2800,8200,0,19600
3289,-4200,12100,0,-1000,0,6900
3290,10300,-2300,0,0,0,8000
3291,-4400,-500,0,12000,0,7100
3292,-4200,200,0,-1000,0,-5000
3293,11500,-4500,0,-1000,0,6000
3294,-5800,11300,0,-1000,0,4500
3295,5100,1200,-1200,200,0,5300
3296,500,-4500,0,-800,-1200,-6000
3297,6900,-800,-10100,6400,0,2400
3298,-2600,200,2800,-1400,-2400,-3400
3299,6100,100,12000,0,0,18200
3300,-3300,12100,0,-1000,-950,6850
3301,9400,100,0,-1000,0,8500
3302,-100,-2300,0,-2700,750,-4350
3303,-1800,100,-1200,-800,-950,-4650
3304,9400,200,-2400,-2500,1950,6650
3305,6900,200,-900,-1000,-950,4250
3306,-3800,-4300,1000,-6700,2900,-10900
3307,-200,-3000,2800,5300,1950,6850
3308,6900,100,0,-2000,0,5000
3309,-4200,12100,0,0,0,7900
3310,7500,-2000,0,20400,-11400,14500
3311,-200,-2200,0,0,0,-2400
3312,-500,-5400,0,0,0,-5900
3313,10100,-2300,0,0,12000,19800
3314,-1100,9100,0,-2000,0,6000
3315,8600,0,0,200,-1200,7600
3316,-900,9700,0,-1800,-1200,5800
3317,-2600,-800,0,-2000,-950,-6350
3318,8400,300,0,0,-950,7750
3319,-6600,12100,0,-5900,2900,2500
3320,10100,-2200,-1200,-2700,1950,5950
3321,-4200,100,-3000,12200,0,5100
3322,-1700,100,4700,-6600,0,-3500
3323,6800,200,0,-2000,0,5000
3324,-4200,200,0,-3000,0,-7000
3325,10100,-2200,-2100,12400,-1200,17000
3326,-2500,0,700,-3400,-1200,-6400
3327,6700,-400,1900,8400,-1200,15400
3328,-2700,-1400,0,-1000,-950,-6050
3329,8500,-2100,0,-3900,1950,4450
3330,-500,-6900,-1200,-1800,-1900,-12300
3331,-4400,-400,-900,-5900,2900,-8700
3332,12500,6600,-200,6500,1950,27350
3333,-2700,300,2800,5400,-10200,-4400
3334,10100,9000,0,-4900,1950,16150
3335,2100,-4500,0,-2800,10800,5600
3336,10100,9800,0,-600,-2400,16900
3337,-3500,-700,0,11200,-1200,5800
3338,-3300,0,0,-2000,-950,-6250
3339,-7300,10400,0,11200,-2150,12150
3340,-4000,-4300,-1200,-3700,1950,-11250
3341,-900,-2300,-900,-5700,750,-9050
3342,10900,-5400,1000,7400,-10200,3700
3343,500,-5300,2800,-8500,-200,-10700
3344,11500,7600,0,-2900,1950,18150
3345,-2400,-800,0,9000,12000,17800
3346,5800,-400,0,-3900,1950,3450
3347,-1500,6100,0,-2000,-950,1650
3348,-2400,-800,0,8300,1700,6800
3349,10200,9700,0,-2000,0,17900
3350,-3400,-700,-1200,12200,0,6900
3351,-1900,9800,0,-1000,-950,5950
3352,11400,-4300,0,12000,-950,18150
3353,-1800,9000,0,-4900,2900,5200
3354,11800,-2300,-1200,-2500,750,6550
3355,-6900,200,1000,-3800,0,-9500
3356,-4000,7800,1900,-2800,0,2900
3357,-1200,-4400,0,9000,0,3400
3358,9200,-2800,-1200,400,-1200,4400
3359,-1300,-6100,-1200,1200,0,-7400
3360,-3600,10800,-1800,12000,-950,16450
3361,14000,-8500,4700,-5600,-950,3650
3362,-5000,12100,0,-2900,2900,7100
3363,9400,200,0,-4700,750,5650
3364,-5900,0,-1200,200,0,-6900
3365,700,9700,0,13200,-1200,22400
3366,6600,500,0,0,0,7100
3367,-2100,7700,0,0,-950,4650
3368,9900,-4300,0,0,0,5600
3369,-5900,-700,-1200,-2700,1950,-8550
3370,-5200,-2800,-1800,-3000,-950,-13750
3371,6100,12200,3500,-8100,1700,15400
3372,-1000,-2200,-1200,11400,-10200,-3200
3373,11000,9700,-2100,-2800,0,15800
3374,-900,-700,-1400,-1400,12000,7600
3375,7500,200,1000,-3800,0,4900
3376,-2400,12000,2300,3800,0,15700
3377,10100,-2300,-1200,200,0,6800
3378,-3300,100,-1800,0,0,-5000
3379,8400,200,3800,5400,0,17800
3380,400,-5400,1000,-2800,0,-6800
3381,5200,1200,2800,9200,0,18400
3382,-7500,-800,0,-1000,0,-9300
3383,-4500,-2100,0,0,0,-6600
3384,-3000,7700,0,12000,0,16700
3385,4400,300,0,0,0,4700
3386,8400,-2900,0,0,0,5500
3387,600,-4600,-1200,-800,0,-6000
3388,-1800,12100,0,200,-1200,9300
3389,8600,-600,0,-800,-1200,6000
3390,-2700,-3000,0,-600,-2400,-8700
3391,7700,13100,0,200,-2150,18850
3392,-4500,-2000,0,-1000,-950,-8450
3393,9200,-2100,0,-3900,1950,5150
3394,11000,-2300,-1200,-2700,1950,6750
3395,-5500,-2800,0,-1000,-950,-10250
3396,9400,-2300,-1800,-3900,1950,3350
3397,-1300,6800,3500,4900,750,14650
3398,5300,200,0,9200,-11150,3550
3399,-2000,-2100,0,-3900,2900,-5100
3400,11800,7400,0,-2900,1950,18250
3401,-2000,-500,0,0,12000,9500
3402,10200,-3000,0,12000,0,19200
3403,-6200,13100,0,-1000,0,5900
3404,10200,-3100,-1200,1200,0,7100
3405,-400,-4500,-900,0,0,-5800
3406,5300,12100,1000,-2800,0,15600
3407,-3800,-2800,2800,-2800,0,-6600
3408,-5400,-2200,0,-1000,0,-8600
3409,8300,7500,0,-2000,0,13800
3410,-3700,-2700,0,12000,0,5600
3411,5900,-3700,0,0,0,2200
3412,-6000,1000,0,-1000,0,-6000
3413,10900,7400,0,-2000,0,16300
3414,-6600,7000,0,-2000,0,-1600
3415,11600,-3700,-1200,200,0,6900
3416,400,-6200,-1200,-1800,0,-8800
3417,4400,-500,0,-1000,0,2900
3418,5800,10900,100,-5800,0,11000
3419,-4000,-800,1600,-3400,-1200,-7800
3420,9400,9700,0,11000,0,30100
3421,-4800,-1700,0,-2000,-950,-9450
3422,7100,0,0,0,0,7100
3423,1000,5200,-1200,7300,1950,14250
3424,7800,-600,0,0,0,7200
3425,-3900,-4200,-1800,-4900,1950,-12850
3426,6200,11400,4700,-6600,0,15700
3427,6600,-2000,0,11000,0,15600
3428,-5100,200,0,-2000,0,-6900
3429,9900,7600,-1200,-600,-1200,14500
3430,-2700,-3000,0,12600,-3600,3300
3431,-4500,-2100,0,0,0,-6600
3432,8400,-3100,-1200,12200,-950,15350
3433,-3600,10000,0,-2000,-950,3450
3434,10200,-2300,-1800,-3900,1950,4150
3435,-1800,11400,4700,-8500,1950,7750
3436,8600,100,0,-2000,-950,5750
3437,10300,0,0,6500,-8500,8300
3438,-6900,12400,0,-3900,1950,3550
3439,9400,-2200,0,0,12000,19200
3440,-2800,-2300,0,-1000,0,-6100
3441,10000,-2000,0,12000,0,20000
3442,-2800,-2900,0,-1000,0,-6700
3443,11700,-4500,0,-1000,0,6200
3444,-7100,400,0,-1000,0,-7700
3445,11800,5800,0,-1000,0,16600
3446,-5400,-1300,0,11000,0,4300
3447,9000,6800,0,1200,-1200,15800
3448,5900,-2000,0,-1800,-1200,900
3449,-3300,-6400,0,0,-950,-10650
3450,9900,6800,0,0,-950,15750
3451,-5200,-2900,0,-3900,2900,-9100
3452,13100,5200,0,-3700,750,15350
3453,-2900,-2800,0,0,0,-5700
3454,9900,6700,0,-3000,0,13600
3455,-2000,-2200,0,200,-2150,-6150
3456,8400,9100,-1200,-800,-950,14550
3457,-4200,-700,-1200,11500,1700,7100
3458,9200,-1200,-1800,-3900,1950,4250
3459,-6700,11200,4700,4800,-12350,1650
3460,-3100,-4100,0,0,0,-7200
3461,7000,12100,0,-4900,13950,28150
3462,-400,-4500,0,-1800,-2150,-8850
3463,10200,8100,-1200,10300,2900,30300
3464,-5300,1300,0,-1000,0,-5000
3465,10800,-4500,0,-2000,-950,3350
3466,-2700,9000,0,-1000,-950,4350
3467,7700,200,0,-6900,2900,3900
3468,5600,-2200,0,-3900,1950,1450
3469,-3300,11300,-1200,-800,0,6000
3470,7000,-600,-900,10200,-1200,14500
3471,-2200,-3700,-200,-2600,0,-8700
3472,-4900,12000,2800,7200,0,17100
3473,7700,200,0,0,0,7900
3474,-4200,100,0,-5000,0,-9100
3475,7400,-1900,-2100,14400,-1200,16600
3476,10100,-2200,1000,-4800,0,4100
3477,-1200,-5200,1600,-4600,-950,-10350
3478,-4100,-800,-10200,8200,-950,-7850
3479,7600,12200,0,-4900,2900,17800
3480,-1900,-2300,12000,-4900,1950,4850
3481,15000,-4600,-1200,-1800,0,7400
3482,7700,11200,-1800,10200,-1200,26100
3483,200,-4400,3500,-6000,-2400,-9100
3484,-3200,12000,0,13200,-1200,20800
3485,11800,-2200,0,-2000,-950,6650
3486,-7800,-1100,0,11000,-950,1150
3487,-11200,1400,0,-3900,1950,-11750
3488,-6100,9900,0,-3900,1950,1850
3489,12300,-6800,-1200,200,-950,3550
3490,-5300,-3000,0,9100,2900,3700
3491,3500,400,-1800,-2900,1950,1150
3492,-300,-4600,4700,-7600,0,-7800
3493,14100,4300,0,1200,-1200,18400
3494,6800,-600,0,11000,0,17200
3495,-6000,300,0,0,0,-5700
3496,11000,9700,0,-2000,0,18700
3497,300,-4300,0,13200,-1200,8000
3498,9400,8900,0,200,-1200,17300
3499,600,-2300,0,-2000,-950,-4650
3500,8400,11400,0,-2800,-1200,15800
3501,-1800,-2200,-2400,-1300,750,-6950
3502,8700,100,-2100,-800,-1900,4000
3503,-6800,12300,-200,-6500,2900,1700
3504,-1700,100,-200,-5500,1950,-5350
3505,6900,200,4700,-5600,-950,5250
3506,-2600,0,-1200,6300,2900,5400
3507,8200,-2000,-2700,-1000,0,2500
3508,-4100,0,4400,-6400,0,-6100
3509,-2100,-5200,0,10000,0,2700
3510,8300,-2000,0,-1800,-1200,3300
3511,8700,0,0,10000,0,18700
3512,-100,-2300,0,200,-2150,-4350
3513,-2700,10600,0,-1000,0,6900
3514,7600,-1400,0,6100,1950,14250
3515,-400,7500,-1200,-3700,1950,4150
3516,12400,-4600,-1800,-1000,0,5000
3517,11700,-4600,4700,4400,0,16200
3518,-3600,-1200,0,-1000,0,-5800
3519,-1300,7600,-1200,12200,0,17300
3520,-5100,0,0,0,0,-5100
3521,-4500,-2700,-2400,10400,0,800
3522,16300,2800,-1200,1200,0,19100
3523,-1700,-700,-2700,0,0,-5100
3524,11800,9800,3800,-6600,0,18800
3525,-2700,300,4700,-6600,0,-4300
3526,-3200,10400,0,-2000,0,5200
3527,-2000,-1200,0,-1000,0,-4200
3528,-4600,10100,0,10000,0,15500
3529,7100,100,0,200,-1200,6200
3530,-2700,-2200,0,10000,0,5100
3531,0,-800,0,1200,-1200,-800
3532,11100,0,0,-1000,-950,9150
3533,-900,11300,0,-1000,-950,8450
3534,6000,1000,0,-2900,2900,7000
3535,-5000,100,0,-3900,1950,-6850
3536,-4000,-4200,0,-1000,0,-9200
3537,-1800,-2200,0,-1000,0,-5000
3538,5200,300,0,11000,0,16500
3539,-300,-5300,0,1200,-1200,-5600
3540,8300,-3000,0,-1000,0,4300
3541,-7700,13200,0,0,-950,4550
3542,7500,-2800,0,-1000,0,3700
3543,-4300,9800,0,-5900,1950,1550
3544,11000,-2200,-10200,10400,-2150,6850
3545,-2800,-2900,0,-4900,2900,-7700
3546,10300,100,10800,1200,0,22400
3547,8600,12000,0,-2800,-1200,16600
3548,-800,0,-2400,-600,0,-3800
3549,-1800,0,-1800,12400,-2400,6400
3550,13300,-4500,4700,-6600,-950,5950
3551,-2500,0,0,200,-2150,-4450
3552,12600,-3000,0,-5900,1950,5650
3553,-4400,200,-1200,-2700,1950,-6150
3554,-6000,11500,-900,11000,-950,14650
3555,9300,-1300,-200,-8500,2900,2200
3556,-2700,-2200,2800,-4500,750,-5850
3557,-3300,-800,0,10000,0,5900
3558,9200,-2200,-1200,1200,-950,6050
3559,-4300,300,-3000,-800,0,-7800
3560,10100,9800,4700,1500,1950,28050
3561,-4500,-2100,0,200,-2150,-8550
3562,8400,-2200,0,8300,1700,16200
3563,-4400,-2900,0,200,-1200,-8300
3564,-100,-2300,0,0,-950,-3350
3565,8400,12300,0,9000,0,29700
3566,-1800,-3100,-1200,-2700,1950,-6850
3567,6800,400,-3000,-800,-950,2450
3568,400,7500,4700,-11500,2900,4000
3569,7000,0,0,1400,-2400,6000
3570,700,-3100,0,9000,0,6600
3571,9300,100,0,200,-2150,7450
3572,-1400,7500,0,-2000,-950,3150
3573,9200,-2100,0,9100,1950,18150
3574,-2000,-6000,0,-3900,1950,-9950
3575,-6100,-2100,0,-2000,-950,-11150
3576,-3500,9100,0,-4900,2900,3600
3577,-5900,200,-2400,9500,1950,3350
3578,-2200,-3600,-1800,-2000,0,-9600
3579,8900,7700,4700,-5600,0,15700
3580,8600,-3000,0,9000,0,14600
3581,-4300,-600,-1200,1200,0,-4900
3582,10000,9800,-1800,0,0,18000
3583,-1000,-2200,4700,4400,0,5900
3584,6900,11300,0,0,0,18200
3585,-7700,300,0,7400,-11400,-11400
3586,-3100,-4400,0,200,-1200,-8500
3587,13400,7400,0,0,12000,32800
3588,-5900,-700,0,-1800,-2150,-10550
3589,9500,100,0,1200,-2150,8650
3590,-3400,100,0,9100,2900,8700
3591,8600,12100,-1200,-2700,1000,17800
3592,-2000,-2200,0,200,-1200,-5200
3593,7000,100,0,-2900,1950,6150
3594,-3400,100,0,0,-950,-4250
3595,7700,200,-1200,-3700,2900,5900
3596,500,-6100,0,200,-1200,-6600
3597,8200,-1100,-3000,200,0,4300
3598,13400,-4600,4700,5400,-950,17950
3599,-3500,11500,-1200,200,0,7000
3600,12200,-6700,0,-3900,1950,3550
3601,-2400,0,-900,-2000,0,-5300
3602,-2600,11300,-200,-4500,1950,5950
3603,-2500,100,2800,7200,0,7600
3604,12000,12000,0,-800,-1200,22000
3605,-6100,200,0,0,0,-5900
3606,-2700,-3000,-2400,-1600,0,-9700
3607,6100,1000,-2100,13400,-1200,17200
3608,2800,-6900,1900,-4600,-1200,-8000
3609,10300,-700,-1400,12000,-2400,17800
3610,-1800,100,2900,-6600,-950,-6350
3611,-1900,9800,-1400,-1400,-950,4150
3612,7700,300,2800,-6700,1950,6050
3613,-1800,-3000,-1800,0,-950,-7550
3614,-4400,100,4700,-10500,2900,-7200
3615,-2600,9800,0,7100,1950,16250
3616,8700,100,0,-1000,-950,6850
3617,-1800,100,0,8100,2900,9300
3618,6000,200,-1200,200,0,5200
3619,-2200,-4200,0,-3000,0,-9400
3620,-1300,-5200,0,11000,0,4500
3621,15700,-6900,0,200,-1200,7800
3622,-4400,-500,-1200,10200,0,4100
3623,6100,11300,-3300,-1600,-950,11550
3624,-5200,-2100,-2300,-1400,-950,-11950
3625,500,-4600,2900,-10500,2900,-8800
3626,-1700,12100,-5500,-300,1950,6550
3627,10900,-3000,1900,-2600,-1200,6000
3628,-4500,11600,12000,-3000,0,16100
3629,10600,-3600,0,-3000,0,4000
3630,-1800,9700,0,13200,-1200,19900
3631,11000,-3100,0,-3000,0,4900
3632,-1200,-4500,0,11000,-950,4350
3633,1300,-5400,0,-2000,0,-6100
3634,-2600,12100,0,8300,750,18550
3635,10000,-2900,0,-1000,-950,5150
3636,1300,7500,0,-3900,2900,7800
3637,-3300,0,0,11000,0,7700
3638,3600,-7600,0,-1800,-1200,-7000
3639,-2700,11300,0,-800,-1200,6600
3640,-1800,9800,0,11000,-950,18050
3641,10900,-2200,0,-2000,0,6700
3642,-3500,12200,0,200,-2150,6750
3643,-2200,-4300,0,-3900,1950,-8450
3644,-1800,-3800,0,-3900,1950,-7550
3645,-5400,-2000,-10200,9200,-950,-9350
3646,-5600,8600,0,-4900,2900,1000
3647,10200,-3100,10800,-2700,1950,17150
3648,-1800,-3100,0,-2000,0,-6900
3649,10700,7600,0,-1000,0,17300
3650,2100,-4500,0,11000,0,8600
3651,11000,8900,0,-800,-1200,17900
3652,0,0,-1200,12200,0,11000
3653,9400,11300,-900,-1000,0,18800
3654,-3400,100,1000,-1400,-2400,-6100
3655,-800,12000,2800,-3800,0,10200
3656,-2000,-2200,0,-3000,-950,-8150
3657,-5900,300,-1200,400,-1200,-7600
3658,9100,-2100,0,-3900,1950,5050
3659,-5300,200,0,12200,-2150,4950
3660,-1300,-4400,-1200,-3700,1950,-8650
3661,10300,-3100,0,-4000,-950,2250
3662,-1200,-5400,-1800,-2900,2900,-8400
3663,-1200,7600,4700,-11500,1950,1550
3664,7700,0,-1200,11200,0,17700
3665,-2400,-5200,0,-2000,0,-9600
3666,6200,10500,-1200,-800,0,14700
3667,-1300,-2800,-1800,11000,0,5100
3668,500,7400,3500,-5400,0,6000
3669,-3300,-700,0,9000,0,5000
3670,9200,-3800,-1200,400,-1200,3400
3671,-4100,12900,-900,0,0,7900
3672,10800,-2900,1000,6400,-2150,13150
3673,6900,1000,1600,-1600,0,7900
3674,-1400,6800,0,-4900,1950,2450
3675,3300,500,0,-2000,-950,850
3676,-100,-2300,0,8100,2900,8600
3677,-5900,100,-1200,200,0,-6800
3678,-2100,7700,0,0,0,5600
3679,8400,-3700,-1800,11000,0,13900
3680,-4500,-1400,4700,-6600,0,-7800
3681,5700,-5100,0,0,0,600
3682,13800,5200,0,-2000,0,17000
3683,400,-5300,0,200,-1200,-5900
3684,7600,9900,-10200,20400,-1200,26500
3685,-10300,-400,-1200,1200,0,-10700
3686,1400,7400,0,-1000,-950,6850
3687,-6800,-600,12000,-1000,0,3600
3688,11900,8900,0,-2700,750,18850
3689,-1500,-5800,-1200,-800,-950,-10250
3690,8700,11300,-2100,-3700,2900,17100
3691,-1500,-4200,1000,-1600,-2150,-8450
3692,7600,-2900,2800,-7700,1950,1750
3693,-4100,12000,-2100,-1800,-950,3050
3694,8400,-500,-3300,-1500,2900,6000
3695,-4300,13000,2900,5400,0,17000
3696,9200,-2200,4700,-5600,0,6100
3697,-2800,-2800,0,11000,0,5400
3698,11700,-4600,0,-1000,0,6100
3699,-6800,300,0,12000,0,5500
3700,10100,9000,0,-1000,0,18100
3701,-4300,-2100,-1200,13200,0,5600
3702,4100,11600,0,-800,-1200,13700
3703,-2800,-1300,0,200,-1200,-5100
3704,8500,-3000,0,-800,-2150,2550
3705,400,-4400,0,-1800,-1200,-7000
3706,7000,12100,-3600,-1300,1950,16150
3707,4300,-1400,-1800,-2000,-1900,-2800
3708,-2700,-1400,1700,-7300,2900,-6800
3709,10700,7600,4700,-9500,1950,15450
3710,-1700,-2300,-1200,-1600,-2150,-8950
3711,9400,-700,-1800,-2900,2900,6900
3712,-1600,0,1900,8400,-1200,7500
3713,9300,10500,2800,-3800,-950,17850
3714,-6800,1900,-1200,11200,-950,4150
3715,9000,-4500,0,-3900,2900,3500
3716,-2800,-2200,-10200,6300,1950,-6950
3717,6100,-600,0,12000,0,17500
3718,-4400,-2200,12000,-1000,0,4400
3719,-6000,12100,0,-2000,0,4100
3720,5200,200,0,-1000,0,4400
3721,-1000,-2300,-1200,1200,0,-3300
3722,11300,-7500,-1800,12200,-1200,13000
3723,-4500,-1900,4700,-8600,0,-10300
3724,12500,-5400,0,200,-1200,6100
3725,-2100,9200,0,-1000,-950,5150
3726,7000,100,0,-3000,-950,3150
3727,-6700,12200,-1200,10700,500,15500
3728,9500,0,0,-5900,1950,5550
3729,-3400,12000,-1200,200,-950,6650
3730,10100,-2200,-1800,-2800,-2150,1150
3731,-2500,100,3500,-8300,2900,-4300
3732,7800,0,-1200,-1800,-950,3850
3733,0,0,-900,18300,-8250,9150
3734,9300,100,1000,-4800,-950,4650
3735,-5100,100,2800,-7700,13950,4050
3736,9200,-2000,0,-3900,2900,6200
3737,-4500,-2200,-11400,21400,0,3300
3738,13400,-6200,-1200,-800,0,5200
3739,-7700,1000,12000,0,0,5300
3740,7000,11300,-1800,-800,-1200,14500
3741,-1900,-2100,1900,9200,0,7100
3742,8600,0,1600,-2600,0,7600
3743,-3400,12000,0,-3000,0,5600
3744,9500,-800,0,-2000,0,6700
3745,-1500,-4300,0,11000,0,5200
3746,12400,-4400,0,-1000,0,7000
3747,-5400,-2700,0,-1000,0,-9100
3748,10700,-4400,0,0,0,6300
3749,-5900,12100,0,-1000,0,5200
3750,-3200,0,-1200,-1800,0,-6200
3751,5300,12200,0,-1000,0,16500
3752,400,-4400,-3000,1200,0,-5800
3753,6900,-600,4700,6400,0,17400
3754,-3700,-2000,0,0,0,-5700
3755,5200,100,-1200,-2800,0,1300
3756,-4400,9100,0,1200,-1200,4700
3757,10800,-4500,-1100,8400,0,13600
3758,-1700,100,700,-1600,-950,-3450
3759,10100,-2200,1000,-3800,0,5100
3760,-2700,11400,2800,-8700,1950,4750
3761,7800,100,-1200,200,-950,5950
3762,-5100,100,0,-3900,2900,-6000
3763,5200,100,0,-1000,0,4300
3764,600,7400,0,12000,0,20000
3765,9400,100,0,0,0,9500
3766,7700,200,0,12000,0,19900
3767,-7700,300,0,0,0,-7400
3768,-600,-6900,0,0,0,-7500
3769,8600,-700,0,0,0,7900
3770,-3100,-4200,0,0,0,-7300
3771,8200,-5200,0,200,-1200,2000
3772,-1000,9800,0,0,0,8800
3773,8400,-3800,0,0,0,4600
3774,6300,8800,0,0,0,15100
3775,-7200,-1900,0,-1000,0,-10100
3776,-1000,8900,-1200,-600,-1200,4900
3777,5200,-500,-1200,2400,-1200,4700
3778,8400,9900,-1800,-3000,-950,12550
3779,-4100,100,3500,-4200,-1200,-5900
3780,9600,-6800,-3000,-800,-950,-1950
3781,1400,7400,4700,-10500,1950,4950
3782,9300,-3900,0,-3900,1950,3450
3783,-4200,200,0,19200,-11150,4050
3784,6100,10500,0,-5700,1700,12600
3785,-600,-2700,0,-1700,750,-4250
3786,10100,-3000,0,11000,12000,30100
3787,-5100,12200,0,8200,-11150,4150
3788,7800,0,0,-1000,0,6800
3789,-4100,11200,-1200,-1700,1950,6150
3790,-1400,-4400,-1800,-3900,13950,2450
3791,10600,-4400,-5500,4000,-2400,2300
3792,-3000,-4400,0,-1000,0,-8400
3793,9900,7400,-1200,9400,-10200,15300
3794,-500,-5200,12000,-1000,-950,4350
3795,6900,-500,0,-2000,11050,15450
3796,-6000,9800,0,-3700,1700,1800
3797,-900,-2300,0,-1700,750,-4150
3798,9400,11300,0,-1000,0,19700
3799,-900,100,0,-1000,-950,-2750
3800,8700,0,-1200,-800,0,6700
3801,8400,12400,-900,10300,750,30950
3802,-5800,100,1000,-2800,-950,-8450
3803,-4300,100,2800,-5700,2900,-4200
3804,7600,-2100,0,-2000,0,3500
3805,1200,-4400,-10200,8200,0,-5200
3806,7000,-700,-1200,-800,0,4300
3807,0,0,12000,400,-2400,10000
3808,8600,12100,0,200,-1200,19700
3809,-800,0,0,12000,-950,10250
3810,9300,-600,0,0,0,8700
3811,-500,-3600,0,-2900,1000,-6000
3812,14200,-4600,0,0,-950,8650
3813,-1800,-700,0,-2900,2900,-2500
3814,-4200,200,0,-4900,1950,-6950
3815,-5400,10100,0,0,-950,3750
3816,1900,-6700,-2400,-2500,2900,-6800
3817,-6700,-700,-900,11000,0,2700
3818,-2800,-3000,1400,-4200,0,-8600
3819,12500,7400,-1800,-1000,0,17100
3820,-6000,300,3500,-5400,0,-7600
3821,14000,4300,-900,-1000,0,16400
3822,-2500,-800,-1400,8600,0,3900
3823,10200,200,2800,-2800,0,10400
3824,-1700,12000,-3000,-800,0,6500
3825,9500,0,4700,4400,0,18600
3826,-3600,12200,-1200,200,0,7600
3827,-2400,0,-900,8400,-11400,-6300
3828,-2300,-4100,2600,-6400,0,-10200
3829,-5000,0,0,-2000,12000,5000
3830,-2800,-2000,0,-1000,0,-5800
3831,9300,-2200,-1200,-800,0,5100
3832,-4500,-2800,-900,11000,0,2800
3833,11700,-4600,1000,-3800,0,4300
3834,1500,8900,1600,-2600,0,9400
3835,8500,100,0,11000,0,19600
3836,-5200,11600,-1200,-800,0,4400
3837,10700,-4400,-3000,1200,0,4500
3838,-5300,-1200,1900,9200,0,4600
3839,-6000,-500,2800,-2800,0,-6500
3840,-300,-4500,0,-2000,0,-6800
3841,8300,9900,0,1800,-4800,15200
3842,-3500,-2900,-2100,1200,0,-7300
3843,9800,-6100,-3000,200,-950,-50
3844,-2700,10700,5600,-5600,0,8000
3845,8900,6900,-1200,-3700,1950,12850
3846,-2600,-2200,0,-1000,-1900,-7700
3847,7500,-2900,-3000,-3700,2900,800
3848,-3000,7600,4700,1500,1950,12750
3849,1300,-5400,0,200,-2150,-6050
3850,7800,12000,0,8100,2900,30800
3851,-1000,-2300,0,-1000,-950,-5250
3852,9300,100,0,-3000,0,6400
3853,-2400,11200,-1200,10300,1950,19850
3854,12000,0,-1800,-1000,-950,8250
3855,-900,0,4700,-9500,2900,-2800
3856,0,12000,0,11000,0,23000
3857,11100,0,0,-800,-1200,9100
3858,-2600,100,-1200,-800,0,-4500
3859,500,-4600,-2100,12200,0,6000
3860,-1700,100,1000,-4800,0,-5400
3861,-1900,-2300,-7400,6400,0,-5200
3862,-5200,400,0,-1000,0,-5800
3863,9200,-3600,12000,1200,-1200,17600
3864,-5300,-1200,0,-3000,0,-9500
3865,-300,7500,0,-1000,-950,5250
3866,-800,-6500,0,-2000,0,-9300
3867,-3600,-3100,0,-5900,1950,-10650
3868,10800,-5300,0,200,-2150,3550
3869,11800,9000,0,-3700,1700,18800
3870,-2600,100,0,12000,0,9500
3871,-1600,12000,0,6200,-10200,6400
3872,10200,200,0,400,-3350,7450
3873,-2600,12100,-1200,-2700,13950,19550
3874,14000,-6800,0,-2000,-950,4250
3875,-1100,-3100,0,-4900,1950,-7150
3876,-800,0,-1200,2400,-2150,-1750
3877,-900,-2400,-900,8100,2900,6800
3878,-7700,14000,-200,-5500,1950,2550
3879,-1800,-2200,2800,-2800,0,-4000
3880,-4600,9900,0,11000,0,16300
3881,-6700,300,0,9400,-11400,-8400
3882,13300,-5400,-2400,400,12000,17900
3883,-2100,-4400,-1800,0,0,-8300
3884,5000,100,3500,-5400,-950,2250
3885,3400,1300,-1200,200,-950,2750
3886,9900,-4400,-1800,-3900,2900,2700
3887,-4200,-600,4700,-9300,750,-8650
3888,9300,9900,0,12000,0,31200
3889,-1100,-2300,-10200,8200,0,-5400
3890,-3700,9900,0,-1000,0,5200
3891,10100,-2900,12000,0,0,19200
3892,7600,300,0,-800,-1200,5900
3893,1200,4400,0,-1000,0,4600
3894,-6800,100,0,0,0,-6700
3895,-4400,9900,-1200,-800,-950,2550
3896,-1000,-2300,-1800,-1000,0,-6100
3897,9500,11200,3500,3700,1950,29850
3898,-3600,-500,-1200,-2700,1950,-6050
3899,6900,1000,-1800,-2000,0,4100
3900,10800,7600,4700,-7600,0,15500
3901,-1400,-4400,0,12000,0,6200
3902,-4100,-800,0,-2000,0,-6900
3903,10100,-2200,0,-1000,0,6900
3904,-3700,-2100,-1200,13400,-1200,5200
3905,-2900,9900,0,0,0,7000
3906,11600,-6000,0,0,0,5600
3907,5100,1200,0,-2000,0,4300
3908,-5100,11400,0,-800,-1200,4300
3909,-4200,100,0,0,0,-4100
3910,-5000,100,0,-1000,0,-5900
3911,4900,10000,-1200,200,-950,12950
3912,-3700,-3000,-900,-1000,-950,-9550
3913,9200,-1300,-200,-6500,2900,4100
3914,6500,-1900,2800,-8700,1950,650
3915,-4500,-3000,0,-2000,0,-9500
3916,-2200,-4300,0,-1000,0,-7500
3917,12600,6600,-1200,11200,0,29200
3918,-4500,-2200,-900,9200,-10200,-8600
3919,8400,-2900,-200,10400,12000,27700
3920,-4200,11300,2800,-2800,0,7100
3921,6600,-1400,0,-1000,0,4200
3922,-1500,5400,0,-1000,0,2900
3923,7000,-800,0,1200,-1200,6200
3924,-2300,-5200,-1200,11400,-1200,1500
3925,7500,10100,-1200,200,0,16600
3926,10700,-5200,-2700,0,-950,1850
3927,-600,-6700,5600,-7600,0,-9300
3928,6100,11400,0,-2700,750,15550
3929,-4400,-2900,0,-1800,-2150,-11250
3930,-8400,12400,0,-4700,1700,1000
3931,11500,-4400,0,-1000,0,6100
3932,-2100,-4500,-1200,12200,-950,3450
3933,6900,11300,-900,-1000,-950,15350
3934,-4400,-2100,1000,-7700,2900,-10300
3935,9200,9900,2800,5300,1950,29150
3936,-2100,-5200,0,-2000,0,-9300
3937,10000,7600,-1200,-1800,0,14600
3938,1100,-7700,0,-1000,0,-7600
3939,11700,7500,0,11000,0,30200
3940,-1000,-3100,0,-1000,0,-5100
3941,5200,-700,0,12000,0,16500
3942,-2200,6700,-1200,200,0,3500
3943,10800,-4400,0,0,0,6400
3944,-2700,9700,-3000,-800,0,3200
3945,10400,0,3500,-5400,0,8500
3946,-1800,11300,-900,-800,-1200,6600
3947,11100,100,3800,-5400,-1200,8400
3948,-7000,11500,0,0,0,4500
3949,7500,-1100,0,10200,-2150,14450
3950,8500,-2200,0,-3900,1950,4350
3951,500,6700,-1200,200,-950,5250
3952,-3600,-2200,0,8100,1950,4250
3953,-2800,-2000,0,-1000,-950,-6750
3954,7000,-800,0,-2700,1700,5200
3955,-5800,12200,0,-2900,1950,5450
3956,7700,200,0,11000,0,18900
3957,-5100,12000,-1200,200,0,5900
3958,14200,-4600,-900,-2000,0,6700
3959,-1800,0,1000,-3800,0,-4600
3960,12000,0,2800,7200,0,22000
3961,10200,100,-1200,1200,0,10300
3962,-5100,-600,0,-1000,0,-6700
3963,9200,-1400,0,-1000,0,6800
3964,-6700,100,0,0,0,-6600
3965,-4400,-3100,0,-3000,0,-10500
3966,-1600,0,0,0,0,-1600
3967,4100,400,0,-600,-2400,1500
3968,-3600,9800,0,11000,0,17200
3969,11700,-4500,0,0,-950,6250
3970,-3600,-3000,0,-2000,0,-8600
3971,7600,200,-11400,7500,1950,5850
3972,-3500,-2200,-900,200,-2150,-8550
3973,9200,10000,13000,-5700,2900,29400
3974,-2700,-3100,2800,-2800,-950,-6750
3975,10100,-2200,0,-2000,0,5900
3976,-1900,-2200,0,8700,-10650,-6050
3977,11800,9000,-1200,-800,-950,17850
3978,-1800,100,-1200,-2700,13950,8350
3979,9500,12100,-1800,0,0,19800
3980,1500,-2300,4700,-10500,1950,-4650
3981,-2700,-500,0,-1000,-950,-5150
3982,7900,100,0,7100,2900,18000
3983,-5100,200,0,400,-2400,-6900
3984,-3600,9900,0,-800,-1200,4300
3985,-900,-2300,0,12000,-950,7850
3986,8400,100,0,-3000,0,5500
3987,-100,-2300,0,-1700,750,-3350
3988,10200,-700,0,10000,-950,18550
3989,-1000,-2200,-1200,-2700,1950,-5150
3990,11100,0,-1200,-800,0,9100
3991,-1700,12100,0,-3900,1950,8450
3992,-1200,-4500,-900,-1000,-950,-8550
3993,-1700,-1600,-200,2700,-7300,-8100
3994,-2300,-4300,2800,-2800,0,-6600
3995,-2700,-1400,0,-2000,0,-6100
3996,8600,12200,0,-2000,12000,30800
3997,-4000,-4900,0,10000,0,1100
3998,-6700,100,-4500,1600,0,-9500
3999,5400,12200,100,-3800,0,13900
4000,-1300,-4400,1000,7400,-1200,1500
4001,10100,-3000,2300,-3200,0,6200
4002,-3800,-2000,1000,-4800,0,-9600
4003,13900,-7700,2800,-5800,0,3200
4004,-6700,12200,0,-4000,0,1500
4005,9300,-3000,-1200,13400,-1200,17300
4006,-3600,9700,0,-2000,0,4100
4007,8500,200,0,12000,-950,19750
4008,4300,2000,-1200,8400,-10200,3300
4009,-5300,300,-900,-3900,1950,-7850
4010,7000,200,1000,-3800,11050,15450
4011,-2700,9000,2800,-8700,2900,3300
4012,8600,100,-1200,200,0,7700
4013,-1900,-2300,0,9000,0,4800
4014,-2100,7400,-1200,200,0,4300
4015,9500,-700,-3000,11200,0,17000
4016,9400,100,3500,-5400,0,7600
4017,-1100,-2200,-900,-3000,0,-7200
4018,-1400,7700,1000,-2800,0,4500
4019,8700,0,2800,-3800,0,7700
4020,-4600,-2800,0,10000,0,2600
4021,-4600,-1900,0,-800,-1200,-8500
4022,-1000,9000,0,-1000,0,7000
4023,3500,200,0,11000,0,14700
4024,-3300,12100,0,-800,-1200,6800
4025,8200,-4300,-1200,200,0,2900
4026,-2700,-2900,0,0,-950,-6550
4027,8300,-2300,0,11000,0,17000
4028,-7600,200,0,-3900,1950,-9350
4029,10800,6700,-1200,200,-950,15550
4030,-1900,-3700,0,-3700,1700,-7600
4031,10800,-3800,-1800,-800,-1200,3200
4032,-2600,100,3500,-5400,0,-4400
4033,9800,7500,0,-1000,-950,15350
4034,-2700,-2200,-1200,9200,0,3100
4035,8400,9200,-1800,5500,-9450,11850
4036,-2500,0,2300,-6900,750,-6350
4037,9400,12100,-2100,1200,0,20600
4038,-1300,-4500,1000,-3800,11050,2450
4039,10800,-2800,2800,-3800,-950,6050
4040,1100,-7600,0,9300,1700,4500
4041,13000,-6600,0,-3900,1950,4450
4042,-5100,12200,0,-2000,0,5100
4043,-4100,-700,0,11200,-1200,5200
4044,300,7600,0,200,-1200,6900
4045,9300,-2900,0,12000,-950,17450
4046,-1100,9900,0,-2000,0,6800
4047,-5100,-700,0,-3700,750,-8750
4048,-2500,0,-1200,200,-950,-4450
4049,8400,9800,-900,-3900,1950,15350
4050,-1000,-2200,1900,-3800,-950,-6050
4051,10200,100,1900,5300,2900,20400
4052,-3300,12100,0,-2900,1950,7850
4053,10200,100,0,8200,-10200,8300
4054,-5400,-2800,0,-1000,0,-9200
4055,-6800,1100,0,10200,1800,6300
4056,4500,-700,0,-1000,0,2800
4057,-3800,-4300,0,200,-1200,-9100
4058,-2700,9800,0,1200,10800,19100
4059,8500,-2300,-1200,200,0,5200
4060,-3900,-2800,0,0,-950,-7650
4061,8300,-2000,0,200,-1200,5300
4062,400,6600,0,-2900,1950,6050
4063,7600,-2000,0,-2900,1950,4650
4064,9300,-2200,0,0,0,7100
4065,-4800,10400,0,-3000,0,2600
4066,11600,-1400,-1200,1200,0,10200
4067,-1000,9700,-1800,10000,0,16900
4068,9300,100,3500,-4200,-1200,7500
4069,-4100,-1500,-1200,200,0,-6600
4070,13200,-3600,-900,1200,-2150,7750
4071,-5200,12200,1900,-2800,0,6100
4072,9400,-3000,1900,-5700,1950,4550
4073,-1100,-2900,-1200,-800,-950,-6950
4074,-2300,-3400,0,-3900,2900,-6700
4075,10100,-2200,0,12000,0,19900
4076,1300,6600,0,-1000,0,6900
4077,-1300,-5300,0,0,0,-6600
4078,-2700,9900,0,10000,0,17200
4079,8500,200,0,-3000,0,5700
4080,-1000,9000,-2400,1400,0,7000
4081,1300,-4600,-900,-1800,-1200,-7200
4082,11100,100,1000,-1600,-1200,9400
4083,2200,6600,2800,-2800,-950,7850
4084,-900,-700,0,-3000,0,-4600
4085,-4400,13000,0,-3700,750,5650
4086,-4400,-2100,0,200,-2150,-8450
4087,-3400,-1500,0,6100,2900,4100
4088,-3500,-1400,0,1200,-2150,-5850
4089,-1600,12000,0,-1000,-950,8450
4090,11100,0,-1200,10300,1950,22150
4091,-1800,0,-1800,-2900,1950,-4550
4092,10300,0,-6700,3800,-950,6450
4093,11800,-2200,0,-2900,2900,9600
4094,-1000,-2300,0,-4900,1950,-6250
4095,-1800,100,12000,0,0,10300
4096,-4100,-700,0,0,0,-4800
4097,-4600,-1900,0,11000,0,4500
4098,-4600,9900,0,-1000,0,4300
4099,-8400,100,-1200,-600,-1200,-11300
4100,5800,-2000,-1800,-3000,0,-1000
4101,-3800,-2200,3500,-5400,0,-7900
4102,6200,-800,-1200,400,-1200,3400
4103,-2800,-3700,0,9000,0,2500
4104,7500,11600,-1800,-2000,0,15300
4105,-6700,100,4700,7800,-3350,2550
4106,8400,-2800,0,-1000,-950,3650
4107,-3800,7600,0,-4900,1950,850
4108,-5500,-1900,-1200,-1700,1950,-8350
4109,4900,-2900,0,12000,-950,13050
4110,9000,-4400,0,-3900,2900,3600
4111,400,-5300,0,-2900,1950,-5850
4112,9400,9800,0,12200,-1200,30200
4113,-2000,-5300,0,200,-1200,-8300
4114,7700,-3000,0,0,0,4700
4115,-4000,12000,0,0,-950,7050
4116,7700,-800,0,0,0,6900
4117,7700,13000,0,0,-950,19750
4118,1300,-4600,-1200,-3500,750,-7250
4119,11200,11200,0,-3900,2900,21400
4120,-7000,300,-1800,0,0,-8500
4121,8400,-2100,4700,-6600,0,4400
4122,200,-6800,-1200,11400,-1200,2400
4123,4400,11500,0,-1000,0,14900
4124,-4400,-2100,0,-2000,0,-8500
4125,-4900,-700,0,12400,-3350,3450
4126,9900,10700,0,0,-950,19650
4127,-3300,-800,-1200,-2700,2900,-5100
4128,4300,-600,-900,0,-1900,900
4129,-7300,-900,1000,-7700,1950,-12950
4130,6000,12200,2800,-5300,500,16200
4131,-4400,-2100,-1200,8300,1950,2550
4132,10200,-2300,0,-800,-2150,4950
4133,9700,-5200,0,0,0,4500
4134,-5900,100,0,8100,1950,4250
4135,-5100,100,-1200,-1800,0,-8000
4136,4500,12000,-2100,-4700,1950,11650
4137,-5900,-600,1000,-3800,0,-9300
4138,3700,1100,2800,5200,0,12800
4139,10400,-6700,0,0,0,3700
4140,-2200,-5200,0,11000,0,3600
4141,-1000,-3000,0,-1000,0,-5000
4142,11400,-6700,0,-1000,0,3700
4143,8500,9800,-1200,-4600,-1200,11300
4144,-1900,-3100,-2100,1600,-2400,-7900
4145,-3300,11300,1000,-4600,-2150,2250
4146,4000,100,2800,9400,-1200,15100
4147,2000,-6800,0,-4900,1000,-8700
4148,6600,10000,-11400,9400,-950,13650
4149,-4100,-1600,-900,-3500,500,-9600
4150,8400,-1300,13000,-7700,1000,13400
4151,600,7400,2800,-3800,-950,6050
4152,11700,-3100,0,7300,750,16650
4153,-1800,-600,0,-4900,1950,-5350
4154,8700,12000,0,12000,-950,31750
4155,-1800,100,-1200,-3700,2900,-3700
4156,9500,12000,-1200,-3500,750,17550
4157,-300,-2200,-1200,13400,-2150,7550
4158,11800,9800,-900,8100,1950,30750
4159,-4300,100,1000,-2800,0,-6000
4160,9300,-3100,2800,-3800,-950,4250
4161,-3500,200,0,8500,500,5700
4162,9200,-2000,0,-3900,1950,5250
4163,-4200,0,0,10000,-950,4850
4164,10700,7700,-1200,400,-1200,16400
4165,-4400,-2200,-3000,-2700,1950,-10350
4166,7700,-2200,4700,-6600,-1900,1700
4167,-1400,-2800,0,-6900,2900,-8200
4168,8400,9000,0,-3900,1950,15450
4169,2000,-6900,0,10000,-950,4150
4170,8400,-2900,0,-4900,2900,3500
4171,-3300,12100,0,-3000,0,5800
4172,10200,200,-3300,11400,0,18500
4173,-3600,-2200,-200,-2600,0,-8600
4174,8600,10500,1900,7200,0,28200
4175,6700,1100,1000,-3600,-1200,4000
4176,-4400,-2200,2800,-4800,0,-8600
4177,7900,12100,-1200,12400,-1200,30000
4178,-5100,100,0,-1000,0,-6000
4179,8400,-2100,0,12200,-2150,16350
4180,-5800,-700,0,-1000,0,-7500
4181,8900,-3500,0,-3900,1950,3450
4182,-6200,-2800,0,11000,-950,1050
4183,8500,-2200,-1200,-2500,1700,4300
4184,2200,7400,-10200,10200,0,9600
4185,8500,-1500,-1800,0,-950,4250
4186,-7100,-1000,16700,-5600,-950,2050
4187,5700,8900,0,-2900,2900,14600
4188,-7500,-800,0,-3900,1950,-10250
4189,7000,900,0,-1000,0,6900
4190,-4100,12100,0,0,0,8000
4191,5100,300,0,12000,0,17400
4192,13100,-6800,0,-2000,0,4300
4193,-3400,-6400,0,-1600,-2400,-13800
4194,12300,-7700,0,0,0,4600
4195,1400,-5400,0,-2000,0,-6000
4196,12600,8900,0,-2000,-950,18550
4197,-900,0,0,11200,-1200,9100
4198,8500,11300,0,-2700,750,17850
4199,-3700,-2000,-1200,-600,-2150,-9650
4200,6700,9800,0,-3700,750,13550
4201,-6600,100,0,0,-950,-7450
4202,9200,8300,0,8100,1950,27550
4203,7500,-1300,0,-2900,1950,5250
4204,-700,5400,0,-2000,-950,1750
4205,-6000,-1400,0,-3900,2900,-8400
4206,5200,1100,0,9100,1950,17350
4207,-4500,9900,0,-1000,0,4400
4208,13400,-6200,0,-2000,0,5200
4209,-5300,-1200,0,0,0,-6500
4210,11600,-6000,0,0,0,5600
4211,5900,13200,0,11000,0,30100
4212,-1700,-2300,-2400,600,-1200,-7000
4213,7300,10000,-1200,-1600,-1200,13300
4214,-5500,-2800,-3000,2400,-1200,-10100
4215,10700,-4400,2900,-6600,0,2600
4216,-2300,6800,1900,-2800,-950,2650
4217,7000,0,2800,-4800,-950,4050
4218,-5900,11300,0,-4900,2900,3400
4219,7800,100,0,19300,-8250,18950
4220,1400,-4600,0,-1000,0,-4200
4221,9200,9900,0,0,12000,31100
4222,-4900,100,0,0,0,-4800
4223,1700,-600,-1200,12400,-1200,11100
4224,-6800,200,-1200,-800,0,-8600
4225,8700,11300,-1800,-2000,-950,15250
4226,8200,-3500,3500,-6400,0,1800
4227,-3600,-2200,-1200,-1700,1950,-6750
4228,5100,-600,100,-3800,-950,-150
4229,-9300,400,2800,-6700,2900,-9900
4230,7500,10000,0,10000,0,27500
4231,-4400,-2200,0,0,0,-6600
4232,7900,0,0,-1000,0,6900
4233,-1800,-2200,0,11000,0,7000
4234,7500,-3700,0,8600,-12600,-200
4235,-4800,-3500,0,0,0,-8300
4236,6700,9900,-1200,200,12000,27600
4237,-1000,-3100,-1800,-3000,-950,-9850
4238,10200,-2200,3500,-4200,-2150,5150
4239,-5100,200,0,-4900,2900,-6900
4240,7800,11200,0,-4900,1950,16050
4241,6100,100,0,-1000,0,5200
4242,-1300,7700,0,8000,0,14400
4243,5000,-2100,-10200,10400,-1200,1900
4244,-5000,-600,0,0,0,-5600
4245,7600,-2200,12000,-3000,-950,13450
4246,-4300,-500,-1200,-600,-2150,-8750
4247,9200,10700,-3300,-1500,2900,18000
4248,-6700,100,100,-7700,1950,-12250
4249,10100,-3100,-6400,4600,0,5200
4250,-5300,1000,2800,-4800,0,-6300
4251,10100,-2900,12000,0,0,19200
4252,10000,-4500,0,-1800,-1200,2500
4253,1200,7500,0,9000,0,17700
4254,-3600,-3000,0,-1000,-950,-8550
4255,10000,-2000,0,11000,0,19000
4256,-1900,-3000,0,-3900,1950,-6850
4257,8300,9900,-1200,-2800,-950,13250
4258,8400,9100,0,-3700,1700,15500
4259,-2800,-2100,-1200,-600,-1200,-7900
4260,8600,-2200,-900,-3000,0,2500
4261,-2000,9000,700,8600,-1200,15100
4262,10100,-2200,1900,-4800,-950,4050
4263,-5100,12100,-1200,11200,-950,16050
4264,9200,-3700,-1800,-4500,500,-300
4265,-4500,-1300,4700,-10500,1950,-9650
4266,10800,-5300,0,12000,0,17500
4267,10900,-2100,0,-4000,-950,3850
4268,-2100,9900,-1200,12400,-2150,16850
4269,11100,-2300,0,-3900,2900,7800
4270,-7200,10000,0,9100,1950,13850
4271,-3700,-2900,0,-1800,-2150,-10550
4272,10700,-4500,0,0,-950,5250
4273,5500,-5000,-1200,8300,2900,10500
4274,-2800,9800,0,-2900,1950,6050
4275,-7600,-500,-3000,11200,0,100
4276,12100,5200,3500,-4400,0,16400
4277,-3300,-1500,-1800,-1000,0,-7600
4278,13900,6000,-5500,4600,0,19000
4279,9900,-4400,0,0,0,5500
4280,-4400,8300,12000,-2000,0,13900
4281,6800,-2100,-11400,11600,-1200,3700
4282,-2900,-4500,0,-1000,0,-8400
4283,10200,8900,12000,-1000,0,30100
4284,-1800,100,0,-2000,-950,-4650
4285,9600,12000,-1200,-800,-950,18650
4286,-400,-3000,-2100,-1700,2900,-4300
4287,8400,9800,1000,-6500,750,13450
4288,-1000,-3000,2800,-4800,0,-6000
4289,6400,-1000,-2100,8400,-10200,1500
4290,-2500,11300,1000,-2600,-1200,6000
4291,9500,-2300,2800,-5800,12000,16200
4292,-5200,12100,0,11000,-950,16950
4293,-2700,-2200,-10200,9200,0,-5900
4294,5300,200,-1200,-2700,1950,3550
4295,-3400,-700,0,-3000,-950,-8050
4296,3400,1200,9600,-500,2900,16600
4297,-2700,-2100,-900,-2000,0,-7700
4298,8400,-2100,1000,-3600,-1200,2500
4299,-3700,-3100,2800,-2800,0,-6800
4300,8400,-2100,0,10000,0,16300
4301,400,7400,0,0,0,7800
4302,14900,-7700,0,-1000,0,6200
4303,-3600,-500,0,11200,-1200,5900
4304,9600,12000,-2400,400,0,19600
4305,-2700,-600,0,0,-950,-4250
4306,8900,8500,-1800,-2000,0,13600
4307,9300,-2300,4700,-7600,-950,3150
4308,-8500,-600,-1200,-2700,2900,-10100
4309,-1200,-4500,-900,-8900,1950,-13550
4310,-6700,12100,1000,-2600,-1200,2600
4311,6900,-700,2800,7400,-1200,15200
4312,-5900,0,0,-800,-1200,-7900
4313,6600,9900,0,10000,-950,25550
4314,-5300,-2000,0,-2000,0,-9300
4315,7600,-2200,-1200,9300,1950,15450
4316,-5500,-3000,0,-3800,-2150,-14450
4317,7800,-6300,0,-4700,1700,-1500
4318,-600,-7600,0,400,-2400,-10200
4319,11000,9800,0,10200,-2150,28850
4320,-9400,-600,0,0,-950,-10950
4321,8200,6700,0,8100,1950,24950
4322,-7000,-1900,0,-4900,1950,-11850
4323,13100,5200,0,-1000,-950,16350
4324,-5200,-3700,0,-3500,-450,-12850
4325,4400,11500,-10200,19300,1950,26950
4326,-1300,-3500,0,0,-1900,-6700
4327,5800,-2800,12000,-2900,2900,15000
4328,-1100,7500,0,-4700,750,2450
4329,12900,-6800,-10200,7300,1950,5150
4330,-2600,8900,0,0,0,6300
4331,10900,-3100,12000,-3900,1950,17850
4332,-4200,12100,0,-800,-1200,5900
4333,11100,-700,0,-4000,0,6400
4334,-5100,12900,0,-1000,-950,5850
4335,7000,100,0,0,0,7100
4336,-600,-4400,0,8100,1950,5050
4337,6200,11400,0,-1000,-950,15650
4338,-3400,100,0,-4900,2900,-5300
4339,10400,0,0,-2000,0,8400
4340,-2700,12000,0,10000,0,19300
4341,9400,100,-1200,-1800,0,6500
4342,-300,-4600,-900,200,-1200,-6800
4343,9300,200,1000,-4800,0,5700
4344,-1600,-800,1600,9600,-1200,7600
4345,12600,-2200,0,0,0,10400
4346,0,12000,0,-2000,-950,9050
4347,11100,0,0,-1000,0,10100
4348,-2900,-2200,0,9100,1950,5950
4349,9000,-4300,0,-1000,-950,2750
4350,-5900,-800,0,-2700,1700,-7700
4351,10000,-4500,0,0,0,5500
4352,1500,9700,0,11000,0,22200
4353,-2600,-700,-1200,1200,0,-3300
4354,9500,0,0,0,0,9500
4355,9400,12100,-1800,-1000,0,18700
4356,1200,-4500,3500,-5400,0,-5200
4357,-1900,-2300,0,0,0,-4200
4358,-1900,-3000,0,-800,-1200,-6900
4359,-500,-4400,0,-1000,0,-5900
4360,1300,6600,0,12000,0,19900
4361,8300,-2200,-1200,-600,-2150,2150
4362,-2300,-5900,-1200,200,-950,-10150
4363,-2700,10600,-3000,-5700,2900,2100
4364,-4200,-700,2900,-9300,750,-10550
4365,-5200,9000,4700,-8400,-1200,-1100
4366,-400,-3700,0,200,-1200,-5100
4367,6600,9200,0,10000,-950,24850
4368,400,-4400,0,200,-2150,-5950
4369,9900,6800,0,6100,1950,24750
4370,-5300,-2100,-2400,-2500,1950,-10350
4371,11700,6600,-900,-1000,-950,15450
4372,12000,-800,1000,5300,2900,20400
4373,-5300,200,-800,-3700,-450,-10050
4374,10200,9800,0,20200,-10200,30000
4375,-1300,-4400,1000,-4800,-950,-10450
4376,-5900,12100,1900,-1600,-2150,4350
4377,-6100,-400,-2400,-5500,14900,500
4378,11000,-2300,-2100,-2700,1000,4900
4379,-2700,9900,100,8200,0,15500
4380,9000,-4300,3800,-10500,1950,-50
4381,-3600,-3000,400,10600,-950,3450
4382,13400,-4600,-1800,-2900,2900,7000
4383,-2600,-800,4700,4400,0,5700
4384,-1800,11300,0,0,0,9500
4385,6100,100,-10200,7200,0,3200
4386,-4500,9200,-1200,10200,0,13700
4387,4400,1100,0,-2000,0,3500
4388,-4400,-1300,12000,-1800,-1200,3300
4389,12200,-7500,-1200,400,-1200,2700
4390,-2600,200,-3000,-800,0,-6200
4391,8600,-1600,4700,-6400,-2150,3150
4392,-7100,10900,-1200,200,0,2800
4393,6700,-2200,0,7300,750,12550
4394,-6900,12400,-1800,-1000,-950,1750
4395,8300,-2100,3500,-9300,1950,2350
4396,-3500,-2100,0,11200,-1200,4400
4397,10000,-5400,0,-4700,750,650
4398,-1800,-2200,0,-2000,0,-6000
4399,10700,6800,0,10300,750,28550
4400,-2900,-2200,-1200,200,-950,-7050
4401,9800,-5100,-1200,11200,-950,13750
4402,-2400,4500,-1800,-2900,2900,300
4403,9800,-5200,3500,-10300,1950,-250
4404,-7800,10000,0,13200,-1200,14200
4405,8500,-2300,-1800,-1000,0,3400
4406,-1200,6800,4700,-7400,-1200,1700
4407,-5300,-2200,0,13200,-2150,3550
4408,11900,8900,-1200,-2600,-2150,14850
4409,6700,200,0,-2700,750,4950
4410,-6000,300,0,9100,1950,5350
4411,10900,7400,0,-800,-3100,14400
4412,-1100,-2900,0,-2900,2900,-4000
4413,6000,-700,-1200,-2700,1950,3350
4414,-3700,10700,0,11000,-950,17050
4415,12500,-4600,-900,-2700,1700,6000
4416,-9200,11200,3800,-8500,1950,-750
4417,8100,-3400,0,0,-950,3750
4418,-9400,13300,-1200,11400,-1200,12900
4419,7800,100,0,-2900,1950,6950
4420,-4400,-2200,0,-2900,1950,-7550
4421,5400,12200,0,12000,0,29600
4422,11600,-4600,0,-1000,0,6000
4423,-1300,-5100,0,0,0,-6400
4424,5800,-2000,0,11000,0,14800
4425,-6900,-400,-1200,1200,0,-7300
4426,11000,9700,-900,0,0,19800
4427,-5000,0,1000,-2800,0,-6800
4428,6000,12300,2800,-2800,0,18300
4429,-3100,-4400,0,0,0,-7500
4430,11700,-4500,0,-2000,0,5200
4431,-5300,-2900,-1200,1200,0,-8200
4432,8400,-3000,0,0,0,5400
4433,-1300,7500,0,-800,-1200,4200
4434,7800,100,0,-1000,0,6900
4435,400,6600,0,0,0,7000
4436,8500,-2300,0,-1000,-950,4250
4437,9400,11300,-1200,-800,-950,17750
4438,-2800,-2200,0,-3900,2900,-6000
4439,7000,100,-900,-5900,1950,2250
4440,-3200,6300,1000,-2600,-1200,300
4441,8200,-3400,2800,-5800,0,1800
4442,-4600,-2000,0,12000,0,5400
4443,7200,11200,0,-2000,0,16400
4444,8600,-6500,0,10000,0,12100
4445,-1900,-2300,-1200,400,-1200,-6200
4446,10200,9000,0,12200,-1200,30200
4447,-5100,100,0,-600,-3350,-8950
4448,11900,8900,-1200,-800,0,18800
4449,-3900,-2700,-3000,-1500,750,-10350
4450,7500,-1200,4700,-6600,-1900,2500
4451,-900,9700,0,-4900,2900,6800
4452,12400,-5300,-1200,-2700,1000,4200
4453,-4600,-1900,-1200,11200,-950,2550
4454,13000,4400,-1800,-3700,1700,13600
4455,-6700,100,2300,-9100,1950,-11450
4456,-5100,11500,-4200,20700,-8250,14650
4457,8700,0,3800,-6600,0,5900
4458,-4300,-2200,1000,-2800,0,-8300
4459,12600,8900,1600,8400,12000,43500
4460,-1700,900,-2100,-1800,0,-4700
4461,9500,-800,1000,-2800,0,6900
4462,-5200,1100,1600,9400,0,6900
4463,11200,-6600,0,8200,-10200,2600
4464,-6900,-600,-900,-1000,0,-9400
4465,10800,-4400,1000,-3800,0,3600
4466,-3000,7000,2800,-2800,12000,16000
4467,-600,-6800,0,8200,-10200,-9400
4468,-2800,-2800,0,-1000,0,-6600
4469,9100,5800,0,-1000,0,13900
4470,-2100,-3500,0,-4000,12000,2400
4471,7700,11300,0,-1000,0,18000
4472,500,-4500,0,9200,-10200,-5000
4473,8300,-2800,0,-2000,0,3500
4474,1200,7600,-1200,400,10800,18800
4475,6200,-600,-1200,-800,0,3600
4476,-3800,10000,-2100,-600,-1200,2300
4477,-3700,-2100,1000,-2800,-950,-8550
4478,-2700,9800,2800,-4600,-2150,3150
4479,5800,-2700,0,-3900,2900,2100
4480,1100,-6700,0,7100,1950,3450
4481,5000,9300,0,-2000,-950,11350
4482,-3700,-2200,0,22400,-12350,4150
4483,9300,9000,0,-3900,2900,17300
4484,-4200,100,0,-2700,750,-6050
4485,6700,9800,0,-1800,10800,25500
4486,-300,-4500,0,-1800,-2150,-8750
4487,10200,8900,-1200,200,0,18100
4488,-1700,0,-900,-4900,1950,-5550
4489,11100,-800,1000,-2400,-4300,4600
4490,-4300,12100,2800,4300,2900,17800
4491,10700,-4400,0,-3900,1950,4350
4492,-1000,8900,0,-3700,-200,4000
4493,8500,1000,0,11000,-950,19550
4494,-1900,-3900,0,-3500,500,-8800
4495,10000,-1200,-1200,9300,1950,18850
4496,-4400,9900,-1200,-800,0,3500
4497,-3300,0,-2100,1200,-950,-5150
4498,-1000,-3100,1000,5300,1950,4150
4499,-2000,-2000,1600,-2600,-950,-5950
4500,10900,9700,-1800,-2700,1700,17800
4501,-2500,100,4700,-5600,0,-3300
4502,10300,-700,0,-1000,-950,7650
4503,-7700,200,0,11000,0,3500
4504,-300,7400,0,-2900,1950,6150
4505,6800,300,0,11000,0,18100
4506,-7800,200,-1200,-2700,1950,-9550
4507,9200,-2300,0,-1000,0,5900
4508,-2600,-2300,0,-1000,0,-5900
4509,8100,-5200,0,12000,0,14900
4510,-5100,-600,0,-2000,0,-7700
4511,11600,7500,0,-1000,0,18100
4512,-4400,-2000,0,0,0,-6400
4513,12500,6600,0,12200,-1200,30100
4514,-2000,-2000,0,-2000,0,-6000
4515,9200,-2200,0,200,-1200,6000
4516,-2800,9000,0,-1000,0,5200
4517,10800,-4400,0,200,-2150,4450
4518,500,6600,-2400,400,0,5100
4519,0,0,-900,-3900,1950,-2850
4520,10200,-600,1000,-5700,1950,6850
4521,-6800,11500,2800,-3800,0,3700
4522,-4400,-1300,-10200,9200,0,-6700
4523,-700,-6900,0,0,0,-7600
4524,-3600,9900,12000,-4000,0,14300
4525,9500,-800,0,-1000,0,7700
4526,-800,0,0,13400,-2400,10200
4527,11100,12000,-1200,-1800,0,20100
4528,-1800,100,-2100,-600,-2150,-6550
4529,8700,0,-1100,-4400,-1200,2000
4530,-9600,700,3800,-11500,1950,-14650
4531,-3700,-2100,1600,-2400,-3100,-9700
4532,-7700,200,0,-4900,2900,-9500
4533,10700,-5400,0,-4900,1000,1400
4534,9300,-2200,0,21400,-12350,16150
4535,-5400,9300,0,-4900,2900,1900
4536,6600,-2800,0,5300,3750,12850
4537,-3500,-1400,0,-3000,-950,-8850
4538,11600,7500,0,-4900,14900,29100
4539,-6100,-3000,0,-800,-1200,-11100
4540,8900,-4300,0,11200,-1200,14600
4541,-5300,9200,0,-800,-2150,950
4542,10100,-3100,0,11000,0,18000
4543,-1200,5800,0,-3900,1950,2650
4544,4900,-300,-1200,10200,-1900,11700
4545,500,6700,0,-3900,2900,6200
4546,11000,-3100,-3000,-2700,1950,4150
4547,-6100,-1900,4700,-6600,-950,-10850
4548,5700,9100,0,9100,2900,26800
4549,1100,-6000,0,-2000,0,-6900
4550,-5100,-600,0,-2000,0,-7700
4551,7900,10500,0,21400,-11400,28400
4552,-4000,8400,0,0,0,4400
4553,6200,100,0,-1000,0,5300
4554,12200,-7600,-1200,1200,12000,16600
4555,300,5200,-900,-2000,0,2600
4556,-2200,-4400,2600,-4200,-1200,-9400
4557,5300,-600,-1200,-800,0,2700
4558,3600,11300,-1200,200,-950,12950
4559,-1600,-6700,-13200,9600,-1200,-13100
4560,13400,6600,3800,-9500,1950,16250
4561,-4600,-2000,13000,-6500,750,650
4562,9400,-3000,1600,-4600,0,3400
4563,-2700,12200,0,-800,-2150,6550
4564,5800,-1900,0,-800,-2150,950
4565,-4900,7800,0,9100,2900,14900
4566,8800,-1600,0,-2900,1950,6250
4567,-7900,10800,0,9200,-2150,9950
4568,3200,-2700,-1200,200,-950,-1450
4569,-5700,11200,-900,-2900,2900,4600
4570,4100,-1000,-200,5500,1950,10350
4571,-3600,-2100,-7400,6400,0,-6700
4572,7600,8900,0,0,0,16500
4573,-900,-2300,12000,-2000,0,6800
4574,9000,-4400,0,-1000,0,3600
4575,-1500,7000,-1200,13200,0,17500
4576,10100,-2300,-900,0,0,6900
4577,-3600,-3000,3800,-6600,0,-9400
4578,7300,7600,-1200,1400,-1200,13900
4579,-1000,-3000,0,-1000,0,-5000
4580,7000,12100,0,-1800,-2150,15150
4581,-3700,-2100,-1200,11200,0,4200
4582,9300,-3700,-1200,-2700,1950,3650
4583,-3700,10700,-1800,-1000,-950,3250
4584,12500,-4600,4700,-10500,2900,5000
4585,-4100,7100,-1200,1200,0,3000
4586,11600,-4400,-900,-3000,0,3300
4587,4400,-500,1000,-3800,0,1100
4588,-3800,7700,2800,8200,0,14900
4589,-1900,-3000,0,-1000,0,-5900
4590,8300,9900,0,11000,0,29200
4591,-3600,-2900,-1200,200,0,-7500
4592,9300,9800,0,0,0,19100
4593,9600,0,0,8000,0,17600
4594,-4500,-2200,-3300,3800,-2400,-8600
4595,10700,7700,-200,-3600,0,14600
4596,-2800,-3800,-500,-1400,-950,-9450
4597,6900,200,-1100,-2400,-1200,2400
4598,-1400,7700,3800,-10500,1950,1550
4599,6600,-2000,1600,-3400,-2150,650
4600,-4200,12100,-1800,8100,1950,16150
4601,4400,-400,4700,-9500,1950,1150
4602,8500,-2200,0,10000,0,16300
4603,-1800,9700,0,-2900,1950,6950
4604,6000,300,-10200,8200,0,4300
4605,-2800,-2900,0,11000,0,5300
4606,5000,-1900,-2400,10600,-10200,1100
4607,-3500,-2200,11100,-1000,0,4400
4608,9200,-3000,1000,-2800,0,4400
4609,-2200,-3700,2800,-2800,12000,6100
4610,4000,9300,0,-1000,0,12300
4611,-4400,-2300,0,0,0,-6700
4612,11700,6600,0,-1000,0,17300
4613,-4500,-3000,0,-1000,0,-8500
4614,6600,9300,-10200,9200,0,14900
4615,-2900,-3600,0,-1000,0,-7500
4616,6100,100,10800,1400,-1200,17200
4617,-4400,9100,0,0,0,4700
4618,11700,-4500,0,0,-950,6250
4619,-900,-800,0,0,0,-1700
4620,11100,12100,-1200,-3700,1950,20250
4621,-2600,12100,-900,0,-950,7650
4622,-1800,-2300,1000,-6700,2900,-6900
4623,11300,-4300,2800,-2800,0,7000
4624,-1900,-3000,0,-800,-1200,-6900
4625,10700,-4400,0,0,0,6300
4626,-400,-5400,-1200,9200,0,2200
4627,7000,12100,0,200,-1200,18100
4628,10100,-3100,0,-2000,0,5000
4629,-1800,12100,-1200,-800,-950,7350
4630,-3100,-4200,-900,-2000,-950,-11150
4631,7600,9100,3800,3900,500,24900
4632,-3800,-2000,0,-3900,1950,-7750
4633,14800,5100,0,-2000,0,17900
4634,8700,-700,0,-800,-2150,5050
4635,-1800,-2200,0,10000,-950,5050
4636,9500,12000,0,-2700,1700,20500
4637,-900,-700,0,-4900,1950,-4550
4638,10600,-4500,-1200,11400,-1200,15100
4639,-5900,11300,0,9200,-11150,3450
4640,4400,1100,0,1200,-2150,4550
4641,1400,-4600,0,-2900,14900,8800
4642,-4700,-2700,-1200,-2500,-200,-11300
4643,9500,0,0,-1000,0,8500
4644,-3500,-2100,-1800,-2700,750,-9350
4645,-2900,9000,4700,6400,-950,16250
4646,4300,400,0,-3900,1950,2750
4647,-5000,200,0,0,0,-4800
4648,4300,-500,0,11000,-950,13850
4649,-800,6200,0,-1700,1700,5400
4650,6200,100,0,-4900,1950,3350
4651,-6900,-1300,-1200,1200,0,-8200
4652,6100,900,0,-1800,-1200,4000
4653,-2100,7500,-1200,12200,0,16400
4654,8500,-2100,-2700,-1000,0,2700
4655,-4200,-1500,4400,-4200,-2150,-7650
4656,12400,-4400,0,-2000,-950,5050
4657,4600,7900,0,-4900,2900,10500
4658,-6900,-300,0,-3700,750,-10150
4659,6700,-1400,0,11000,0,16300
4660,-4900,11200,-1200,-2800,-950,1350
4661,10800,-4600,-11100,9200,0,4300
4662,-7100,-2000,1000,-6700,1950,-12850
4663,10100,9100,14800,-4800,0,29200
4664,-6100,-2800,0,-3500,-450,-12850
4665,11600,-3600,0,-1000,0,7000
4666,-5000,11200,-1200,11200,0,16200
4667,7000,-700,0,-800,-2150,3350
4668,-6200,-1300,0,12000,-950,3550
4669,7000,12200,0,-4900,2900,17200
4670,-1800,-2300,0,-1700,750,-5050
4671,9500,0,0,0,0,9500
4672,-3400,-800,0,11200,-2150,4850
4673,11100,-800,0,1400,-2400,9300
4674,-4600,10100,0,-2900,1950,4550
4675,9100,-2000,0,-1000,-1900,4200
4676,-7900,-1200,0,-2700,1700,-10100
4677,11600,-4500,0,-3900,1950,5150
4678,-1800,-3000,0,12000,-1900,5300
4679,8200,-4500,0,-3700,1700,1700
4680,-3000,-5100,0,-2700,750,-10050
4681,11000,8200,0,-1000,0,18200
4682,-6200,1200,0,-3900,1000,-7900
4683,9900,7600,0,12200,-2150,27550
4684,-1900,-3000,0,-3900,2900,-5900
4685,9400,-2200,-1200,-3700,1950,4250
4686,4300,12200,-2100,-800,0,13600
4687,-200,-5400,1000,-4800,0,-9400
4688,10200,12100,2800,5600,-11400,19300
4689,-3500,100,0,13200,-1200,8600
4690,9600,-4100,0,0,0,5500
4691,-2700,9700,0,-2000,11050,16050
4692,9300,-3100,0,-3900,1950,4250
4693,-5300,-2000,0,0,0,-7300
4694,6800,9100,-10200,5300,1950,12950
4695,-4500,-2100,0,0,0,-6600
4696,13300,7400,0,9200,-10200,19700
4697,-2500,-1500,12000,-1000,0,7000
4698,6600,-1200,0,200,-1200,4400
4699,-700,4500,0,-1000,12000,14800
4700,8800,0,-1200,-800,-950,5850
4701,-1200,9100,-900,0,-950,6050
4702,7800,0,1900,-7700,2900,4900
4703,-2600,100,1900,-7700,1950,-6350
4704,9300,9800,-1200,1200,0,19100
4705,-300,-2100,-1200,-2800,0,-6400
4706,4200,-500,-1800,-1000,0,900
4707,-6700,300,4700,4400,0,2700
4708,13800,-6700,0,-1000,0,6100
4709,1100,4500,0,11000,0,16600
4710,10100,-2200,0,9200,-10200,6900
4711,2900,-6900,0,-1000,0,-5000
4712,4000,11700,0,-1000,12000,26700
4713,-900,-3100,0,0,0,-4000
4714,10800,-4400,0,-1000,0,5400
4715,-2600,9700,0,-1000,0,6100
4716,6800,-500,0,11000,0,17300
4717,-6000,12200,0,0,0,6200
4718,9300,-2200,0,-1000,0,6100
4719,-1000,9700,0,200,-1200,7700
4720,13400,-3100,0,-1000,0,9300
4721,-1800,200,-1200,-800,0,-3600
4722,7800,12200,0,-800,-1200,18000
4723,-4200,100,0,400,-2400,-6100
4724,-1000,-2300,0,1200,-2150,-4250
4725,400,-5300,0,0,-950,-5850
4726,-6100,300,0,-3900,1000,-8700
4727,8600,-2200,0,-3900,2900,5400
4728,-3500,12200,0,-2900,1950,7750
4729,-3300,-700,0,-2000,-950,-6950
4730,10300,0,0,9100,2900,22300
4731,-1600,12000,0,0,0,10400
4732,7600,100,0,8200,-10200,5700
4733,-200,-2200,0,0,0,-2400
4734,9200,-2100,0,-2000,0,5100
4735,-2800,-2200,-1200,400,10800,5000
4736,-3400,100,0,-1000,0,-4300
4737,8900,-5000,-5400,-400,0,-1900
4738,-3800,-4500,2900,-5600,-950,-11950
4739,-2600,9000,4700,-6600,-950,3550
4740,7500,-2000,0,-5900,2900,2500
4741,1000,-8300,0,-5900,1950,-11250
4742,5200,12200,-1200,21400,-10200,27400
4743,-1000,-2200,-1800,-2000,0,-7000
4744,-4400,9100,4700,-5600,0,3800
4745,10100,-1400,0,-1000,12000,19700
4746,-6000,11400,-10200,19400,-1200,13400
4747,7400,-2000,0,-3000,0,2400
4748,-2100,-4500,10800,200,0,4400
4749,9200,9800,0,0,0,19000
4750,10600,-5100,0,-4000,0,1500
4751,-5300,-2200,0,-1000,0,-8500
4752,-6800,-500,0,-2000,0,-9300
4753,13300,7400,-1200,12400,-1200,30700
4754,-5400,-2900,0,0,0,-8300
4755,3500,11600,-1800,-3000,-950,9350
4756,-4900,900,4700,-5600,-950,-5850
4757,10000,-4500,0,8100,2900,16500
4758,-1000,9700,0,-3900,1950,6750
4759,7900,-800,0,-800,-1200,5100
4760,-1100,-2200,0,-1000,0,-4300
4761,9700,7400,-1200,11200,0,27100
4762,-2800,-3000,-1200,1200,0,-5800
4763,3500,300,-2100,11200,0,12900
4764,-5200,9800,-200,-1600,0,2800
4765,9500,-800,1000,-3800,0,5900
4766,-5100,-600,4700,-4200,-2400,-7600
4767,8700,12900,-1200,200,0,20600
4768,-5200,200,0,-4000,0,-9000
4769,8100,-4200,0,1200,-2150,2950
4770,-1400,-4400,0,12000,-950,5250
4771,6900,-500,0,-3900,1950,4450
4772,500,-4600,-1200,-2300,-450,-8050
4773,7000,100,-900,-1000,-950,4250
4774,-6200,8900,1000,-7700,1950,-2050
4775,6900,200,2800,-2800,-950,6150
4776,-5000,12000,0,8100,1950,17050
4777,7700,100,0,-2900,2900,7800
4778,-4200,100,0,-3900,1950,-6050
4779,6200,0,0,12000,0,18200
4780,-2700,-2200,0,0,0,-4900
4781,10800,-2300,0,12000,0,20500
4782,-1700,-700,0,0,0,-2400
4783,8600,-700,0,0,0,7900
4784,-4200,12100,0,0,0,7900
4785,5900,1100,0,-1000,0,6000
4786,-700,-6700,0,200,-1200,-8400
4787,9900,-4300,0,-1000,0,4600
4788,-3600,-3000,0,200,-1200,-7600
4789,6500,-2700,-1200,-800,0,1800
4790,-2600,9000,0,-1800,-2150,2450
4791,5300,1100,0,200,-2150,4450
4792,-4400,9800,-11400,6500,2900,3400
4793,9500,0,0,0,-1900,7600
4794,-3600,-500,-2700,-2900,2900,-6800
4795,9300,-2200,17600,-10500,1950,16150
4796,-4400,9800,-1200,-800,-950,2450
4797,6600,-2200,-1200,-3700,2900,2400
4798,7900,0,-900,12000,0,19000
4799,-3800,-2900,1000,-6800,0,-12500
4800,-400,-5300,2800,8200,0,5300
4801,7500,-1300,0,-1000,0,5200
4802,-6900,11500,0,-3000,0,1600
4803,7500,-2800,-2400,-600,0,1700
4804,9100,8400,-2100,11400,-1200,25600
4805,-700,-7500,-200,-6600,0,-15000
4806,9900,-4400,-6400,4600,0,3700
4807,-400,-5300,700,-5600,0,-10600
4808,6200,11400,12000,9200,-10200,28600
4809,-2600,-7400,0,-3000,0,-13000
4810,-8000,9200,0,-2600,-2400,-3800
4811,7600,-1300,-2400,1400,12000,17300
4812,-5700,6000,-1800,10000,-950,7550
4813,7900,100,4700,-6600,0,6100
4814,7500,9900,-12600,4900,750,10450
4815,-3400,-2200,-2100,-1600,-2150,-11450
4816,9000,-4300,11200,-6700,1950,11150
4817,-4900,11200,7500,-9400,0,4400
4818,7000,0,-10200,17300,1950,16050
4819,100,5300,0,-4900,1950,2450
4820,9600,-2400,0,-2000,0,5200
4821,-1400,9300,10800,-800,0,17900
4822,6100,200,0,11000,0,17300
4823,-6800,11500,-1200,9400,-10200,2700
4824,7800,-2300,0,12000,0,17500
4825,-12200,14300,-900,0,0,1200
4826,8600,-1400,1000,-2800,12000,17400
4827,-3600,-2100,2800,-2800,0,-5700
4828,13700,-9000,-1200,-800,0,2700
4829,-7700,-600,0,10200,-10200,-8300
4830,5200,200,0,0,0,5400
4831,-2700,-3100,0,200,10800,5200
4832,4400,12300,0,0,0,16700
4833,-3200,0,0,0,0,-3200
4834,13300,6600,0,0,-950,18950
4835,-1700,900,0,-2000,-950,-3750
4836,10900,-3100,0,-2900,2900,7800
4837,0,-800,0,-3900,1950,-2750
4838,7600,13100,0,-1000,0,19700
4839,-400,-4500,0,-1000,0,-5900
4840,8600,100,-1200,-800,0,6700
4841,9100,-2900,-900,-2000,0,3300
4842,-5900,-1400,-200,-3600,0,-11100
4843,-6700,9700,1600,-3600,0,1000
4844,10300,-2300,-1200,11200,0,18000
4845,11400,-7600,-12000,9200,0,1000
4846,-2600,-3100,4700,-6200,-2400,-9600
4847,7700,12300,0,0,0,20000
4848,-1300,-4500,12000,-2000,-950,3250
4849,10100,9900,0,-3000,0,17000
4850,-4300,-700,0,9300,750,5050
4851,8700,100,-1200,-1800,-950,4850
4852,-300,9900,-2100,-4700,2900,5700
4853,400,-5400,-200,-3400,-1200,-9800
4854,10400,0,1000,8200,0,19600
4855,13500,-2300,4700,-6600,0,9300
4856,-900,11300,-1200,-800,-950,7450
4857,11100,100,0,-2000,0,9200
4858,-1700,100,0,8100,1950,8450
4859,10400,12000,0,-1000,-950,20450
4860,-5300,200,-1200,6300,2900,2900
4861,-900,-2300,-900,200,-1200,-5100
4862,12900,-6700,1000,-3800,0,3400
4863,10800,-5300,2800,8200,0,16500
4864,-2500,100,0,-2000,0,-4400
4865,-2900,-2800,0,11000,0,5300
4866,7000,12200,0,-800,-1200,17200
4867,-1800,-2200,0,0,0,-4000
4868,-5100,11300,0,12000,-950,17250
4869,7400,-1200,-1200,200,-950,4250
4870,-2800,-3000,0,-3700,1700,-7800
4871,9900,-4500,0,-3900,1950,3450
4872,-8000,-2500,0,200,-1200,-11500
4873,4800,9300,0,-2000,0,12100
4874,-4900,900,-10200,10200,-950,-4950
4875,10100,-2200,0,-2000,-950,4950
4876,-2900,6700,12000,-4900,2900,13800
4877,10600,-4300,-1200,-1700,1950,5350
4878,-2600,8900,-900,-3000,0,2400
4879,2300,-1700,1000,4400,-10200,-4200
4880,-3600,9900,2800,-2800,0,6300
4881,11100,-3100,0,-2000,12000,18000
4882,7600,-2900,-1200,-1800,0,1700
4883,-1100,9800,0,11000,0,19700
4884,8900,-4300,-1200,200,0,3600
4885,3700,-6900,-900,-3000,0,-7100
4886,11000,8900,1000,7600,-11400,17100
4887,0,-800,2800,-3800,0,-1800
4888,10200,100,0,0,12000,22300
4889,-4300,12100,0,-2000,0,5800
4890,500,-4500,-1200,200,0,-5000
4891,700,-2300,0,12000,0,10400
4892,-1200,9100,0,-3000,0,4900
4893,7000,100,0,1200,-1200,7100
4894,-3700,10100,0,-1000,0,5400
4895,-2400,-7400,0,-1000,-950,-11750
4896,-5100,200,0,200,-1200,-5900
4897,6200,11200,0,-3900,1950,15450
4898,-5100,200,-1200,-1800,-950,-8850
4899,8400,-2100,-2400,-2500,2900,4300
4900,-1100,9900,1000,-3600,-1200,5000
4901,6600,-2100,-1100,-2600,0,800
4902,-3800,-5100,4700,5400,-950,250
4903,9800,-4400,-1200,1200,0,5400
4904,-2300,-5000,-900,7100,1950,850
4905,8100,7500,3800,-6400,-2150,10850
4906,2100,-7700,0,8100,2900,5400
4907,6600,-2700,0,-2000,0,1900
4908,1100,5200,0,-1000,0,5300
4909,7800,-600,0,11000,0,18200
4910,-5100,12100,0,-2000,0,5000
4911,-5900,-700,0,-2000,0,-8600
4912,-3500,-2200,0,-3000,0,-8700
4913,10400,12000,0,11200,-1200,32400
4914,6700,200,0,0,0,6900
4915,-3500,9800,0,-2000,-950,3350
4916,-2700,-2300,0,-1000,-950,-6950
4917,10000,9900,0,-4900,2900,17900
4918,-4200,-800,0,9300,750,5050
4919,10100,-2200,-1200,-2800,0,3900
4920,-2500,12000,-10200,10400,-1200,8500
4921,12600,-2200,0,-2000,0,8400
4922,-3600,-600,10800,400,-2150,4850
4923,9700,-6800,0,0,-950,1950
4924,-2100,-4500,-1800,-2900,2900,-8400
4925,9600,11200,4700,3500,1950,30950
4926,-3600,200,0,0,0,-3400
4927,-1400,6700,0,-1000,0,4300
4928,3900,-1200,0,0,0,2700
4929,-5100,-700,0,10000,0,4200
4930,9900,-4400,-1200,1200,0,5500
4931,-7800,11600,0,-2000,0,1800
4932,-6900,400,-2100,400,-1200,-9400
4933,7600,-2200,-200,-2600,0,2600
4934,-1300,7600,2800,-3800,-950,4350
4935,7000,-700,0,-1000,-950,4350
4936,-7500,-2200,0,-3700,1700,-11700
4937,300,700,-1200,9300,1950,11050
4938,-3600,9800,-2100,-800,0,3300
4939,7900,100,-200,-2600,0,5200
4940,-1400,-6000,2800,9400,-1200,3600
4941,7700,-1300,-1800,0,0,4600
4942,-6700,12000,4700,-6600,-950,2450
4943,6900,-500,0,0,0,6400
4944,-5400,-1900,0,8100,1950,2750
4945,12500,6600,0,0,0,19100
4946,-4200,100,0,-3900,1950,-6050
4947,11000,-2200,0,0,0,8800
4948,-3000,-4300,0,-3000,0,-10300
4949,10300,9700,-1200,11200,0,30000
4950,-1400,-5300,0,-1000,0,-7700
4951,8000,0,0,-2000,0,6000
4952,-400,6600,-2400,-1600,0,2200
4953,11800,-2300,-1800,-2000,0,5700
4954,-600,-8300,4700,6400,0,2200
4955,7500,10800,0,-2000,0,16300
4956,-4200,-700,0,-1000,0,-5900
4957,8500,9800,0,-1000,0,17300
4958,1000,-7500,0,-1000,0,-7500
4959,9900,7600,0,8000,0,25500
4960,-1800,-2200,-12600,11600,0,-5000
4961,10200,11200,-900,-2000,0,18500
4962,-2600,0,1000,-2600,-1200,-5400
4963,13100,5200,14800,-6600,-1200,25300
4964,-5300,-500,0,1200,-1200,-5800
4965,6200,-700,-1200,-3600,-1200,-500
4966,11600,-3600,-2100,400,-2150,4150
4967,-200,9700,1000,6300,1950,18750
4968,11100,-700,1600,-4600,-1900,5500
4969,1300,-4500,-900,-4700,1700,-7100
4970,8600,12100,-6400,700,1950,16950
4971,-1700,-700,0,-5000,-1900,-9300
4972,-5100,100,12000,-3700,1700,5000
4973,-2600,12000,0,10700,-1650,18450
4974,7400,-2000,0,-1000,-950,3450
4975,-500,-4300,0,7100,1950,4250
4976,7600,-3000,0,0,-950,3650
4977,-100,-2300,0,-5500,-450,-8350
4978,-4500,-2000,0,10300,750,4550
4979,-4900,11200,0,-1000,-950,4350
4980,8300,-2200,0,9100,1950,17150
4981,-2700,9800,0,-3700,750,4150
4982,9500,0,-1200,11200,-950,18550
4983,-1800,-800,0,-1500,-450,-4550
4984,12400,-4600,0,-3900,1950,5850
4985,-2500,12100,-1200,8300,1950,18650
4986,13300,-4500,-2100,1400,-2150,5950
4987,-300,-3800,3800,-10500,1950,-8850
4988,-1700,900,-1200,-2700,1950,-2750
4989,10400,0,-900,-3000,0,6500
4990,0,12000,3800,1500,1950,19250
4991,-2700,100,0,400,-2400,-4600
4992,-5100,100,0,10000,0,5000
4993,-1700,-2300,0,-800,-1200,-6000
4994,2000,-5300,0,200,-2150,-5250
4995,-2600,200,0,10000,-950,6650
4996,7700,12100,0,-2900,1950,18850
4997,-4300,100,0,8100,1950,5850
4998,-3500,-2200,0,-1000,-950,-7650
4999,12400,-5400,0,-3900,2900,6000
5000,-3700,-2100,-1200,9300,1950,4250
5001,-2100,6900,0,-800,-1200,2800
5002,8800,0,0,-3000,0,5800
5003,-2000,-2200,0,0,0,-4200
5004,-4300,11300,0,11000,-950,17050
5005,5300,-800,-1200,-800,0,2500
5006,11500,-3600,-2100,-4700,1950,3050
5007,-1400,7800,1900,-7700,1950,2550
5008,5300,-700,-500,-2400,0,1700
5009,-1800,-2200,-1800,-1000,0,-6800
5010,2100,7400,4700,5400,0,19600
5011,8400,-1500,0,-2000,0,4900
5012,-3700,-1100,0,11000,0,6200
5013,8800,12000,0,-800,-1200,18800
5014,-4200,100,0,10000,0,5900
5015,-5400,-2200,0,-1000,0,-8600
5016,12600,-4600,0,-800,-1200,6000
5017,-3800,-2900,-1200,200,0,-7700
5018,-8500,-500,-900,200,-2150,-11850
5019,5200,12200,2600,6600,0,26600
5020,-4300,-2200,0,-2700,750,-8450
5021,6000,300,0,-800,-2150,3350
5022,-3600,9100,-1200,-4700,1950,1550
5023,9200,-1300,0,-2000,0,5900
5024,-6100,-2800,-200,-6500,1950,-13650
5025,9200,-2000,1900,8200,-950,16350
5026,-6800,100,0,-3900,2900,-7700
5027,10000,7400,0,-2000,0,15400
5028,1100,-7500,-1200,10200,0,2600
5029,11800,-3900,-900,-800,-1200,5000
5030,-2900,-1300,1000,7200,0,4000
5031,10200,9700,2800,-3800,0,18900
5032,0,-800,0,8200,-11150,-3750
5033,11100,12000,0,0,-950,22150
5034,-1800,12200,0,-5700,1700,6400
5035,6600,-1900,0,9200,850,14750
5036,-400,-4400,0,-2700,1700,-5800
5037,6100,-600,0,-2000,0,3500
5038,-4500,-2000,0,-1000,12000,4500
5039,9300,-2200,0,13200,-2150,18150
5040,-400,6800,0,0,-950,5450
5041,10900,-2200,0,-2700,1700,7700
5042,-300,9800,0,-4900,1950,6550
5043,5300,-600,0,0,0,4700
5044,-800,-7400,0,200,-2150,-10150
5045,-5800,8600,0,7100,1950,11850
5046,-9300,-600,0,2400,-3350,-10850
5047,10100,-3000,-1200,-2700,2900,6100
5048,-6800,12300,-1200,200,-950,3550
5049,8500,-2300,-1800,-1000,-950,2450
5050,-3200,11200,4700,-8500,2900,7100
5051,3500,1000,0,7100,1950,13550
5052,-1200,-4500,-1200,400,-1200,-7700
5053,10200,-2300,0,0,0,7900
5054,-2700,-3000,0,-2800,-2150,-10650
5055,7800,11200,-1200,11200,0,29000
5056,-1700,0,-1800,-3700,750,-6450
5057,10200,11300,4700,-5200,-3350,17650
5058,-7100,1200,-1200,-4700,2900,-8900
5059,9300,-2100,-10200,9200,-950,5250
5060,-2000,-4500,-10200,7400,-2150,-11450
5061,13100,-6800,10800,-3700,1950,15350
5062,-5900,-700,-900,-5900,1950,-11450
5063,9400,-600,15800,-4400,-2150,18050
5064,-7600,12300,0,-2900,1950,3750
5065,9200,-2100,0,7300,750,15150
5066,-5900,12200,-1200,-800,-950,3350
5067,-3500,-2200,0,8100,2900,5300
5068,11700,-2100,-2400,-3500,1950,5650
5069,-1000,-3100,-900,11000,0,6000
5070,12000,0,-900,-1000,0,10100
5071,-5400,11300,4700,-4200,-2400,4000
5072,8400,-1300,0,11000,0,18100
5073,10200,-2200,-10200,8200,-950,5050
5074,-5000,-1600,-1200,1400,-1200,-7600
5075,-1300,-3500,0,-3900,1950,-6750
5076,10900,9700,10200,0,-1900,28900
5077,-800,-800,4700,-9500,1950,-4450
5078,10900,-3100,0,-4900,2900,5800
5079,-5300,1000,0,-2000,-950,-7250
5080,12500,6700,-2400,-1300,1700,17200
5081,10600,-4400,0,10200,-1200,15200
5082,-1700,-2300,100,-2800,0,-6700
5083,-5200,-400,2800,9400,-1200,5400
5084,-1300,7600,0,-1000,-950,4350
5085,-1200,-4500,0,-2000,-950,-8650
5086,7800,11200,0,8100,2900,30000
5087,-3300,100,0,-3900,1950,-5150
5088,8400,300,0,-2000,0,6700
5089,-5100,12100,0,-1000,0,6000
5090,7500,-2100,0,11200,-1200,15400
5091,-2800,-2100,-1200,200,0,-5900
5092,10200,-3000,0,-2000,-950,4250
5093,-5000,100,0,-1000,0,-5900
5094,10000,-2200,0,-3900,1950,5850
5095,-3200,12000,0,-2900,1950,7850
5096,11100,0,-1200,11200,0,21100
5097,0,0,0,-2000,0,-2000
5098,9400,100,-12000,10200,0,7700
5099,-2500,100,4700,-7600,0,-5300
5100,10200,200,10800,200,0,21400
5101,-6700,200,0,-1000,0,-7500
5102,-100,-2300,-1200,200,0,-3400
5103,-2100,-3000,0,11000,0,5900
5104,1300,-4600,100,-3800,0,-7000
5105,6600,10100,2800,-2600,-1200,15700
5106,13300,-5300,-1200,200,0,7000
5107,-2000,-2200,0,-2000,0,-6200
5108,-2700,9000,0,0,0,6300
5109,-3300,100,0,10000,0,6800
5110,-5200,12300,0,1200,-1200,7100
5111,-2600,-2200,-1200,200,0,-5800
5112,9900,-2100,0,0,-950,6850
5113,-1300,-5200,-3900,-800,0,-11200
5114,5800,-2700,5600,-8500,1950,2150
5115,-1900,9900,0,-1000,-950,6050
5116,10700,-4400,0,-2900,2900,6300
5117,-700,5500,0,-1000,0,3800
5118,5200,-1300,0,12600,-3600,12900
5119,-7000,-2200,0,0,0,-9200
5120,-4300,9800,0,12200,-2150,15550
5121,8400,-2900,0,0,0,5500
5122,-4200,12100,-1200,-3700,1950,4950
5123,8400,-2200,0,-2000,-1900,2300
5124,-4200,-700,-2100,-500,1700,-5800
5125,7500,10700,3800,-9500,1950,14450
5126,-4400,-3100,0,-3900,1950,-9450
5127,400,-4500,0,-2800,-1200,-8100
5128,8700,10500,-1200,200,0,18200
5129,-6200,1100,-1800,11000,-950,3150
5130,5300,200,4700,-7600,-950,1650
5131,8400,9800,-1200,-3500,1700,15200
5132,-1700,-2300,-12600,20700,1950,6050
5133,10000,-2100,-900,0,0,7000
5134,-3400,-700,13000,-4800,0,4100
5135,6000,-600,2800,-2600,-1200,4400
5136,-1300,8400,0,11000,0,18100
5137,9800,-4500,0,-1000,0,4300
5138,8100,-5100,0,-1000,-950,1050
5139,-200,-4600,0,-5900,1950,-8750
5140,11700,9000,-2100,13400,-2150,29850
5141,-5200,300,1000,-5500,1700,-7700
5142,400,-5300,2800,-2400,-2400,-6900
5143,8400,9900,0,-1000,-950,16350
5144,-7700,300,0,-1000,-950,-9350
5145,7600,9100,0,9100,1950,27750
5146,8000,-800,0,-4900,1950,4250
5147,-2600,12900,-1200,-1800,-950,6350
5148,10300,-700,0,-4900,2900,7600
5149,-5200,300,-2100,8300,1950,3250
5150,9300,-1400,-200,5800,-11400,2100
5151,-1600,0,2800,-3800,0,-2600
5152,9300,100,-1200,-800,12000,19400
5153,-100,-2300,-1800,0,0,-4200
5154,10800,-2100,4700,-6600,0,6800
5155,-4300,-600,-10200,22200,0,7100
5156,7800,11200,-1200,200,0,18000
5157,-7000,1400,0,-1000,0,-6600
5158,-1900,-2200,10800,1200,0,7900
5159,-3400,-2300,-900,0,0,-6600
5160,11600,-5400,1000,-2800,0,4400
5161,-5100,200,2800,-4800,0,-6900
5162,8700,12000,-1200,9400,-10200,18700
5163,-900,100,0,-1000,0,-1800
5164,6600,-1900,0,-1000,0,3700
5165,-300,-4600,0,0,12000,7100
5166,13400,-3100,0,-2600,-2400,5300
5167,-2800,-2900,-1200,-1800,0,-8700
5168,14200,7400,-4200,400,-950,16850
5169,0,0,1700,3800,-10200,-4700
5170,-900,11300,4700,-8500,1950,8550
5171,-2700,300,0,-1800,9850,5650
5172,-3500,-2100,0,-2900,2900,-5600
5173,-1000,9800,0,11000,0,19800
5174,-3500,200,0,200,-2150,-5250
5175,-5500,-1800,0,0,-950,-8250
5176,6100,100,0,9100,2900,18200
5177,8300,-2700,0,-2900,1950,4650
5178,-3500,-2200,0,-800,-1200,-7700
5179,-2600,-3000,0,0,0,-5600
5180,8500,10600,0,12000,-950,30150
5181,-200,-3100,-1200,200,0,-4300
5182,8500,100,-1800,-3900,1950,4850
5183,-6000,12200,3500,-4200,-2150,3350
5184,5400,100,0,-3900,2900,4500
5185,700,-2300,-10200,9200,0,-2600
5186,9300,-600,0,-1000,0,7700
5187,-4200,0,10800,1200,0,7800
5188,11100,12100,-1800,-1000,0,20400
5189,-6100,300,1900,-3800,0,-7700
5190,7100,100,2800,-2800,0,7200
5191,11800,-2300,0,-2000,0,7500
5192,-7600,-700,0,-1000,0,-9300
5193,-2800,-1200,0,11000,0,7000
5194,7800,100,0,0,0,7900
5195,-5100,200,0,10000,0,5100
5196,11500,-4500,0,1400,-2400,6000
5197,-2200,-5100,0,0,0,-7300
5198,8500,200,0,-1000,-950,6750
5199,-1900,9000,0,-800,-1200,5100
5200,9400,-2200,-1200,-3700,1950,4250
5201,-2800,9100,0,200,-3100,3400
5202,-10200,1100,0,-3900,2900,-10100
5203,7600,-3000,0,-3700,750,1650
5204,-4100,0,0,-800,-2150,-7050
5205,11100,11300,0,-2900,1950,21450
5206,-3500,900,-1200,11200,0,7400
5207,11000,-2300,0,-3700,750,5750
5208,-3400,-700,-1800,-3900,1950,-7850
5209,9100,-1200,4700,4400,-950,16050
5210,-6100,-2100,0,-2000,0,-10200
5211,10100,-3100,0,-2900,1950,6050
5212,-1300,-4400,0,7100,1950,3350
5213,8300,9100,0,-1000,0,16400
5214,-4100,0,0,400,-2400,-6100
5215,11800,-2200,0,11000,0,20600
5216,-3600,9000,0,0,0,5400
5217,11800,-2200,-1200,-1600,-2150,4650
5218,-2600,100,0,9200,-10200,-3500
5219,11400,6800,-1200,-2700,1950,16250
5220,-4300,100,-900,1200,9850,5950
5221,10700,-4300,3800,-9500,2900,3600
5222,-200,-4600,0,-800,-1200,-6800
5223,3600,4400,0,-3000,-950,4050
5224,-3500,-600,0,-1000,-950,-6050
5225,-6000,11400,-1200,8300,2900,15400
5226,2700,1100,-2400,-3500,1950,-150
5227,-500,7500,-1800,-1000,0,4200
5228,-7700,-500,4700,-7600,0,-11100
5229,5600,-4600,0,9000,0,10000
5230,-6100,9200,0,1200,-1200,3100
5231,-4500,-2100,0,-3000,0,-9600
5232,11800,-4600,-1200,21800,-13550,14250
5233,-3000,6700,-1800,-2000,-950,-1050
5234,7000,-600,700,-5500,13950,15550
5235,-3600,9800,2800,-5700,1950,5250
5236,9500,100,0,9200,-11150,7650
5237,10000,9900,0,-2900,2900,19900
5238,-6000,100,0,-4700,12750,2150
5239,-3500,-2200,0,0,0,-5700
5240,11600,-4500,0,11000,0,18100
5241,-900,-700,-1200,-800,0,-3600
5242,8800,-4300,-900,11000,0,14600
5243,-3300,11300,1000,-4800,0,4200
5244,4300,300,2800,-3800,0,3600
5245,1200,-6900,0,-800,-1200,-7700
5246,9200,9000,0,-600,-2400,15200
5247,6700,-2100,0,-4000,-950,-350
5248,-200,-3000,0,11200,-1200,6800
5249,8300,9800,0,-5900,1950,14150
5250,1500,-8900,0,1200,-2150,-8350
5251,-1100,-3000,0,-4900,1950,-7050
5252,7500,9100,0,-800,-3100,12700
5253,9400,-2300,0,-4900,2900,5100
5254,-6700,11400,-11400,16500,1950,11750
5255,1300,-4500,-2400,400,-950,-6150
5256,7700,100,-3300,-4500,1950,1950
5257,-1900,9700,12100,-7700,2900,15100
5258,7000,100,3800,-5600,0,5300
5259,-1600,11200,2800,7200,0,19600
5260,10200,100,0,-2600,-2400,5300
5261,-1800,12100,0,12200,-1200,21300
5262,8700,0,-1200,200,0,7700
5263,-1800,100,-12000,8400,-2150,-7450
5264,8700,100,3500,6600,-950,17950
5265,-2800,-2200,12000,-4500,-450,2050
5266,-500,-4500,0,-7900,1950,-10950
5267,-3500,-2100,0,1400,-3350,-7550
5268,12600,-3900,0,8100,1950,18750
5269,-4000,-3600,-1200,-2700,1950,-9550
5270,-2100,7500,0,10200,-3100,12500
5271,9300,-3000,-1800,-2700,1700,3500
5272,200,-7500,4700,-9500,1950,-10150
5273,-4300,10500,0,10000,-1900,14300
5274,-3600,10800,0,-3900,2900,6200
5275,7900,-800,0,-4900,1950,4150
5276,-200,-1400,0,10000,-950,7450
5277,10200,10400,-1200,-1700,2900,20600
5278,-1000,-1400,0,6100,1950,5650
5279,11100,100,0,-3000,0,8200
5280,-5100,11400,0,0,0,6300
5281,-4300,1100,0,10000,0,6800
5282,14800,-6900,-10200,9200,0,6900
5283,-5100,200,-2100,-1800,0,-8800
5284,-8800,-300,13000,-2600,-1200,100
5285,8800,0,2800,-3800,0,7800
5286,500,7400,0,-2000,-950,4950
5287,-5400,-2000,-1200,200,0,-8400
5288,-4900,-800,0,8100,1950,4350
5289,15000,-4600,0,-2000,-950,7450
5290,9400,100,0,-2700,1700,8500
5291,-7200,9300,-1200,-1800,0,-900
5292,17100,2800,-1800,11000,0,29100
5293,-5100,-600,4700,-5600,0,-6600
5294,8400,-2100,0,-1000,0,5300
5295,1000,-7500,-1200,-1800,0,-9500
5296,-2300,5300,-1200,-800,0,1000
5297,-5900,-1300,-1800,9000,0,0
5298,8200,8600,4700,-5200,-2400,13900
5299,-3600,-2900,0,-3000,0,-9500
5300,10500,6800,-1200,11200,-950,26350
5301,-5300,-2800,-1200,1400,-2150,-10050
5302,7500,10800,-900,8100,2900,28400
5303,-1300,-5300,1000,-6700,1000,-11300
5304,-2700,9000,2800,-2800,-950,5350
5305,7500,-2900,0,-4900,2900,2600
5306,-7800,10800,0,-2900,1950,2050
5307,10800,-6100,-1200,20400,-10200,13700
5308,-4400,9800,0,-800,-1200,3400
5309,5200,1100,-1200,-1800,12000,15300
5310,-1700,-3100,-1200,1200,0,-4800
5311,5700,12300,-900,11200,-1200,27100
5312,-6200,-2900,1000,-3800,0,-11900
5313,9900,8400,1600,-4600,0,15300
5314,-1800,-3100,-1800,1200,-2150,-7650
5315,9300,-2200,4700,-7600,-950,3250
5316,-6800,-600,0,-2900,2900,-7400
5317,12600,7400,0,8100,1950,30050
5318,-3600,200,0,-1000,0,-4400
5319,9300,9000,-1200,12200,0,29300
5320,-3700,-2100,-1200,200,0,-6800
5321,12400,-4500,-900,-1000,0,6000
5322,-4900,11200,1000,-2800,0,4500
5323,9300,-500,2800,-3800,0,7800
5324,-6700,900,0,-1000,0,-6800
5325,8400,8200,0,-2000,0,14600
5326,-2200,-2700,0,11000,0,6100
5327,13100,-6800,0,0,0,6300
5328,-1800,-1400,0,12000,0,8800
5329,6600,-1900,0,0,0,4700
5330,-1800,9800,-1200,-800,0,6000
5331,7000,200,0,-1000,0,6200
5332,-1000,9700,0,1200,-1200,8700
5333,11100,100,0,-1000,0,10200
5334,-3500,-600,0,-2000,-950,-7050
5335,9500,100,0,-2000,0,7600
5336,-4200,10500,0,-5900,1950,2350
5337,5100,1900,-1200,1200,-950,6050
5338,8000,0,-1800,-7700,1700,200
5339,-2000,-2100,700,800,-2400,-5000
5340,-6100,400,2800,8200,0,5300
5341,9300,-2300,0,-3000,-950,3050
5342,-3500,-2200,-1200,400,-2150,-8650
5343,10800,-2200,-900,-3700,1700,5700
5344,-300,-5400,1000,9200,-950,3550
5345,9100,-2100,2800,-7700,1950,4050
5346,-200,9000,0,0,-950,7850
5347,10000,-2000,-1200,8300,2900,18000
5348,-5300,9900,0,-2700,750,2650
5349,-2700,-2900,-1200,-800,0,-7600
5350,10100,-2200,-900,11000,0,18000
5351,-6800,12100,1900,-3800,-950,2450
5352,8500,-3000,1900,9600,-2400,14600
5353,-5100,100,0,-3700,750,-7950
5354,-6100,12200,-1200,-3700,1000,2200
5355,9400,-2300,0,0,0,7100
5356,-2900,-2100,0,8100,1950,5050
5357,7800,-1500,0,-1000,-950,4350
5358,-7700,1100,0,-4900,2900,-8600
5359,12500,6600,0,-1000,0,18100
5360,10300,-5600,0,0,0,4700
5361,-1900,-3100,0,10000,0,5000
5362,6100,0,0,0,0,6100
5363,-1000,-3100,0,-2000,0,-6100
5364,-3700,9900,0,11000,0,17200
5365,9100,-4500,0,200,-1200,3600
5366,-4200,12100,0,-2000,0,5900
5367,12200,-8400,0,0,0,3800
5368,6100,900,0,-1000,-950,5050
5369,-8600,11600,0,-1000,-950,1050
5370,12200,-6800,0,-4900,2900,3400
5371,-3000,7700,0,-3900,1950,2750
5372,6800,-500,0,-3000,0,3300
5373,-1000,-3800,0,12200,-1200,6200
5374,8600,10600,0,-1000,0,18200
5375,-2200,-5200,0,-2800,-1200,-11400
5376,6500,10100,-1200,13200,0,28600
5377,-2600,-2200,-1800,0,0,-6600
5378,5200,300,3500,-6400,-950,1650
5379,-2800,8300,0,0,-950,4550
5380,8300,-1300,0,-5700,1700,3000
5381,-9400,500,0,-3700,750,-11850
5382,6300,7100,0,10200,-1200,22400
5383,-400,-3700,0,-1000,-950,-6050
5384,11100,-3100,0,11000,0,19000
5385,-8600,-600,0,-2900,1950,-10150
5386,5300,12200,0,-2000,-950,14550
5387,-7000,-2000,-1200,-4700,2900,-12000
5388,9800,7500,-1800,-2000,0,13500
5389,10000,-5300,3500,6800,-1200,13800
5390,-3000,-4400,0,0,0,-7400
5391,11500,-5200,0,11000,-950,16350
5392,-5300,9100,0,-1800,-1200,800
5393,12300,-6700,0,-3900,1950,3650
5394,-1100,5800,-1200,-1800,-950,750
5395,8600,1000,0,-3900,2900,8600
5396,-1300,-5400,-1800,11000,0,2500
5397,6700,12400,3500,-6400,0,16200
5398,-7000,9300,0,-2000,0,300
5399,11400,-6900,0,11200,-1200,14500
5400,1900,-7700,0,-1000,0,-6800
5401,12400,7500,0,12000,0,31900
5402,-5000,-800,0,-1000,-950,-7750
5403,9300,8200,0,-4900,1950,14550
5404,-1900,-1400,0,-1000,0,-4300
5405,10200,12100,-2100,-3700,1950,18450
5406,-2500,100,1000,-5800,0,-7200
5407,600,-2200,2800,-2400,-2400,-3600
5408,7700,11300,0,11000,0,30000
5409,-1800,-2200,0,-2000,0,-6000
5410,8600,12000,0,11000,-950,30650
5411,-2100,-2200,-10200,5300,1950,-7250
5412,-2600,-3000,0,-3000,-950,-9550
5413,11000,9800,10800,-3700,2900,30800
5414,-3500,200,0,200,-1200,-4300
5415,-4500,-2900,0,-1800,-1200,-10400
5416,10200,10600,0,-1000,0,19800
5417,600,-3100,0,-1000,-950,-4450
5418,-1800,100,0,12000,0,10300
5419,11900,-2300,0,-5900,1950,5650
5420,0,12000,0,-2000,-950,9050
5421,-3500,100,0,-2900,2900,-3400
5422,-200,-2300,0,-1600,-2400,-6500
5423,8700,-700,0,12000,0,20000
5424,-900,0,0,0,-950,-1850
5425,-4200,100,0,11000,0,6900
5426,-2700,12100,0,-3900,1950,7450
5427,10700,-5100,0,0,-950,4650
5428,-2600,-1400,0,-4900,2900,-6000
5429,-4600,-2700,-2100,1200,0,-8200
5430,-400,-4600,1000,-4800,0,-8800
5431,6200,200,1600,-3400,-1200,3400
5432,1300,6600,0,11000,0,18900
5433,-1800,100,0,0,0,-1700
5434,7500,12200,0,-1000,0,18700
5435,6100,300,0,12000,0,18400
5436,-4400,-2000,0,200,-1200,-7400
5437,-5000,0,0,-1000,0,-6000
5438,-3200,-800,0,-1000,0,-5000
5439,6800,200,-1200,-600,-2150,3050
5440,-2100,7600,-2100,200,-950,2650
5441,6800,300,1000,-6700,2900,4300
5442,-3900,-4300,2800,-5700,1950,-9150
5443,-6700,-500,0,9200,-10200,-8200
5444,8500,-2200,0,-1000,0,5300
5445,8800,12000,-10200,8200,12000,30800
5446,500,-2200,-1200,1600,-2400,-3700
5447,8600,-800,-900,0,0,6900
5448,-1700,0,13000,-4800,-950,5550
5449,9200,-2900,2800,-3800,-950,4350
5450,900,6200,0,-5900,2900,4100
5451,11900,-3100,0,7500,-9450,6850
5452,-2200,-2100,0,-4000,0,-8300
5453,9300,9100,-2400,1600,9850,27450
5454,-4900,100,-1800,-1000,-950,-8550
5455,-3600,-2100,4700,2500,2900,4400
5456,-3300,12000,0,-3900,1950,6750
5457,6800,100,0,9400,-11400,4900
5458,-7700,100,0,-800,-1200,-9600
5459,12200,-6600,0,0,12000,17600
5460,-5300,-2900,0,-1000,-950,-10150
5461,6400,-1800,0,12200,-2150,14650
5462,-5300,-2800,0,-2900,2900,-8100
5463,7100,12100,0,-3900,1000,16300
5464,-400,7400,0,-1000,0,6000
5465,7800,200,0,-3900,1950,6050
5466,-6200,-3100,0,-1000,-950,-11250
5467,8500,-2100,-2400,8500,2900,15400
5468,-8500,11600,-3000,11600,-11400,300
5469,10800,-4400,4700,-5600,0,5500
5470,-5900,100,0,-800,10800,4200
5471,11500,-4300,0,-1000,0,6200
5472,-4300,11400,0,-1000,0,6100
5473,7800,-700,-1200,200,-950,5150
5474,-5000,900,-1800,12000,-950,5150
5475,7600,8900,4700,-8500,2900,15600
5476,-3700,-2900,-1200,-3700,1950,-9550
5477,5100,-500,0,-2000,0,2600
5478,-4400,-400,0,-1000,0,-5800
5479,7700,9800,0,-1000,0,16500
5480,7900,100,0,12000,0,20000
5481,-2600,100,0,-1000,0,-3500
5482,7600,400,0,0,0,8000
5483,1900,-6900,0,12000,0,7000
5484,8700,-700,0,0,0,8000
5485,-4400,200,0,200,-1200,-5200
5486,12500,7500,0,0,0,20000
5487,9800,-4300,0,-2000,0,3500
5488,-1200,-5400,0,1200,-1200,-6600
5489,10900,-3000,-1200,200,0,6900
5490,-2700,12100,-900,-2000,-950,5550
5491,6800,-500,1000,-3800,-950,2550
5492,-5400,10100,2800,-6500,1700,2700
5493,-3500,-2300,0,-3900,1950,-7750
5494,8400,-2900,-10200,7200,0,2500
5495,7000,12900,0,0,0,19900
5496,-7100,-3500,12000,-2000,0,-600
5497,10700,-3600,0,-1000,0,6100
5498,-7500,11300,-1200,-800,0,1800
5499,12500,-4600,0,11000,0,18900
5500,-2800,-2000,0,-1000,0,-5800
5501,12100,4600,0,-1000,0,15700
5502,-1600,0,-1200,-800,0,-3600
5503,4900,11500,-2100,200,0,14500
5504,-3400,-2200,1000,-7800,0,-12400
5505,7600,-2900,1600,-4600,0,1700
5506,-1800,10600,-900,-2000,0,5900
5507,7400,-2900,1900,8200,0,14600
5508,-1000,-2200,1900,-4800,0,-6100
5509,7800,12000,-1200,11400,-1200,28800
5510,-6200,-500,0,0,0,-6700
5511,8400,-1200,0,11200,-2150,16250
5512,9800,-4400,0,-1000,0,4400
5513,-4200,-600,-10200,5500,750,-8750
5514,10100,-2100,0,0,-950,7050
5515,-4400,9900,12000,-3900,1950,15550
5516,12500,-5300,0,-1000,0,6200
5517,-7200,-4200,0,-2900,1950,-12350
5518,11400,-5900,0,12000,-950,16550
5519,5200,13000,0,-3900,2900,17200
5520,-6000,-500,0,0,0,-6500
5521,5300,12200,-3600,-1400,0,12500
5522,-2000,-4500,-900,0,0,-7400
5523,7600,9900,100,7200,0,24800
5524,-500,-6200,2600,-4400,0,-8500
5525,9500,900,2800,-3800,0,9400
5526,-2700,9000,0,-3000,0,3300
5527,10300,100,0,-1800,-1200,7400
5528,-3400,100,0,11200,-1200,6700
5529,6800,12200,0,-1000,0,18000
5530,-5000,100,0,-1000,-950,-6850
5531,11500,-5200,0,-1000,0,5300
5532,-4400,-1300,0,8100,1950,4350
5533,9400,-700,0,-1000,-950,6750
5534,-3600,-3000,0,-4900,2900,-8600
5535,6600,11000,0,10200,-10200,17600
5536,-5900,200,0,-1000,0,-6700
5537,6700,-3000,-1200,-800,12000,13700
5538,-2700,-2200,-900,-2000,0,-7800
5539,10700,-4500,1000,-3800,0,3400
5540,-5800,11300,2800,8200,0,16500
5541,-3600,100,0,200,-1200,-4500
5542,6100,11300,0,-2000,0,15400
5543,6800,-1300,0,-1000,0,4500
5544,-1900,-2200,0,8200,-10200,-6100
5545,300,-5200,0,-2000,0,-6900
5546,7000,200,0,1200,-1200,7200
5547,-1100,-2300,0,-1000,12000,7600
5548,6500,9300,0,-1000,-950,13850
5549,-4600,-1900,0,0,-950,-7450
5550,13900,-6700,0,-4900,2900,5200
5551,-400,6700,-1200,-1500,750,4350
5552,8500,-2200,0,11000,0,17300
5553,-3000,-5300,0,1200,-1200,-8300
5554,10900,7500,0,-3000,0,15400
5555,-2500,-800,0,400,-3350,-6250
5556,7600,11500,0,0,0,19100
5557,500,-4600,0,-4900,1000,-8000
5558,10000,9800,-1200,-1700,1950,18850
5559,-4200,200,-11100,8200,0,-6900
5560,5200,-600,1000,-6700,1950,850
5561,-1800,8900,1600,-6500,1950,4150
5562,7800,900,12000,6200,-10200,16700
5563,-1200,-2000,0,0,0,-3200
5564,3300,12200,0,-2000,12000,25500
5565,2800,-7700,0,-1000,0,-5900
5566,6200,-4100,0,9000,0,11100
5567,-6600,100,0,200,-1200,-7500
5568,4700,11200,0,-1000,0,14900
5569,-4500,-3600,0,11000,0,2900
5570,6600,11600,0,0,0,18200
5571,-5000,-1600,0,-1000,0,-7600
5572,-2100,-3600,0,1200,-1200,-5700
5573,10700,6700,0,-2800,-1200,13400
5574,-3000,-4300,0,200,-2150,-9250
5575,7900,100,0,-1000,-950,6050
5576,-1100,8900,0,5300,-8250,4850
5577,10300,100,0,-3900,1950,8450
5578,-2900,-2900,-1200,1200,11050,5250
5579,8300,10900,-900,-4900,2900,16300
5580,-5700,-4200,1900,-8700,1950,-14750
5581,8500,-3100,700,10400,0,16500
5582,-4700,-4200,0,-2000,0,-10900
5583,9000,6700,0,-2000,0,13700
5584,-5900,-700,-2400,-1600,0,-10600
5585,10800,-4600,-3000,13600,-2400,14400
5586,-3600,9900,3800,-7600,0,2500
5587,8300,-2800,1000,-2400,-3350,750
5588,-2100,6100,2800,8200,0,15000
5589,9800,-3600,0,-4900,1000,2300
5590,-4500,-2000,0,0,-950,-7450
5591,8500,8900,0,-3700,1700,15400
5592,-4900,12000,0,7100,1950,16150
5593,7700,200,-1200,-1800,-950,3950
5594,4800,-2800,0,7100,2900,12000
5595,-5000,12200,0,200,-1200,6200
5596,-1200,-4500,0,10000,0,4300
5597,12400,7500,0,9200,-10200,18900
5598,8500,200,0,-1000,-950,6750
5599,-6800,-400,0,0,11050,3850
5600,-3500,-2200,0,-3900,2900,-6700
5601,6700,9900,0,-2700,750,14650
5602,11900,-3100,0,-1000,0,7800
5603,-2700,200,0,0,0,-2500
5604,9600,0,0,11000,0,20600
5605,-4500,12200,0,1200,-1200,7700
5606,9300,-2200,-1200,-800,0,5100
5607,-5100,200,0,1200,-2150,-5850
5608,-600,-6800,-1800,0,0,-9200
5609,6700,-3700,4700,-5600,-950,1150
5610,9300,-1300,-1200,-3700,2900,6000
5611,-7700,-400,0,-2500,-450,-11050
5612,14400,3000,0,-1800,-1200,14400
5613,-6200,-2900,-1200,14400,-2150,1950
5614,7000,12200,-1800,0,0,17400
5615,-300,-5400,4700,-8500,1950,-7550
5616,11800,9800,0,0,-1900,19700
5617,-3400,-700,0,-5900,2900,-7100
5618,6700,200,-2400,-500,1950,5950
5619,-5000,12000,-900,10000,-950,15150
5620,7000,0,1000,-6700,2900,4200
5621,-4200,12000,2800,-2800,0,7800
5622,9600,0,0,9000,0,18600
5623,-2700,100,0,-2000,0,-4600
5624,8600,-600,-1200,12200,0,19000
5625,-4500,-1400,-1200,400,-1200,-7900
5626,8300,-2000,-900,-1000,0,4400
5627,-3600,-2100,1000,-4800,-950,-10450
5628,9100,-5300,2800,-4800,0,1800
5629,-4500,-2000,-1200,-4700,1950,-10450
5630,-900,-3100,0,12000,-950,7050
5631,10200,12100,0,-2900,2900,22300
5632,-3700,-2100,-1200,10200,0,3200
5633,9800,7700,-1800,-1000,0,14700
5634,5900,-3600,4700,5400,0,12400
5635,-8500,1200,0,-1000,0,-8300
5636,9100,7500,0,-1000,0,15600
5637,1400,-4600,0,0,0,-3200
5638,5900,-500,0,0,0,5400
5639,-9400,-300,0,11000,0,1300
5640,14000,5100,0,-1000,0,18100
5641,-2700,-2200,-1200,1200,0,-4900
5642,10100,8900,0,0,0,19000
5643,-2600,100,-1200,-1800,0,-5500
5644,10300,11200,-900,-3000,0,17600
5645,-5100,1000,-1400,-1400,0,-6900
5646,10600,-4400,1000,-4600,-1200,1400
5647,-3900,-5200,4700,-5200,-2400,-12000
5648,7900,100,0,-1000,0,7000
5649,-3600,-3600,-1200,-1800,-950,-11150
5650,11600,8300,-1200,11200,-950,28950
5651,-1000,-2200,-1800,-2900,2900,-5000
5652,9300,-700,4700,1500,1950,16750
5653,7000,12100,0,0,0,19100
5654,-200,-3100,0,-800,-1200,-5300
5655,10900,-2200,0,12000,0,20700
5656,-7700,12900,0,0,0,5200
5657,11600,-5300,0,0,-950,5350
5658,-1100,-2200,0,12200,-2150,6750
5659,11500,7500,0,-2900,2900,19000
5660,-2800,-3700,0,-3900,1950,-8450
5661,7600,-2200,0,-1000,0,4400
5662,-6800,12200,0,-1000,0,4400
5663,-1900,-2200,0,-3000,0,-7100
5664,-2600,9800,0,-1000,0,6200
5665,7200,-2700,0,10000,0,14500
5666,-1000,-3100,-2400,-400,-1200,-8100
5667,4000,-1900,-3000,200,0,-700
5668,10400,5600,4700,-6600,0,14100
5669,-6200,-1800,-1200,-800,-950,-10950
5670,-3500,-3100,-1200,-1800,-950,-10550
5671,-7700,12300,-3900,-4700,2900,-1100
5672,7500,9700,4700,2500,1950,26350
5673,-8000,-1800,1000,-4800,0,-13600
5674,9000,-5200,1600,9400,0,14800
5675,-3800,-4400,-1200,-800,0,-10200
5676,8300,7500,-11100,21200,0,25900
5677,-6300,-200,1900,-2800,0,-7400
5678,8000,11200,12700,-2600,0,29300
5679,-2700,-2300,0,-1800,-1200,-8000
5680,7500,-2100,0,-1000,0,4400
5681,-5700,7000,0,12200,-1200,12300
5682,6900,300,0,-1000,0,6200
5683,-2700,-2300,0,-2000,-950,-7950
5684,7600,9800,0,1600,-3600,15400
5685,-500,-5200,0,-2900,1950,-6650
5686,7600,-2100,0,11000,-1900,14600
5687,-5300,-2800,-1200,-1700,2900,-8100
5688,7500,10000,-900,-3900,1950,14650
5689,-7600,-600,1000,-4800,0,-12000
5690,5000,10000,1600,-5300,750,12050
5691,13900,-6900,0,-800,-1200,5000
5692,-3600,9800,0,12200,-1200,17200
5693,9900,-6000,0,-1000,-950,1950
5694,-5300,-2100,0,200,-2150,-9350
5695,5200,12200,0,7100,1950,26450
5696,-1900,-2200,-1200,-2700,1950,-6050
5697,14000,-8500,-1800,-2000,-950,750
5698,-4600,10800,3500,-9300,2900,3300
5699,5400,-700,0,-2700,750,2750
5700,-1300,7500,0,10000,0,16200
5701,6100,100,-1200,-1800,0,3200
5702,-3000,6800,-900,8000,-950,9950
5703,6100,100,1000,-5300,-450,1450
5704,-4400,9900,2800,-2800,-950,4550
5705,7400,-2000,0,-5900,1950,1450
5706,-900,-3100,0,-1000,0,-5000
5707,9300,-2200,0,7100,1950,16150
5708,1400,6600,0,-3000,-950,4050
5709,9200,-2100,0,-3900,2900,6100
5710,-5900,-600,-2400,11400,0,2500
5711,9300,9700,-900,-2000,0,16100
5712,-6600,100,3800,5600,-1200,1700
5713,10800,7500,0,-2000,0,16300
5714,-3600,400,0,11000,0,7800
5715,10800,-5300,0,-800,-1200,3500
5716,2800,-6900,0,9000,0,4900
5717,11100,11300,0,200,-1200,21400
5718,9400,100,0,-1000,-950,7550
5719,1200,-4500,0,10000,-950,5750
5720,12400,6600,0,-2700,1700,18000
5721,-3500,100,-1200,-3500,750,-7350
5722,9200,-2900,0,0,-950,5350
5723,600,7400,0,0,0,8000
5724,10200,-600,-1200,9500,750,18650
5725,-4200,12100,-1800,-800,-2150,3150
5726,9300,300,4700,-9300,750,5750
5727,-3500,-2200,0,-800,-1200,-7700
5728,11200,12000,-10200,9200,-950,21250
5729,-1800,100,0,-3900,1950,-3650
5730,-1700,0,12000,-2900,1950,9350
5731,8700,100,0,0,-950,7850
5732,-200,-2300,-10200,18500,1700,7500
5733,12000,0,-2400,-2500,1950,9050
5734,-5300,-600,-1800,0,0,-7700
5735,6000,-1300,16700,-5600,-950,14850
5736,-5000,-600,0,0,-950,-6550
5737,-1200,-2100,-1200,-3700,2900,-5300
5738,2200,-4600,-1200,-2700,1950,-4350
5739,10900,9000,-900,12200,-1200,30000
5740,-900,100,-9200,6400,0,-3600
5741,5900,200,2800,-2800,0,6100
5742,500,6700,0,0,0,7200
5743,-4200,900,12000,200,-1200,7700
5744,-2700,-3900,-1200,200,0,-7600
5745,-3800,-1100,-1200,-800,-950,-7850
5746,5300,12200,-900,-1000,0,15600
5747,-1200,-4400,1900,-2800,-950,-7450
5748,10800,-6100,1900,-6700,1950,1850
5749,-2900,-1200,0,-4900,2900,-6100
5750,7000,11300,-1200,-1800,0,15300
5751,-6000,100,0,-1000,0,-6900
5752,-1000,9700,0,11000,0,19700
5753,11900,-2300,0,-1000,0,8600
5754,-900,0,-1200,12200,0,10100
5755,12000,-1600,0,-2000,0,8400
5756,6700,1100,-1800,-2000,0,4000
5757,-3400,9700,4700,-7600,0,3400
5758,700,-2300,0,0,0,-1600
5759,-900,0,0,10000,0,9100
5760,11100,-700,0,0,0,10400
5761,-2000,-1300,0,11000,0,7700
5762,-800,0,0,-2000,0,-2800
5763,7700,-600,0,1200,-1200,7100
5764,1300,-4600,0,-2000,0,-5300
5765,-1000,9000,0,1200,-1200,8000
5766,-3900,-1800,0,0,0,-5700
5767,-5200,-2100,0,-1000,-950,-9250
5768,-2200,-4300,0,-1000,0,-7500
5769,6700,9100,0,-3900,1950,13850
5770,1300,-4500,0,-2000,0,-5200
5771,5600,10100,-1200,-2700,1950,13750
5772,-6000,-400,-1200,200,0,-7400
5773,10800,-4600,-11100,21400,-1200,15300
5774,-300,-4600,3800,-6600,0,-7700
5775,-1200,6700,12000,200,-1200,16500
5776,8700,-700,0,-1000,0,7000
5777,-3300,12000,0,-1000,0,7700
5778,9300,-600,0,200,-2150,6750
5779,-1200,-3700,0,-800,-2150,-7850
5780,9500,12100,0,-4900,2900,19600
5781,-4300,-600,0,-3900,1950,-6850
5782,-200,-2200,0,200,-2150,-4350
5783,8500,11400,0,-1800,-2150,15950
5784,-6800,1100,0,7100,2900,4300
5785,13300,-4600,0,-2700,750,6750
5786,-2600,-3100,0,11000,-950,4350
5787,-900,0,0,-1000,-950,-2850
5788,6800,-600,-11400,7500,2900,5200
5789,-2900,9900,0,-2900,1950,6050
5790,5900,-1900,12000,0,0,16000
5791,-5900,200,0,-1000,0,-6700
5792,-4100,12000,0,0,0,7900
5793,-8500,200,0,12000,0,3700
5794,3500,200,0,0,0,3700
5795,-6800,200,0,-1000,0,-7600
5796,10100,-2200,0,1200,-1200,7900
5797,-1800,-2200,0,200,-1200,-5000
5798,10100,-2200,0,-2000,-950,4950
5799,7000,-700,-1200,1400,-1200,5300
5800,-2900,-2200,-2100,-3700,1950,-8950
5801,-4100,12000,-200,-1400,-3100,3200
5802,8600,200,1900,-5700,2900,7900
5803,-7900,-600,1000,-7700,1950,-13250
5804,13900,-5900,2800,-4800,0,6000
5805,-4100,-800,0,-3900,1950,-6850
5806,7000,100,-10200,20400,-1200,16100
5807,8400,9800,0,-2000,0,16200
5808,-100,-3100,9600,10600,-11150,5850
5809,11100,0,-1800,-1000,0,8300
5810,-2700,11300,4700,-9500,13950,17750
5811,7800,200,0,-3900,1950,6050
5812,-6300,-1100,0,-2600,-2400,-12400
5813,10000,-4400,-1200,1200,0,5600
5814,-200,-2300,0,10000,-950,6550
5815,9300,-1500,-2100,-600,-1200,3900
5816,-4500,-1300,1000,-6700,1950,-9550
5817,-500,-4400,2800,8200,-950,5150
5818,6800,9100,0,-5900,2900,12900
5819,-1900,-2100,0,9200,-10200,-5000
5820,10200,8900,-1200,-1800,0,16100
5821,10800,-3100,0,-2000,12000,17700
5822,-5100,-600,0,10000,0,4300
5823,-5100,13100,0,-800,-1200,6000
5824,5200,200,0,-2000,0,3400
5825,-2800,-2100,0,-1000,-950,-6850
5826,9000,6700,0,9200,-2150,22750
5827,-1900,-2900,-1200,-2700,2900,-5800
5828,7000,900,-900,-2900,1950,6050
5829,-4800,7600,1000,-5800,0,-2000
5830,8400,-2100,2800,-2800,0,6300
5831,500,-6200,0,11000,0,5300
5832,5800,-1200,0,-2000,0,2600
5833,10100,9000,0,-2000,0,17100
5834,-2900,-4500,-1200,12200,0,3600
5835,7000,-700,0,9400,-11400,4300
5836,-3000,9800,0,-1000,0,5800
5837,3300,500,0,1200,-1200,3800
5838,-400,7400,0,-4000,11050,14050
5839,10700,-6200,0,2400,-3350,3550
5840,-7600,1000,0,-3900,2900,-7600
5841,11100,-3100,0,-3700,-200,4100
5842,-6700,10500,-2400,400,0,1800
5843,10700,-2800,-2100,-3700,1950,4050
5844,-4400,9900,1000,-3800,-1900,800
5845,5900,-2800,-200,-5300,1700,-700
5846,-300,7400,4700,2500,1950,16250
5847,12500,-2900,0,-2900,1950,8650
5848,4200,400,0,11000,0,15600
5849,-1800,-2200,-1200,-800,0,-6000
5850,9800,7600,-900,11000,0,27500
5851,-300,-5300,1000,-2800,0,-7400
5852,5900,400,2800,-3800,0,5300
5853,-3600,8900,0,11000,0,16300
5854,7500,-2200,0,-1000,0,4300
5855,-3000,-4300,0,11000,0,3700
5856,10100,9100,-1200,-800,0,17200
5857,-6000,-600,-1200,-800,0,-8600
5858,10000,7500,0,-1000,0,16500
5859,-8400,300,-1800,200,-1200,-10900
5860,11000,-3000,4700,-5600,0,7100
5861,-3800,9900,0,-2000,0,4100
5862,7800,100,0,-2000,-950,4950
5863,-3600,-2200,0,-1000,0,-6800
5864,4900,10200,0,7100,1950,24150
5865,-400,-5400,0,-4000,-950,-10750
5866,8400,-2300,-2400,-300,1700,5100
5867,6100,11300,-900,-2000,0,14500
5868,-5400,-2000,-200,7400,0,-200
5869,5400,0,2800,-4800,0,3400
5870,-3000,6700,-1200,12200,0,14700
5871,11600,-3700,-900,-2800,-1200,3000
5872,-6900,-600,3800,-5600,0,-9300
5873,11600,-4500,0,12000,0,19100
5874,-4400,8100,0,-2000,-950,750
5875,4300,1100,0,-3000,0,2400
5876,-5200,-2200,-1200,9300,1950,2650
5877,13000,4400,-1200,-2700,1950,15450
5878,1300,-4500,-2700,-2000,0,-7900
5879,7700,-800,5600,-5600,0,6900
5880,1500,9700,0,11000,0,22200
5881,10200,-700,0,0,0,9500
5882,1300,7500,0,-1000,0,7800
5883,11100,100,0,11000,0,22200
5884,-2700,9000,0,200,-1200,5300
5885,10000,-2100,0,-800,-1200,5900
5886,-5300,-2900,0,0,0,-8200
5887,-400,-3700,0,9200,-11150,-6050
5888,10100,9100,0,0,0,19200
5889,-2800,-2100,0,-2900,1950,-5850
5890,2200,7400,-1200,-800,12000,19600
5891,10200,-1600,-2400,-3500,1950,4650
5892,-3400,1000,-2100,1600,-2400,-5300
5893,10100,9700,3800,-6600,0,17000
5894,-1100,-3800,-1800,1200,-1200,-6700
5895,-2700,-1300,4700,-8600,-950,-8850
5896,-1200,9800,0,-1000,-950,6650
5897,-2300,-5700,0,9300,1700,3000
5898,-6700,1100,0,-2900,1950,-6550
5899,10800,7500,0,10000,-950,27350
5900,-1000,-3100,0,200,-1200,-5100
5901,-5200,300,0,-4900,1950,-7850
5902,6500,10200,0,200,-2150,14750
5903,-6900,100,-1200,-2700,2900,-7800
5904,6200,-700,0,12000,-950,16550
5905,-4100,0,-10200,9200,0,-5100
5906,12100,5300,-1200,-2700,1950,15450
5907,-4400,-2000,-900,0,0,-7300
5908,7900,-800,13000,-5700,1950,16350
5909,-4800,-4300,1600,-2600,0,-10100
5910,7800,11400,0,-1000,0,18200
5911,-5900,100,0,-1000,0,-6800
5912,9500,-2300,0,12000,0,19200
5913,-2000,9800,0,-1000,0,6800
5914,10100,-2100,0,-1800,-1200,5000
5915,-1000,-2300,0,1200,-1200,-3300
5916,-3600,-400,0,-1000,0,-5000
5917,6200,100,0,-1000,-950,4350
5918,11200,12000,0,0,-950,22250
5919,-1800,0,0,-3900,2900,-2800
5920,10600,-4500,0,-2900,1950,5150
5921,-8600,400,0,12000,0,3800
5922,5000,-2700,0,0,0,2300
5923,-4500,-2100,0,0,0,-6600
5924,9400,9800,0,-1000,0,18200
5925,-2100,-4600,-1200,1400,-1200,-7700
5926,14000,-7600,-1200,200,0,5400
5927,-300,-3800,1000,-2800,0,-5900
5928,9400,12900,700,-2600,0,20400
5929,-4100,-800,0,-2000,0,-6900
5930,9400,12200,-3000,8400,-10200,16800
5931,-4200,100,3500,-4400,0,-5000
5932,11100,-800,-900,-1000,12000,20400
5933,-5100,12100,3800,-7600,0,3200
5934,7500,-1200,0,200,-1200,5300
5935,-5800,200,0,-1000,0,-6600
5936,7800,0,0,10000,-950,16850
5937,-1800,100,0,-800,-1200,-3700
5938,9200,-2100,-1200,-1700,1950,6150
5939,-1900,-2100,-2400,10400,-950,3050
5940,7800,100,-1200,-4700,2900,4900
5941,-1900,-3100,-1800,1200,-1200,-6800
5942,9400,100,2900,-9600,0,2800
5943,-1100,9900,3500,-4000,-3350,4950
5944,11000,-2300,-1200,11200,0,18700
5945,-2700,-600,0,-4900,1950,-6250
5946,8700,0,-200,9400,-1900,16000
5947,-100,-3100,1900,-7700,2900,-6100
5948,-3700,10800,0,-3900,1950,5150
5949,-4400,400,0,10000,-950,5050
5950,-400,-4600,0,-5900,2900,-8000
5951,10800,-5200,0,10000,0,15600
5952,-5000,-700,0,1400,-2400,-6700
5953,-3500,300,-1200,-2800,0,-7200
5954,5700,9100,-1800,12200,-2150,23050
5955,-3000,8600,1900,-3800,0,3700
5956,13100,-7700,1600,6500,1950,15450
5957,-5000,100,0,-1000,-950,-6850
5958,6100,-600,0,-3700,1700,3500
5959,-1800,9800,-1200,-1800,0,5000
5960,9200,-2300,0,10000,-950,15950
5961,-800,12000,1000,-3800,0,8400
5962,8400,200,700,6700,750,16750
5963,-4100,0,0,-2000,-950,-7050
5964,12500,-4600,0,-6900,2900,3900
5965,-4300,-1500,0,-1000,0,-6800
5966,-1900,-1300,-1200,10200,0,5800
5967,8600,12100,-1800,-1000,0,17900
5968,-2600,-700,4700,4600,-1200,4800
5969,10700,-3600,0,-2000,0,5100
5970,1500,-3100,-11400,6400,-950,-7550
5971,9500,0,0,2600,-3600,8500
5972,-4600,-2100,12000,-2900,1950,4350
5973,-8600,11000,0,5200,-12100,-4500
5974,-5900,200,0,-2700,1700,-6700
5975,-7100,10000,0,-3900,13950,12950
5976,11600,-3700,0,-2000,-1900,4000
5977,-7500,200,0,-2900,2900,-7300
5978,4400,-800,0,7300,750,11650
5979,-5800,100,0,11200,-1200,4300
5980,10700,7600,0,-3900,1950,16350
5981,-5800,200,0,-1000,-950,-7550
5982,9700,-4400,0,-4000,0,1300
5983,-2300,-7500,-1200,-1300,-450,-12750
5984,11500,-4400,-2100,200,-950,4250
5985,-2300,6800,-900,6100,2900,12600
5986,-500,-5200,4700,-5400,-2150,-8550
5987,11000,-2300,0,-2000,0,6700
5988,-2100,6800,-11400,19700,750,13750
5989,13100,-7600,-1800,-3900,1950,1750
5990,-2000,9800,16700,-6600,0,17900
5991,10400,-7500,0,-1000,-950,950
5992,600,-4600,0,-2000,-950,-6950
5993,10900,8300,0,8100,2900,30200
5994,-4200,200,-1200,-4500,750,-8950
5995,11000,-2300,0,13400,-2400,19700
5996,11100,10500,-1200,-800,0,19600
5997,-8800,1200,0,0,-950,-8550
5998,3600,-6900,-1800,0,0,-5100
5999,10900,7500,700,6500,1950,27550
6000,-3600,-3000,2800,-3800,-950,-8550
6001,-400,7600,-1200,-2700,2900,6200
6002,-3700,-2800,-900,0,0,-7400
6003,-5900,12300,1000,8200,0,15600
6004,6100,-600,2800,-2800,0,5500
6005,-2800,9800,0,-2000,0,5000
6006,8100,-4400,0,-1000,0,2700
6007,-1000,7400,-1200,12200,0,17400
6008,10200,-700,-1200,-800,0,7500
6009,-2500,0,-900,-1000,0,-4400
6010,-1200,9800,1000,-4800,0,4800
6011,14200,-5400,1600,-2600,0,7800
6012,5800,11700,-1200,400,-1200,15500
6013,-4500,-1200,-900,-2000,0,-8600
6014,-8700,-2000,1000,9400,-1200,-1500
6015,200,4600,2800,-3800,-950,2850
6016,7600,-2900,0,-800,-2150,1750
6017,-1000,9700,0,-2900,2900,8700
6018,7400,-2100,0,8100,1000,14400
6019,-400,6600,0,-800,-2150,3250
6020,11600,-6200,-1200,10300,2900,17400
6021,-3500,9900,0,-4900,1950,3450
6022,8200,-4200,-1200,400,-1200,2000
6023,-5000,12100,0,200,-1200,6100
6024,-1800,200,100,9200,-950,6750
6025,6000,12200,2800,-3800,0,17200
6026,-2000,-2200,0,-3700,750,-7150
6027,10200,9800,-1200,400,-2150,17050
6028,-4400,-3000,0,-3900,1950,-9350
6029,11800,-2300,0,0,0,9500
6030,8600,11400,0,8300,750,29050
6031,-1300,-4600,0,-2000,-950,-8850
6032,-2500,12100,-11400,7500,1950,7650
6033,9300,200,-2100,-800,0,6600
6034,-4100,0,3800,1700,-8250,-6850
6035,9500,0,12000,-1000,-950,19550
6036,-2700,100,0,-4700,13700,6400
6037,-2500,0,-1200,1200,0,-2500
6038,13400,-4600,-900,-1000,0,6900
6039,-2700,100,2600,5800,-1200,4600
6040,-3800,-2800,-1200,1400,-1200,-7600
6041,9900,-4300,-900,-2000,0,2700
6042,-1700,8900,1000,-2600,-2150,3450
6043,1800,-6900,400,-3400,-950,-9050
6044,400,6800,-1200,9500,1700,17200
6045,-1900,-3100,-3000,-3700,1000,-10700
6046,8600,12200,4700,-7600,-950,16950
6047,-2200,-4400,-1800,-2900,2900,-8400
6048,-4200,-700,3500,2700,1950,3250
6049,-5100,12300,0,-800,-1200,5200
6050,-5800,-700,-1200,12200,0,4500
6051,11800,10600,-1800,-3000,0,17600
6052,10500,-5300,3500,-4400,-950,3350
6053,-4200,200,0,11000,-950,6050
6054,8300,-2900,0,-4900,2900,3400
6055,-3700,-2100,-2400,9500,1950,3250
6056,-6200,10100,-900,-800,-1200,1000
6057,6500,-1900,1000,-4800,0,800
6058,-1100,-4600,2800,9400,-1200,5300
6059,10000,7400,0,-2000,0,15400
6060,-4300,-3000,0,0,-950,-8250
6061,11600,-5300,0,-2000,0,4300
6062,-100,9700,-1200,8300,1950,18650
6063,10200,-700,-900,0,-950,7650
6064,-3500,12200,1000,-7700,2900,4900
6065,4300,100,2800,6400,-10200,3400
6066,-7600,12300,0,-1000,0,3700
6067,6200,100,-1200,-800,12000,16300
6068,2200,-4600,0,11000,0,8600
6069,10200,-700,0,-1000,0,8500
6070,-500,-4400,0,10000,0,5100
6071,10900,9800,-1200,200,0,19700
6072,-1900,-3000,-900,-1000,0,-6800
6073,8500,-2900,1000,-2600,-1200,2800
6074,-2500,100,2800,-3800,0,-3400
6075,-3400,12100,0,-1000,0,7700
6076,600,-1400,0,-1600,-2400,-4800
6077,7600,-700,0,-1000,0,5900
6078,-5400,-1800,0,10000,-950,1850
6079,10800,6800,-1200,2400,-2150,16650
6080,-3000,-3600,0,-3900,2900,-7600
6081,-6100,-2700,0,-3900,1000,-11700
6082,9400,-2300,-10200,9200,-950,5150
6083,-300,8200,-1200,-4700,2900,4900
6084,-1100,-1400,0,-2900,1950,-3450
6085,10800,9800,0,8400,-1200,27800
6086,-3200,-800,3500,-6200,-1200,-7900
6087,11400,-4200,-1200,1200,0,7200
6088,400,7500,12100,-4800,-950,14250
6089,2200,-5400,2800,-4800,0,-5200
6090,11100,-700,0,9300,750,20450
6091,-4200,12200,0,-1000,-950,6050
6092,-3700,-2100,0,-4900,2900,-7800
6093,-4500,-2200,0,13200,-1200,5300
6094,-2800,9100,0,-1000,0,5300
6095,11300,-7600,0,0,-950,2750
6096,-7000,-1900,0,11000,-950,1150
6097,8200,7700,0,-3700,1700,13900
6098,-300,-5400,0,-4900,1950,-8650
6099,-400,7400,0,1400,-2400,6000
6100,6900,-700,0,-1000,0,5200
6101,-3400,12100,0,-1000,-950,6750
6102,-6000,300,0,-1000,0,-6700
6103,6600,-2000,0,8100,1950,14650
6104,8400,9100,0,1400,-3350,15550
6105,-1200,-4600,0,-3700,1700,-7800
6106,-4300,12100,0,-2000,-950,4850
6107,11000,-6200,0,13200,-2150,15850
6108,-3800,-1200,0,-5900,1950,-8950
6109,9300,9800,-1200,-1500,750,17150
6110,-1900,-3000,0,-1000,-950,-6850
6111,8500,200,0,-5900,1950,4750
6112,-1800,-2300,-1200,-1700,1950,-5050
6113,9400,12200,0,10000,-950,30650
6114,-6000,-700,100,-7500,1700,-12400
6115,5700,-1800,2800,4700,-9450,1950
6116,-2700,9800,0,-3000,0,4100
6117,7000,-800,0,-2000,11050,15250
6118,-6800,900,-1200,400,-1200,-7900
6119,9100,-4300,0,9100,1950,15850
6120,-2600,-3100,0,0,-950,-6650
6121,12000,0,0,7100,2900,22000
6122,10200,-700,0,-2000,0,7500
6123,-5300,13100,0,0,0,7800
6124,10400,-6600,0,10000,0,13800
6125,-2700,-2900,-2100,1200,0,-6500
6126,11500,-4500,1000,-2600,-1200,4200
6127,-6600,-800,2800,-3800,0,-8400
6128,-1000,8900,0,-1000,-950,5950
6129,7400,-4300,0,0,0,3100
6130,-1600,8000,0,-3900,1950,4450
6131,9200,-3100,0,12000,-950,17150
6132,-4200,100,0,-4700,1700,-7100
6133,8200,7600,0,-4000,0,11800
6134,-2100,-5300,0,-800,-1200,-9400
6135,-5300,9900,0,200,-1200,3600
6136,6200,-700,0,11000,-950,15550
6137,-5300,-2700,0,-3000,-950,-11950
6138,10700,8300,0,-3500,500,16000
6139,-2800,-2900,-1200,-1300,-450,-8650
6140,4200,12400,0,-2000,-950,13650
6141,-2700,-2300,0,-2000,0,-7000
6142,9800,6900,0,9100,1950,27750
6143,-10300,500,0,-1000,-1900,-12700
6144,10100,9000,-1200,9500,1700,29100
6145,-6000,200,0,-3900,1950,-7750
6146,10200,-2300,-1800,0,-950,5150
6147,-4400,-2100,3500,3700,1950,2650
6148,12500,7400,0,-2900,1950,18950
6149,8800,-800,0,-1000,0,7000
6150,-2800,-2300,0,-3900,1950,-7050
6151,10100,-2200,-1200,12200,0,18900
6152,-2000,9800,-900,-1000,0,5900
6153,9300,-3000,1000,-3800,0,3500
6154,-3700,-2200,2800,8200,0,5100
6155,-1600,0,-1200,-1800,0,-4600
6156,11700,9000,0,-800,-1200,18700
6157,9200,-2100,0,-2000,0,5100
6158,-3400,12100,0,11000,0,19700
6159,-6800,200,0,-1000,0,-7600
6160,7500,-2000,0,-2000,0,3500
6161,6600,-2700,0,0,0,3900
6162,-3500,-2100,0,-3000,0,-8600
6163,-8400,300,0,-1000,0,-9100
6164,11700,7500,0,200,-1200,18200
6165,400,-5300,0,11000,0,6100
6166,11100,0,0,-1800,-2150,7150
6167,11100,10400,0,-1000,-950,19550
6168,-10500,1600,0,-3900,2900,-9900
6169,-3600,-2200,0,-3900,1950,-7750
6170,6200,12100,0,10000,0,28300
6171,-2100,-4500,-2400,400,0,-8600
6172,8400,-2900,-900,-1800,-1200,1600
6173,-6000,300,1000,-3800,0,-8500
6174,8200,-4400,2800,8400,-2150,12850
6175,10300,9700,0,-800,-1200,18000
6176,500,-5400,0,-2900,1950,-5850
6177,11100,-700,0,12000,-1900,20500
6178,-3400,100,0,-3700,1700,-5300
6179,12600,9700,0,-4900,1950,19350
6180,-3500,100,-1200,1400,-1200,-4400
6181,13200,7500,0,8100,1950,30750
6182,-3300,-800,-3900,200,-950,-8750
6183,7800,100,5600,3600,-11150,5950
6184,-3700,-2000,0,-3900,2900,-6700
6185,-4600,9900,0,-2900,13950,16350
6186,-4000,0,0,-3000,0,-7000
6187,9900,-4600,0,-1000,0,4300
6188,-2500,-800,0,12000,0,8700
6189,7600,200,0,-1000,0,6800
6190,-3500,9800,0,-1000,0,5300
6191,10300,0,0,-1000,0,9300
6192,-6300,-1900,-2400,13600,-1200,1800
6193,5200,200,-1800,-1000,0,2600
6194,-4600,-5300,4700,-5600,0,-10800
6195,6000,-600,0,-1000,0,4400
6196,1700,3900,0,-2000,0,3600
6197,10200,-3100,0,0,0,7100
6198,-2600,-2300,0,12200,-1200,6100
6199,7600,11500,0,0,0,19100
6200,-1100,-3000,-1200,200,0,-5100
6201,5100,200,-900,0,-950,3450
6202,7100,12000,1000,-2800,-950,16350
6203,-4300,100,2800,-5700,2900,-4200
6204,8400,9900,0,-2900,1950,17350
6205,-5100,200,0,-2000,0,-6900
6206,11000,-2300,0,12000,0,20700
6207,-3500,200,-2400,400,0,-5300
6208,9200,-2200,-900,0,0,6100
6209,-2600,-2200,1000,-3800,0,-7600
6210,8500,-600,2800,-2800,0,7900
6211,-200,-2200,0,-1000,0,-3400
6212,5100,11600,-1200,-1800,0,13700
6213,-7100,-1300,0,12200,-1200,2600
6214,5300,-600,0,-1000,0,3700
6215,-6800,200,0,-1000,0,-7600
6216,5200,300,-1200,200,0,4500
6217,1100,5300,-900,-1000,0,4500
6218,12500,-4600,2600,-7400,0,3100
6219,-1900,-3000,0,200,-1200,-5900
6220,10100,-2200,0,0,0,7900
6221,-1000,8900,0,11000,-950,17950
6222,7600,300,0,-2000,-950,4950
6223,-5900,200,0,-3900,2900,-6700
6224,9600,12000,0,-4900,1950,18650
6225,-3800,-2100,0,9200,-10200,-6900
6226,7700,-2900,0,-3000,0,1800
6227,-4300,200,-10200,8200,12000,5900
6228,8400,-2200,-2400,400,0,4200
6229,-4400,9700,13000,-3800,0,14500
6230,9100,-2900,1900,-5800,0,2300
6231,-2700,-2300,0,-600,-2400,-8000
6232,-200,9700,-1200,400,-1200,7500
6233,8200,-2000,-1800,0,-950,3450
6234,10200,-3000,1900,7200,-950,15350
6235,-4200,200,2800,-6700,2900,-5000
6236,7600,9900,0,8500,-450,25550
6237,-1100,-2100,0,-2000,0,-5200
6238,7800,-700,0,0,-950,6150
6239,0,0,0,11000,0,11000
6240,11100,12000,0,-3900,1950,21150
6241,-3600,-2200,0,11000,-950,4250
6242,12800,-6600,0,-2900,2900,6200
6243,-3400,-700,0,-1000,0,-5100
6244,-3200,0,0,-2000,0,-5200
6245,-4600,9200,0,200,-1200,3600
6246,-5300,-1200,0,-2000,0,-8500
6247,8500,-3000,-10200,10200,-950,4550
6248,-3700,-4400,0,-2000,-950,-11050
6249,9200,9700,12000,-3900,2900,29900
6250,-1900,-2900,-1200,-2700,1950,-6750
6251,12300,-5300,0,-2000,0,5000
6252,-4500,9300,0,10200,-10200,4800
6253,9100,-3600,0,0,0,5500
6254,-1000,8900,0,-1000,12000,18900
6255,9400,-700,0,1200,-1200,8700
6256,-3600,-400,0,-1000,0,-5000
6257,10000,10700,-1200,-800,0,18700
6258,-300,-4600,-4200,2600,-1200,-7700
6259,-2100,7700,3800,-7600,0,1800
6260,-6200,-4500,-1400,-400,0,-12500
6261,-2800,-1300,1900,6400,-11150,-6950
6262,8700,12000,1000,-5700,1950,17950
6263,1400,-4600,-7400,6400,11050,6850
6264,10200,12100,0,-3700,1700,20300
6265,-3600,-4500,0,0,0,-8100
6266,6900,1800,12000,12000,0,32700
6267,-5800,12100,0,0,0,6300
6268,-1800,100,-2400,-600,0,-4700
6269,10100,-2200,-1200,200,0,6900
6270,-6800,100,-1800,-4000,0,-12500
6271,11000,-2200,1100,-2800,-1200,5900
6272,-6100,-600,-2700,-1000,0,-10400
6273,6900,200,3800,3600,-10200,4300
6274,9400,9700,4700,-7600,-950,15250
6275,-300,-2300,0,-4500,-450,-7550
6276,8700,0,0,0,12000,20700
6277,-900,100,0,6100,1950,7250
6278,10100,-2200,0,0,-950,6950
6279,-6000,-600,0,9000,-950,1450
6280,9500,100,0,-2700,1700,8600
6281,-1100,-2300,0,-5900,1950,-7350
6282,-3400,11300,-1200,200,0,6900
6283,11600,-4500,0,-3000,0,4100
6284,-5500,-2000,-2400,12600,-1200,1500
6285,4400,400,-900,-1000,0,2900
6286,1200,-6800,-200,10400,-950,3650
6287,-2200,6800,-200,-3600,0,800
6288,-2400,0,4700,-10300,750,-7250
6289,9100,-2800,-10200,9200,-950,4350
6290,-2500,12000,-1200,-3700,2900,7500
6291,12200,-6800,11100,-1000,0,15500
6292,-2400,7000,1000,7200,0,12800
6293,10200,-2200,1600,-2600,0,7000
6294,-2200,-6700,0,0,0,-8900
6295,-6500,9500,-12600,21600,0,12000
6296,-300,-5400,-3000,200,0,-8500
6297,-4500,9100,16700,-8600,0,12700
6298,7600,-3000,-1800,1400,-2400,1800
6299,-2900,-4300,4700,-5600,0,-8100
6300,11600,7400,0,-3000,-950,15050
6301,1300,-5400,0,1200,-2150,-5050
6302,11700,-2200,0,7100,2900,19500
6303,-6500,8500,0,-1700,-200,100
6304,11000,-1400,0,0,0,9600
6305,-4000,10400,0,9100,1950,17450
6306,300,-6700,0,0,-950,-7350
6307,-6000,13100,-1200,-4700,2900,4100
6308,-5900,-600,-2400,400,0,-8500
6309,13000,5300,-900,12000,0,29400
6310,11000,-3100,1000,-2800,0,6100
6311,-3500,12300,2800,-3800,0,7800
6312,3200,-1900,0,1200,-1200,1300
6313,-1900,9800,0,-1000,0,6900
6314,-5800,-700,-1200,200,-950,-8450
6315,12400,7500,-900,8100,1950,29050
6316,8300,-2200,1000,-1600,-2150,3350
6317,-1200,-5300,2800,-6500,1700,-8500
6318,10600,7600,-1200,-600,-1200,15200
6319,500,6700,-10200,10200,-950,6250
6320,8700,100,-1200,-800,0,6800
6321,500,-2900,-900,-3900,1950,-5250
6322,-4200,12100,13000,-3800,-950,16150
6323,-100,-2300,2800,-6700,2900,-3400
6324,8500,12300,-1200,-2800,0,16800
6325,-1100,-3000,-11400,9400,0,-6100
6326,-5300,400,-1800,200,-1200,-7700
6327,14200,-4600,16700,-7600,0,18700
6328,-1800,-2200,-1200,200,-950,-5950
6329,-3600,9800,0,11000,-950,16250
6330,-3600,-2800,0,-2900,2900,-6400
6331,-2900,-2800,-1200,8300,1950,3350
6332,4900,10100,-11100,10200,0,14100
6333,2800,-6800,1000,-3800,0,-6800
6334,10200,9000,12400,-1400,0,30200
6335,-1200,-4600,-900,0,0,-6700
6336,-3400,12100,1000,-3600,-1200,4900
6337,10800,-3800,2800,-2800,0,7000
6338,-4300,1000,0,10000,0,6700
6339,10800,7600,0,1200,-1200,18400
6340,-4100,-1500,0,0,0,-5600
6341,-4500,-2100,0,0,-950,-7550
6342,-3400,12900,0,0,0,9500
6343,6100,-600,0,-2900,1950,4550
6344,-1400,-3400,0,0,0,-4800
6345,6700,-2200,-1200,-4700,1950,550
6346,-9500,-300,0,-800,-1200,-11800
6347,12400,-4500,0,10000,0,17900
6348,-3500,9000,0,2400,-2400,5500
6349,8500,-2100,0,-1000,0,5400
6350,9000,-5200,0,-2000,-950,850
6351,-1000,9800,0,-1000,0,7800
6352,8300,-2000,0,-3700,750,3350
6353,-1900,8900,0,-1800,-2150,3050
6354,10100,-2300,-11400,7500,1950,5850
6355,-5500,9300,0,-1000,0,2800
6356,6100,100,10200,-4900,1950,13450
6357,-2700,-2900,4700,-5600,-950,-7450
6358,4400,13000,0,-2900,2900,17400
6359,-400,-4400,0,8000,0,3200
6360,3000,-2600,0,-1000,0,-600
6361,-2700,-3000,0,200,-1200,-6700
6362,9200,-1400,-1200,11400,-1200,16800
6363,-2300,4500,0,1200,-2150,1250
6364,12400,-5300,0,-1000,-950,5150
6365,-4900,12000,-1200,-3700,1950,4150
6366,9200,-2900,-10200,5300,1950,3350
6367,-2200,7700,-3000,-800,-950,750
6368,4500,200,4700,-9500,2900,2800
6369,-1900,-2900,12000,-4900,1950,4250
6370,-5400,10000,-10200,10400,-1200,3600
6371,6900,100,0,11000,0,18000
6372,-4500,-2100,0,-1000,0,-7600
6373,10900,5800,12000,0,0,28700
6374,-1900,-2100,0,12000,0,8000
6375,10100,-2200,0,-2000,0,5900
6376,300,7700,-2400,1400,0,7000
6377,10000,-2300,-1800,400,-2400,3900
6378,10200,8900,3500,-5400,0,17200
6379,-100,-2300,-900,-1000,0,-4300
6380,11100,12000,1000,-3800,-950,19350
6381,-900,-800,2800,-2600,-1200,-2700
6382,9400,100,0,-4700,750,5550
6383,400,7600,0,0,-950,7050
6384,-4600,-2000,0,-3900,1950,-8550
6385,-6700,-700,0,9100,1950,3650
6386,-6100,-2900,0,200,-1200,-10000
6387,-3500,10600,-1200,7500,750,14150
6388,5200,200,-10200,10400,-2150,3450
6389,-2700,-2100,-1200,200,0,-5800
6390,10000,-2200,9000,-2500,750,15050
6391,-1000,-3000,3500,-4400,-1900,-6800
6392,12400,-5300,-1800,-2700,1700,4300
6393,-1900,9900,4700,-9500,1950,5150
6394,11700,-2200,0,-1000,-950,7550
6395,-500,6900,-11400,16500,1950,13450
6396,10000,-2100,-2400,1600,-2150,4950
6397,-5000,-800,10800,6500,-7300,4200
6398,-1200,7400,-1800,-3900,1950,2450
6399,1400,-2200,1700,-5400,12000,7500
6400,7700,11300,4700,-7600,0,16100
6401,4200,-9000,0,-2000,0,-6800
6402,12400,7500,0,11200,-1200,29900
6403,700,-3100,0,-1000,0,-3400
6404,1500,-3100,0,0,-950,-2550
6405,0,12000,0,11000,0,23000
6406,-3600,200,0,-5900,1950,-7350
6407,-2700,9800,0,-1000,-950,5150
6408,-900,-2300,0,-3900,2900,-4200
6409,-4600,-2800,0,-1800,-1200,-10400
6410,-3800,-4500,0,0,0,-8300
6411,-5100,11400,0,8000,0,14300
6412,5100,-9200,0,400,-2400,-6100
6413,10300,-800,0,0,0,9500
6414,-1600,12000,0,11000,-950,20450
6415,11100,100,0,-1000,-950,9250
6416,-3600,200,0,-3900,2900,-4400
6417,-4900,10500,-1200,-1800,-950,1650
6418,5800,2100,-2100,-3700,2900,5000
6419,-7700,-600,1000,-2800,0,-10100
6420,-300,-3700,2800,7200,0,6000
6421,6700,-2900,0,-1000,0,2800
6422,2600,-9900,0,-1000,0,-8300
6423,5300,12200,-1200,10400,-1200,25500
6424,-3400,-800,-900,1200,-1200,-5100
6425,7000,100,1000,-2800,0,5300
6426,-200,9800,2800,9200,-950,20650
6427,9400,100,0,-1000,-950,7550
6428,3000,7400,-10200,7500,1700,9400
6429,10200,-800,0,-800,-2150,6450
6430,-1800,200,12000,-2900,2900,10400
6431,8700,0,0,200,-2150,6750
6432,-1900,9900,0,-3900,1950,6050
6433,-500,-4400,0,0,-950,-5850
6434,-4200,100,0,-3900,1950,-6050
6435,-4200,-1400,0,7300,-8250,-6550
6436,9200,-1300,0,-1000,0,6900
6437,-500,7600,0,-3700,12750,16150
6438,-2700,-2200,0,0,0,-4900
6439,7400,-2800,-10200,8200,0,2600
6440,-2600,-2200,0,-1000,0,-5800
6441,-3900,7600,0,0,0,3700
6442,-4000,-5100,10800,200,0,1900
6443,11700,-4600,0,-1000,0,6100
6444,10800,-5300,0,0,0,5500
6445,-200,8200,0,0,0,8000
6446,-2900,-2000,0,0,0,-4900
6447,6900,12300,0,-1800,-1200,16200
6448,8000,-4100,0,-2000,0,1900
6449,-5900,200,0,1200,-1200,-5700
6450,-3300,11200,-10200,8200,-950,4950
6451,-800,-6600,-1200,200,0,-8400
6452,8400,-2100,0,-3700,750,3350
6453,-2600,9000,9000,-1500,750,14650
6454,-600,-6800,4700,-5600,0,-8300
6455,12500,6700,0,-1000,-950,17250
6456,8400,100,0,-1000,-950,6550
6457,-1000,9000,-1200,-1700,1950,7050
6458,-2800,-2100,-3000,8500,1700,2300
6459,10300,-2300,-5500,4600,0,7100
6460,-1200,9100,0,-1000,-950,5950
6461,-200,-2300,12000,-1000,0,8500
6462,7700,12000,0,9200,-11150,17750
6463,-6100,-2900,0,-2900,2900,-9000
6464,-3600,9800,0,-4900,13950,15250
6465,5800,-2200,-1200,-1800,0,600
6466,-4100,100,0,200,-1200,-5000
6467,13100,6700,-12000,8200,0,16000
6468,-1900,-2200,4700,-5400,-1200,-6000
6469,-3600,9700,0,-1000,0,5100
6470,10900,-2900,12000,-2000,-950,17050
6471,-4200,200,-2400,-1400,-2150,-9950
6472,4300,12400,-1800,9100,2900,26900
6473,11600,-4500,4700,-9500,1950,4250
6474,-5000,-700,-2400,400,0,-7700
6475,-1900,-2200,-900,-1000,0,-6000
6476,7600,100,1000,8200,0,16900
6477,-2700,9800,2800,-3800,0,6100
6478,13900,-7600,0,11000,0,17300
6479,-2200,-4300,-1200,9600,-11400,-9500
6480,13100,4300,0,0,0,17400
6481,-3300,-800,0,0,-950,-5050
6482,-900,11300,0,0,12000,22400
6483,9200,-1300,-1200,200,-950,5950
6484,-3500,12100,-1200,-3700,1950,5650
6485,-3500,-3100,-3000,-2700,2900,-9400
6486,-3700,-2200,4700,-5600,0,-6800
6487,6800,12100,-4200,-1600,0,13100
6488,-2100,-4400,3800,-4400,-1200,-8300
6489,3700,-1400,1000,9200,0,12500
6490,-3700,-1300,2800,-6800,0,-9000
6491,-700,5300,0,1400,-2400,3600
6492,10800,-5200,0,10000,0,15600
6493,11000,-2300,0,1400,-3350,6750
6494,-2500,-700,0,11000,0,7800
6495,7600,12300,0,-7900,1000,13000
6496,-3300,100,-1200,200,-950,-5150
6497,11000,9800,0,-4900,2900,18800
6498,-3500,200,0,-4900,1950,-6250
6499,-3600,-2900,0,-1000,-950,-8450
6500,13300,-4600,0,-3700,1700,6700
6501,-1200,-2100,-1200,10200,0,5700
6502,6000,11600,-1800,9200,-10200,14800
6503,-5300,-2700,4700,-6400,-2150,-11850
6504,-5800,900,0,-2800,9850,2150
6505,-1000,9800,-1200,8500,-7300,8800
6506,7700,100,0,-4900,1000,3900
6507,-1100,-3000,0,-2000,12000,5900
6508,11500,-4600,0,9300,750,16950
6509,-2700,9900,0,0,-950,6250
6510,7000,-600,0,9100,2900,18400
6511,2600,-8400,0,0,0,-5800
6512,10600,8600,0,-1000,0,18200
6513,-4900,0,0,-1000,0,-5900
6514,-6300,9300,0,11200,-1200,13000
6515,2700,-6900,0,0,0,-4200
6516,-2700,9800,0,-1000,0,6100
6517,7000,-700,0,-2000,-950,3350
6518,2700,-6800,0,0,-950,-5050
6519,8300,9000,0,-3700,1700,15300
6520,-1800,-2300,0,-4900,1950,-7050
6521,6900,-700,0,-1000,0,5200
6522,-1000,9700,0,-1800,-1200,5700
6523,-900,100,0,-1000,0,-1800
6524,6700,10000,0,11000,0,27700
6525,-2000,-2100,0,-3000,-950,-8050
6526,-3500,-3000,0,-3500,-450,-10450
6527,5900,300,-10200,8200,-950,3250
6528,-5200,11500,0,-1700,750,5350
6529,10700,-4400,12000,-4000,0,14300
6530,-1300,-4300,-10200,8400,-2150,-9550
6531,10200,-2200,0,-3900,2900,7000
6532,-2700,8900,0,-3900,1000,3300
6533,-4400,-3600,1800,8200,0,2000
6534,8100,-3600,0,-2900,1950,3550
6535,-900,9700,12000,-1000,-950,18850
6536,6800,200,0,-6900,2900,3000
6537,-4200,10600,-1200,2400,-1200,6400
6538,-6800,1000,-900,-3000,0,-9700
6539,6800,-6300,-7600,17000,-1200,8700
6540,-2700,8200,-2400,400,0,3500
6541,5600,-1100,9900,-400,-3350,10650
6542,9900,-4400,100,-3800,-950,850
6543,-4700,7000,2600,-8300,2900,-500
6544,6100,0,2800,-7700,1000,2200
6545,-6000,-700,0,0,-950,-7650
6546,13100,5200,0,5300,-7300,16300
6547,-1400,-4300,0,9300,750,4350
6548,5800,-2900,0,-1000,0,1900
6549,6900,12300,0,-3000,12000,28200
6550,-4800,-5000,-1200,13200,0,2200
6551,4500,12200,-1800,-2000,0,12900
6552,-8800,-2900,3500,-6400,0,-14600
6553,8900,8600,0,12000,0,29500
6554,-300,-5300,0,-1000,0,-6600
6555,14800,-7700,0,200,-1200,6100
6556,300,5200,-1200,-800,0,3500
6557,6900,-1400,-1800,12000,0,15700
6558,-8500,200,4700,-7600,-950,-12150
6559,7300,7700,0,200,-2150,13050
6560,-10200,100,0,-5900,2900,-13100
6561,8800,11200,-1200,-3700,1950,17050
6562,12200,-7500,-1200,13400,-1200,15700
6563,-2700,-1300,-2100,-2800,0,-8900
6564,10100,8900,3800,-5600,-950,16250
6565,500,-4500,0,10200,-1200,5000
6566,8000,7000,0,-4900,1950,12050
6567,-1000,-2200,0,-800,-2150,-6150
6568,7300,-5200,-1200,-3700,2900,100
6569,-5100,11500,-2100,13200,0,17500
6570,9800,-4300,1000,-2800,-950,2750
6571,6700,9900,2800,8200,-950,26650
6572,-5600,-4900,0,-2900,2900,-10500
6573,-5000,12100,0,-3900,1950,5150
6574,11400,-6700,-1200,200,0,3700
6575,9800,6000,-900,11000,0,25900
6576,-5800,900,3800,-7600,0,-8700
6577,9000,6800,-1200,1200,0,15800
6578,-5200,-2800,-1200,-1800,0,-11000
6579,9000,-4400,0,0,0,4600
6580,-5800,12100,-1800,11000,0,15500
6581,-5400,-2900,3500,-6400,0,-11200
6582,10700,7600,0,0,0,18300
6583,6600,-2800,0,12000,0,15800
6584,-5100,-2200,-1200,200,0,-8300
6585,8500,9700,0,0,0,18200
6586,400,-4500,-1800,0,0,-5900
6587,13500,8900,1900,-5800,0,18500
6588,-4300,-600,2800,-3800,0,-5900
6589,10300,11300,0,200,-1200,20600
6590,-2800,-1400,0,-1000,0,-5200
6591,6500,-1900,0,11000,0,15600
6592,-1000,9700,0,-1000,0,7700
6593,6200,100,0,-600,-2400,3300
6594,1200,6700,0,0,0,7900
6595,7400,-2200,0,-2000,-950,2250
6596,8400,-2800,0,-1000,0,4600
6597,-2700,9800,0,9100,1950,18150
6598,-4400,-2200,0,-3700,750,-9550
6599,12400,6600,0,-800,-1200,17000
6600,11700,-2300,-1200,1200,0,9400
6601,-4200,-600,0,11000,-950,5250
6602,8700,12100,0,-1000,-950,18850
6603,-5200,100,-1200,-2700,2900,-6100
6604,-3300,11300,-1800,-2900,1950,5250
6605,6600,-1300,4700,-7600,0,2400
6606,-1000,-2300,-1200,-600,-1200,-6300
6607,8300,-2100,-2100,400,-1200,3300
6608,-2100,-5200,-200,8400,-950,-50
6609,14100,-4500,1600,-5600,0,5600
6610,-2000,-2900,-1800,-2900,1950,-7650
6611,8000,12000,4700,-7600,-950,16150
6612,600,-2200,0,9300,1700,9400
6613,-4400,-700,0,-2000,0,-7100
6614,11500,6800,0,11000,-950,28350
6615,200,-5800,0,0,0,-5600
6616,-3100,6900,0,7100,1950,12850
6617,-1900,-2300,0,0,-950,-5150
6618,-2700,-3000,0,-4900,2900,-7700
6619,-5900,11300,0,-1000,0,4400
6620,10800,-4500,-1200,12200,0,17300
6621,-5300,9900,-1200,-800,0,2600
6622,13100,-6800,-1200,200,0,5300
6623,1200,-6200,1000,-4800,0,-8800
6624,10700,8300,1900,-2600,-1200,17100
6625,0,-1600,0,0,0,-1600
6626,10900,9800,0,11000,0,31700
6627,-2000,-2100,0,-1000,0,-5100
6628,-500,6800,0,0,0,6300
6629,-3600,-2000,0,12000,0,6400
6630,-4200,-600,0,0,0,-4800
6631,-6800,11500,0,-1000,0,3700
6632,-6800,1100,0,-3000,0,-8700
6633,10800,7500,-1200,1200,0,18300
6634,-2600,-3100,0,-1000,0,-6700
6635,5900,-500,-3000,200,0,2600
6636,-5000,13000,4700,-5400,-1200,6100
6637,6100,200,-1200,-1800,0,3300
6638,-1900,9900,-900,-800,-1200,5100
6639,10100,-2300,1000,-1600,-2150,5050
6640,-5100,200,2800,9200,-950,6150
6641,-6000,300,0,-3900,1950,-7650
6642,10300,-2300,0,-3700,750,5050
6643,10800,-2900,-1200,-3500,750,3950
6644,-2800,-2100,-1200,11200,-950,4150
6645,8300,-2100,-900,-3700,1700,3300
6646,-1800,9700,3800,4600,-11150,5150
6647,11400,-6100,-1200,-800,-950,2350
6648,-5500,-2800,0,-3700,13700,1700
6649,6600,9900,0,8100,1950,26550
6650,-2800,-1300,0,-1000,0,-5100
6651,9300,9900,0,-1000,-950,17250
6652,-6100,-2800,0,10000,-950,150
6653,9200,-2200,0,-2900,2900,7000
6654,-7100,9300,0,-3900,1950,250
6655,6900,200,0,-2000,0,5100
6656,-1800,-2300,-1200,-800,0,-6100
6657,10200,9800,-900,-2000,0,17100
6658,-5000,-800,1000,7200,0,2400
6659,8500,-2200,2800,-5800,0,3300
6660,-2100,-4500,0,200,-1200,-7600
6661,12500,7500,0,-3000,0,17000
6662,11100,-800,0,12200,-1200,21300
6663,-900,100,0,-1000,0,-1800
6664,-1900,9700,0,9000,0,16800
6665,14300,-2300,-1200,-800,-950,9050
6666,-2600,-600,-1200,-600,-2150,-7150
6667,10200,-2200,-1100,-6500,2900,3300
6668,600,9700,2800,-7700,1950,7350
6669,-1800,-600,0,-2000,0,-4400
6670,10000,-2000,0,12000,0,20000
6671,-6500,-4200,0,-3000,0,-13700
6672,-1100,7500,0,13200,-1200,18400
6673,-2800,-2900,0,0,0,-5700
6674,-2200,-4400,0,0,-950,-7550
6675,-1700,8900,0,11000,0,18200
6676,7300,-2000,-1200,-1500,750,3350
6677,-2700,-3100,-900,0,-950,-7650
6678,11200,5400,1000,-6700,2900,13800
6679,-2600,-3800,1600,-2600,0,-7400
6680,10400,4700,-10200,8400,-1200,12100
6681,-2500,-6500,0,-800,-1200,-11000
6682,-3500,-2100,-1200,-600,-1200,-8600
6683,11000,9000,9000,-800,-950,27250
6684,-4100,0,3500,-4400,-950,-5950
6685,400,7400,-900,-5900,1000,2000
6686,8400,-600,1000,3500,-7300,5000
6687,-2600,-3000,1600,-5500,1950,-7550
6688,5200,13200,0,-1000,11050,28450
6689,-5400,-2000,0,5300,-7300,-9400
6690,-2200,7800,-1200,12200,0,16600
6691,6200,-700,0,-3000,0,2500
6692,-4500,-2200,-2300,-1400,12000,1600
6693,9300,8900,1900,9400,-1200,28300
6694,-2700,-2200,1000,-4800,0,-8700
6695,8600,12100,2800,-2600,-1200,19700
6696,-5000,0,-1200,12200,0,6000
6697,6000,12200,-1200,10400,-11150,16250
6698,6500,-1900,-900,0,0,3700
6699,-6600,200,1900,-7700,13950,1750
6700,-1900,-3000,700,-1600,-950,-6750
6701,9200,-2000,0,-2900,2900,7200
6702,9300,9700,0,-1000,0,18000
6703,-6900,-500,0,-2000,0,-9400
6704,12500,-4500,0,13200,-1200,20000
6705,-1000,-2300,-1200,200,0,-4300
6706,6600,11600,-2100,-600,-1200,14300
6707,-5900,100,-2100,-800,0,-8700
6708,14900,5100,4700,-6600,0,18100
6709,-5900,200,-900,0,-950,-7550
6710,9500,-1500,1000,2500,-8250,3250
6711,5100,1000,2800,-2800,0,6100
6712,-2600,-2200,0,-3900,13950,5250
6713,11700,9800,0,-1000,0,20500
6714,-4300,0,0,11000,0,6700
6715,10600,-4400,0,-1000,0,5200
6716,500,-5300,-1200,11400,-1200,4200
6717,8400,-2200,0,-1000,0,5200
6718,-200,-3100,0,0,0,-3300
6719,10100,9800,0,-1000,0,18900
6720,-2800,9800,-1200,200,0,6000
6721,2200,-5400,0,-1000,0,-4200
6722,10200,100,-1800,-800,-1200,6500
6723,-3400,11300,4700,-6400,-1200,5000
6724,-1800,-2300,0,-800,-2150,-7050
6725,-2700,12200,0,-800,-1200,7500
6726,-3400,200,0,9100,1950,7850
6727,8900,-4300,0,-2000,-1900,700
6728,100,-6800,-1200,-3700,2900,-8700
6729,-2700,-3700,-1200,-3700,1950,-9350
6730,9300,-2900,-1800,13200,-2150,15650
6731,-9400,13100,4700,-9500,2900,1800
6732,-5000,200,0,-2000,-950,-7750
6733,8300,9800,0,-2000,0,16100
6734,-4900,100,0,9100,1950,6250
6735,5300,-600,0,-1000,-950,2750
6736,-1200,-4400,-1200,9300,2900,5400
6737,14100,7400,0,-1000,0,20500
6738,-300,-3900,0,0,0,-4200
6739,4900,1300,0,12000,0,18200
6740,-5000,12000,0,-1000,0,6000
6741,5300,100,-2400,1400,0,4400
6742,-2900,-4400,-1800,-1000,0,-10100
6743,6900,-600,3500,-6400,0,3400
6744,-2000,-4500,0,1200,-1200,-6500
6745,10900,-2100,-2100,-3800,0,2900
6746,1300,6600,3800,4000,-12600,3100
6747,11100,100,0,200,-1200,10200
6748,-900,11200,0,-2000,11050,19350
6749,-3500,0,0,0,0,-3500
6750,9600,-1600,0,-4900,1000,4100
6751,-1900,11500,-1200,12200,-950,19650
6752,5900,300,-900,-2900,2900,5300
6753,-2700,-2100,700,-8500,1950,-10650
6754,5200,200,-8300,6400,-950,2550
6755,-5900,300,0,-4700,1700,-8600
6756,10700,-4500,12000,200,-1200,17200
6757,1300,-5300,0,-800,-1200,-6000
6758,10100,-3100,0,11200,-2150,16050
6759,-5100,-600,0,-1000,-950,-7650
6760,5800,10900,0,9100,1950,27750
6761,-500,-4400,0,-4900,1950,-7850
6762,12400,-4500,0,-800,-2150,4950
6763,-1900,9100,-2400,-1500,2900,6200
6764,-3100,-5000,-1800,-3900,1950,-11850
6765,11800,7400,4700,5400,0,29300
6766,-2000,-3000,-1200,200,0,-6000
6767,-3800,9200,-3000,-1600,-1200,-400
6768,-5900,200,4700,-5600,0,-6600
6769,6200,12100,-1200,10400,-1200,26300
6770,500,-5300,-900,-1000,-950,-7650
6771,1600,13200,1000,-6300,-450,9050
6772,2100,-7700,2800,7200,-950,3450
6773,9300,-2300,0,-1700,1700,7000
6774,2900,6700,0,10000,-950,18650
6775,8500,-1600,0,0,-950,5950
6776,-3600,10700,0,-3900,1000,4200
6777,14400,-9000,0,7100,2900,15400
6778,-4200,-700,0,-2700,750,-6850
6779,-2200,7800,0,0,-950,4650
6780,-4200,-700,0,8100,2900,6100
6781,-2700,9900,0,0,0,7200
6782,8500,-2200,0,12000,0,18300
6783,-5900,-600,0,-800,-1200,-8500
6784,10800,9800,-1200,400,-1200,18600
6785,-1900,-2200,-2400,600,-1200,-7100
6786,9200,9800,-4200,1400,-950,15250
6787,-1900,-2200,3800,-5600,-950,-6850
6788,5100,-1200,1000,-5700,1950,1150
6789,-3600,-1300,2800,-6700,1950,-6850
6790,-900,9700,0,0,-950,7850
6791,5900,-3000,-1200,8300,2900,12900
6792,600,-2300,0,-3700,750,-4650
6793,12000,12000,-3000,13400,-1200,33200
6794,-2600,100,4700,-6600,0,-4400
6795,10900,-2100,0,-2000,-950,5850
6796,9200,-2900,0,200,-1200,5300
6797,-3300,100,0,9300,750,6850
6798,-3500,10700,-1200,1200,-950,6250
6799,-5200,-500,-2100,-3700,1950,-9550
6800,-3400,100,3800,-5600,0,-5100
6801,6900,100,0,9100,1950,18050
6802,6900,300,0,-1000,-950,5250
6803,-4400,-2200,0,7300,-7300,-6600
6804,9300,-2200,0,-1000,0,6100
6805,-4600,-2800,0,-2000,12000,2600
6806,5900,300,0,200,-1200,5200
6807,1900,4400,0,200,-1200,5300
6808,6500,-1900,0,0,0,4600
6809,-6900,300,0,-3000,-950,-10550
6810,3500,11600,0,-3000,0,12100
6811,-4200,-800,0,-2900,1950,-5950
6812,-5300,-1100,0,8100,1950,3650
6813,6600,9200,0,-1000,0,14800
6814,-700,-5800,-1200,-800,0,-8500
6815,7700,-3100,0,-3000,0,1600
6816,-2900,-4400,-3000,-600,-1200,-12100
6817,8400,-2800,4700,5400,0,15700
6818,-400,6700,-2400,-400,-1200,2300
6819,10200,-3100,-1100,-2600,0,3400
6820,8000,7600,1600,-3600,0,13600
6821,-500,-4300,-3000,12200,-950,3450
6822,6800,8200,1900,-2800,-950,13150
6823,-5900,1100,-200,6500,2900,4400
6824,7500,-2200,4700,-300,-8250,1450
6825,-4800,7900,0,1200,-1200,3100
6826,3500,-600,0,-1000,0,1900
6827,-5200,9900,0,-1000,12000,15700
6828,9400,-3100,-1200,12200,0,17300
6829,-1300,-4500,-2100,-800,0,-8700
6830,7000,11400,-2100,1200,0,17500
6831,-3600,-3000,1700,-6400,0,-11300
6832,11300,-5800,4700,-7600,0,2600
6833,-2800,9000,-1200,200,0,5200
6834,8700,0,-900,-2000,0,5800
6835,-5000,11200,3800,6400,0,16400
6836,7600,-2100,0,-2000,0,3500
6837,-2900,-3600,-2400,13400,0,4500
6838,8500,11300,-1800,-1000,0,17000
6839,-4200,100,4700,-6600,0,-6000
6840,11500,-4500,0,11200,-1200,17000
6841,-4100,11300,0,-1000,0,6200
6842,9700,-4400,-1200,-800,0,3300
6843,8400,-3000,0,10200,-2150,13450
6844,400,7400,-1200,2600,-3350,5850
6845,7900,100,-2100,-4700,2900,4100
6846,300,-5300,1000,-6700,1000,-9700
6847,9600,12000,2800,-2600,-1200,20600
6848,-1800,100,0,-3900,1950,-3650
6849,9300,12000,0,-4700,750,17350
6850,-1000,-2200,-1200,11400,-2150,4850
6851,11000,-2300,-900,-1000,-950,5850
6852,-6000,-1400,-1400,4700,1000,-3100
6853,-4600,-1200,1900,-5700,2900,-6700
6854,11100,9700,1000,-6500,750,16050
6855,8300,-2100,-7400,19400,-950,17250
6856,-1900,-3000,0,-4900,2900,-6900
6857,5000,-2000,10800,200,0,14000
6858,-4100,12100,-2400,-600,0,5000
6859,10900,-3100,-1800,12000,0,18000
6860,-5200,-600,4700,-6600,0,-7700
6861,5100,13200,0,10000,0,28300
6862,-1800,-3000,-1200,200,0,-5800
6863,-3600,-1300,-1800,200,-1200,-7700
6864,12500,-4500,1900,-4800,0,5100
6865,-2000,-2900,2800,-2800,0,-4900
6866,13400,-5400,0,-1000,-950,6050
6867,-4400,11600,0,12000,-950,18250
6868,10600,-3700,0,-3900,2900,5900
6869,-3500,-3700,-3600,10700,1950,1850
6870,6000,13200,-900,0,0,18300
6871,-6700,0,1900,-2800,0,-7600
6872,-1000,9800,1900,-3800,0,6900
6873,12500,-5400,0,-1000,0,6100
6874,0,0,0,9200,-10200,-1000
6875,10200,100,0,-1000,0,9300
6876,-2600,12100,0,-1000,12000,20500
6877,10200,-2200,0,-1000,0,7000
6878,-4400,-600,0,-800,-1200,-7000
6879,-6300,-2000,0,200,-1200,-9300
6880,-3400,9700,0,-2000,0,4300
6881,11700,-4600,0,-1000,-950,5150
6882,-2700,-700,0,10200,-2150,4650
6883,8700,0,0,-2700,1700,7700
6884,-1800,100,0,-3900,1950,-3650
6885,7600,9000,0,-2000,0,14600
6886,-1000,-3000,0,-800,-2150,-6950
6887,13200,-3600,0,-1000,-950,7650
6888,-4300,200,0,-4900,2900,-6100
6889,-1000,9700,-1200,10300,1950,19750
6890,-900,-800,-900,-1000,0,-3600
6891,9200,-2300,1000,-2800,0,5100
6892,-5800,-600,2800,9200,0,5600
6893,-2900,10800,-1200,-1800,0,4900
6894,-300,-4500,0,-1000,0,-5800
6895,9300,200,0,12000,0,21500
6896,-1000,-3000,0,-1000,0,-5000
6897,10000,-2000,0,0,0,8000
6898,500,7400,0,-1000,0,6900
6899,-5400,-600,0,-1000,0,-7000
6900,8500,-2100,0,0,0,6400
6901,-6700,12300,0,-1000,0,4600
6902,-400,-5400,0,-1000,0,-6800
6903,-1800,-2300,-1200,1200,0,-4100
6904,11500,7400,-900,12000,0,30000
6905,-1000,-3800,1000,-3800,0,-7600
6906,8200,-1900,2800,-2800,0,6300
6907,2200,7400,0,200,-1200,8600
6908,9400,0,0,-800,-1200,7400
6909,-3300,-700,0,0,-950,-4950
6910,-3300,12100,0,-2000,0,6800
6911,-1800,-800,-1200,1200,-950,-3550
6912,-5800,12900,0,-6900,2900,3100
6913,11700,-2300,0,-500,-450,8450
6914,-2600,100,-1200,11200,0,7500
6915,7400,-2100,-10200,9400,-2150,2350
6916,-2600,-2200,-1800,0,-950,-7550
6917,11900,-2300,16700,-8500,2900,20700
6918,-2700,-700,0,-3900,1000,-6300
6919,-1400,-4300,0,-1800,-1200,-8700
6920,8300,9900,0,-1700,750,17250
6921,-1800,-3900,0,12000,-950,5350
6922,-2000,-3700,0,-5900,1950,-9650
6923,-2800,9100,0,-800,-1200,4300
6924,6500,-1900,-1200,7500,-8250,2650
6925,-1000,-2300,0,-1000,-950,-5250
6926,4800,8500,0,-2700,13700,24300
6927,-4300,-1400,0,-3000,0,-8700
6928,11600,6700,-2400,1400,-950,16350
6929,-1800,-3100,-2100,11200,0,4200
6930,-1100,-2200,-200,-5500,1950,-7050
6931,9200,9900,1000,-3800,-950,15350
6932,8600,100,4700,-10500,2900,5800
6933,1300,7400,-1200,400,-1200,6700
6934,-2600,-700,-900,-2000,0,-6200
6935,9200,-2100,1000,9400,-1200,16300
6936,-2700,-2200,2800,-4800,0,-6900
6937,-4400,9900,0,13200,-1200,17500
6938,-2800,-3600,0,0,-950,-7350
6939,5200,1000,0,12000,-950,17250
6940,-4400,10000,0,-2900,2900,5600
6941,9100,-3000,0,-4700,750,2150
6942,-2100,-4400,-10200,10200,0,-6500
6943,6900,0,0,-1000,-950,4950
6944,-400,6600,-1200,200,0,5200
6945,10800,-4600,12000,-3900,1950,16250
6946,-2500,-1500,0,0,-950,-4950
6947,8500,13000,0,-4700,1700,18500
6948,-1100,-2900,0,-1000,0,-5000
6949,9300,-1400,0,12000,0,19900
6950,-2900,10000,0,0,0,7100
6951,8800,-800,0,0,0,8000
6952,-5400,-2800,0,0,0,-8200
6953,-4300,12100,-1200,-800,0,5800
6954,-4300,-1300,0,0,0,-5600
6955,11800,-3100,-1800,0,0,6900
6956,-4500,200,4700,-6600,0,-6200
6957,8500,9000,0,-800,-1200,15500
6958,-6700,200,0,-1000,0,-7500
6959,13000,-5900,0,0,-950,6150
6960,-4500,-2900,0,10000,-950,1650
6961,6700,-2200,0,-2900,2900,4500
6962,5100,-9900,0,-5700,750,-9750
6963,8600,11300,-2400,1400,0,18900
6964,-1700,100,0,11200,-1200,8400
6965,8300,9800,-2300,-2400,0,13400
6966,-1000,-2200,1900,-4800,0,-6100
6967,9500,11200,1000,-3800,-950,16950
6968,-2100,-2200,1600,-6500,1950,-7250
6969,-300,-4600,-1200,11200,-950,4150
6970,-1100,9100,-11100,7300,2900,7100
6971,12400,-4400,1000,-4800,0,4200
6972,-4100,-800,14800,8600,-11400,7100
6973,-300,9900,-1200,200,0,8600
6974,-1100,-2300,0,-2000,12000,6600
6975,11700,-2100,0,200,-1200,8600
6976,-2400,11200,0,10000,0,18800
6977,-300,-2100,-1200,200,0,-3400
6978,-2500,12000,-1800,0,-950,6750
6979,-1900,-2300,4700,-6600,-950,-7050
6980,-2700,-500,-1200,-2700,1950,-5150
6981,8700,100,0,-4700,1700,5800
6982,-5400,-2600,0,-1000,0,-9000
6983,-7000,9900,-2400,400,0,900
6984,-4400,-1200,-2700,20200,-10200,1700
6985,2400,-300,5600,-4400,-1200,2100
6986,8500,-2200,0,200,10800,17300
6987,-2500,8900,0,-1000,-950,4450
6988,7500,-1300,0,-1000,0,5200
6989,2000,-7600,0,-3900,1950,-7550
6990,-2000,-2100,-1200,-800,-950,-7050
6991,7800,-600,-900,-3700,1700,4300
6992,-2700,9000,3800,7800,-2400,15500
6993,5500,-800,0,-1000,0,3700
6994,-2700,9000,0,0,-950,5350
6995,11800,-4600,0,12000,-950,18250
6996,1100,-4400,0,-3700,750,-6250
6997,9500,11200,0,-2700,750,18750
6998,10000,-2100,-1200,-800,-950,4950
6999,-3500,-3000,0,-2900,1950,-7450
7000,6100,12200,0,9100,1950,29350
7001,-2700,-2200,0,-2000,-950,-7850
7002,-2600,12200,0,-3700,1700,7600
7003,11000,-2300,-1200,8700,-9450,6750
7004,500,-3100,0,-2000,0,-4600
7005,7600,400,-1800,-1000,11050,16250
7006,-1800,-2200,4700,-6400,-1200,-6900
7007,9300,9900,0,-4900,1950,16250
7008,400,-4500,0,-4000,-950,-9050
7009,-2000,-3800,-2400,-3500,2900,-8800
7010,8700,900,-2100,22400,-10200,19700
7011,-2900,9300,1000,-5800,0,1600
7012,-400,-4600,1600,-2400,10800,5000
7013,-2800,-2900,-900,-1000,0,-7600
7014,7000,12100,1000,6200,-950,25350
7015,400,7600,2800,-1600,-1200,8000
7016,-4500,-2200,0,-3900,1950,-8650
7017,5000,-3700,-10200,22200,-950,12350
7018,-2100,-3600,0,-2900,2900,-5700
7019,-3200,7000,12000,-2000,0,13800
7020,8400,-2100,0,0,0,6300
7021,400,-6000,0,-1000,0,-6600
7022,7400,10800,0,12000,0,30200
7023,3200,-12900,0,0,0,-9700
7024,11700,-4500,0,-1000,0,6200
7025,-4300,9800,-1200,-800,0,3500
7026,-1100,-3000,0,-1000,0,-5100
7027,-800,11200,0,0,0,10400
7028,7700,100,0,-1000,0,6800
7029,-5100,12100,0,0,0,7000
7030,8300,-2800,0,0,0,5500
7031,-5400,-1100,0,0,0,-6500
7032,-3400,9800,0,0,0,6400
7033,7600,-3000,0,-1800,-1200,1600
7034,-7100,12200,-2400,2400,0,5100
7035,9900,-4400,-1800,0,0,3700
7036,-7800,-500,4700,-5600,-950,-10150
7037,5300,12200,0,0,-950,16550
7038,8100,7700,-10200,3300,2900,11800
7039,-1700,-2300,-1200,-500,750,-4950
7040,4800,-2700,10200,0,0,12300
7041,-4200,100,4700,-8600,0,-8000
7042,4100,9900,-1200,200,0,13000
7043,-800,-6700,0,11000,0,3500
7044,6000,-2900,0,-4000,0,-900
7045,-1200,-5200,-1200,1400,-1200,-7400
7046,9800,7500,0,0,0,17300
7047,11600,-5300,-1800,11000,-950,14550
7048,-3300,-800,4700,-6600,0,-6000
7049,6700,9900,0,-3900,1950,14650
7050,4500,-6900,0,-2000,-950,-5350
7051,10900,9000,-1200,-2700,2900,18900
7052,-4900,100,-1200,11400,-1200,4200
7053,8300,-2900,0,-1000,0,4400
7054,-1200,6700,-1800,1400,-2400,2700
7055,-5100,200,4700,5400,0,5200
7056,9400,-700,-1200,1200,-950,7750
7057,-4100,12900,0,-1000,-950,6850
7058,12600,9700,0,-2700,1700,21300
7059,7500,200,0,8100,1950,17750
7060,-3400,-6700,-2100,1200,-950,-11950
7061,8600,9700,1000,-2800,0,16500
7062,-2000,-5300,2800,-5700,1950,-8250
7063,-2000,-3000,0,-2000,-950,-7950
7064,10100,9800,0,6300,-7300,18900
7065,-2600,-3000,0,1200,-1200,-5600
7066,9500,12100,0,-2800,-1200,17600
7067,-3700,-2100,0,-1000,12000,5200
7068,-3700,10000,0,11000,0,17300
7069,11800,-3100,0,-1000,-950,6750
7070,7800,200,0,0,0,8000
7071,2100,-4500,0,-3700,750,-5350
7072,-3200,7800,0,-4900,1950,1650
7073,-1900,-3800,0,400,-2400,-7700
7074,5300,1100,0,-2000,0,4400
7075,-1000,6600,-1200,13200,-950,16650
7076,-900,0,0,9200,-10200,-1900
7077,-5200,12200,-1200,-2700,1950,5050
7078,6700,400,-1800,-2900,1950,4350
7079,-3500,-2300,4700,-6600,12000,4300
7080,10200,-2200,0,1200,-1200,8000
7081,-5100,-700,-10200,9200,0,-6800
7082,12400,-5300,0,0,-950,6150
7083,-6100,13100,0,0,0,7000
7084,8600,-3000,12000,-2900,1950,16650
7085,-300,-2300,0,-2900,1950,-3550
7086,10400,0,0,200,-1200,9400
7087,600,9700,0,-1000,0,9300
7088,11100,-800,0,0,0,10300
7089,-5100,-700,0,0,0,-5800
7090,-1000,10600,0,12200,-1200,20600
7091,8500,300,-2400,-600,0,5800
7092,-500,-4500,-1200,-1800,0,-8000
7093,-2700,-2100,-1800,200,-2150,-8550
7094,7000,-700,4700,-5600,-950,4450
7095,-4300,100,0,-5900,2900,-7200
7096,100,4600,0,-2700,750,2750
7097,-6000,300,-10200,7200,0,-8700
7098,6100,-800,-1200,1400,-2150,3350
7099,-6200,-1100,10200,-2000,0,900
7100,-5300,9900,4700,-10500,1950,750
7101,10100,-3000,-11400,9400,-950,4150
7102,-2700,-2300,0,-3700,1700,-7000
7103,4900,10000,12000,0,0,26900
7104,-1300,-4400,0,11000,-950,4350
7105,10200,-3900,0,-800,-1200,4300
7106,-6000,300,0,9100,1950,5350
7107,10600,7700,0,-1000,0,17300
7108,1900,-6700,0,-4900,1950,-7750
7109,5300,10400,-1200,200,0,14700
7110,-2100,-3700,-900,-2800,-1200,-10700
7111,6600,-1900,-2600,-1200,0,900
7112,6800,9100,100,-2800,-950,12250
7113,-5000,100,5600,5400,-950,5150
7114,12500,6600,0,-2900,2900,19100
7115,-1900,-3000,0,-3900,1950,-6850
7116,7400,10000,-2100,11200,0,26500
7117,1900,-6900,1000,-2800,0,-6800
7118,15000,7400,2800,8200,0,33400
7119,0,-800,0,-1800,-1200,-3800
7120,9400,-1600,0,-1000,0,6800
7121,-1900,9800,0,200,-1200,6900
7122,-7200,-1200,0,11000,0,2600
7123,-1800,-2200,-1200,-600,-2150,-7950
7124,6600,10000,0,0,0,16600
7125,-3600,-2800,0,-2900,1950,-7350
7126,9900,-4400,0,200,-1200,4500
7127,-4400,9000,0,-5900,1950,650
7128,-5900,200,-1200,-1600,-1200,-9700
7129,6200,100,-3000,12200,-950,14550
7130,-500,7600,4700,-7400,-2150,2250
7131,11000,-3000,-1200,-4500,1700,4000
7132,8400,100,-2100,-4700,1950,3650
7133,-2700,8900,-1400,-2400,-950,1450
7134,6700,-2800,1000,9200,-950,13150
7135,-3600,-1200,4700,1500,2900,4300
7136,8400,9900,0,-2700,750,16350
7137,500,-5300,0,-1000,0,-5800
7138,-5100,200,0,12000,0,7100
7139,7600,300,0,-1000,-950,5950
7140,-400,7500,0,12000,-950,18150
7141,11900,-2300,0,-2900,2900,9600
7142,-1700,-800,0,12000,-950,8550
7143,10200,100,0,-2900,2900,10300
7144,-5200,12100,0,-2000,0,4900
7145,3500,-300,0,-1000,0,2200
7146,-8500,1100,0,1200,-1200,-7400
7147,-5300,-2100,0,0,0,-7400
7148,11700,-4600,0,-2000,0,5100
7149,-5300,-2900,0,-800,-1200,-10200
7150,5200,200,0,-1000,0,4400
7151,-2400,11200,0,-3000,-950,4850
7152,7000,-700,-1200,-600,-2150,2350
7153,-6000,13100,-2400,7700,1700,14100
7154,13900,-6800,-2700,-3900,1950,2450
7155,-7100,-1900,3800,-8600,0,-13800
7156,500,-5300,4700,-5000,-4550,-9650
7157,6800,200,0,-5900,1950,3050
7158,9300,9100,0,11000,0,29400
7159,-5500,-1900,0,-5900,1000,-12300
7160,11100,-2300,0,12000,-950,19850
7161,-3600,9800,0,-6900,2900,2200
7162,9300,-3000,-1200,-2500,750,3350
7163,-1800,200,0,10200,-1200,7400
7164,8300,-2000,0,-1000,-950,4350
7165,-3500,9800,0,0,0,6300
7166,9300,-3900,-1200,6500,750,11450
7167,-300,-2100,-1800,200,-1200,-5200
7168,7500,10000,3500,4700,1950,27650
7169,-3600,-2000,0,-800,-2150,-8550
7170,10100,-2300,0,200,-2150,5850
7171,-300,9100,-1200,9300,2900,19800
7172,10200,-2200,0,-3900,1000,5100
7173,11700,9800,-1400,6600,-950,25750
7174,-5000,-700,1900,-7500,1700,-9600
7175,9500,100,-3000,9500,750,16850
7176,-1800,12100,4700,4800,-12350,7450
7177,-1600,0,0,-2000,-950,-4550
7178,11700,-2200,-1200,-3700,14900,19500
7179,-1900,-2200,-3000,-3700,1000,-9800
7180,-900,100,4700,4400,-950,7350
7181,-200,-3100,0,-4900,2900,-5300
7182,10900,-1300,-1200,8300,1950,18650
7183,-1600,-1600,100,-3600,-1200,-7900
7184,-3500,1000,2800,19400,-10200,9500
7185,-5900,12200,0,-1000,0,5300
7186,-5900,300,0,0,12000,6400
7187,10100,-2300,0,0,0,7800
7188,400,-4600,-1200,11200,0,5800
7189,10100,-3100,0,-1800,-1200,4000
7190,-5300,400,0,-800,-1200,-6900
7191,11000,-4600,0,-1000,-950,4450
7192,-1200,8900,0,-1000,0,6700
7193,-6900,-400,0,-3900,1950,-9250
7194,400,-3600,0,-1000,-950,-5150
7195,7800,12100,0,-5900,2900,16900
7196,2100,-7700,-1200,-800,0,-7600
7197,10700,-2100,-900,-2000,0,5700
7198,-3600,8200,-200,16800,-11400,9800
7199,9100,-3600,1600,-200,-2400,4500
7200,-2000,-2900,-1800,-2000,-950,-9650
7201,-2800,9000,4700,-6600,12000,16300
7202,-5100,100,-3600,-2100,-200,-10900
7203,-3500,9900,0,10000,-950,15450
7204,5200,100,-3000,-1700,2900,3500
7205,-3000,-5300,2900,500,1950,-2950
7206,6000,12300,3500,-6200,-2150,13450
7207,-6100,-2100,-2100,9300,2900,1900
7208,7800,0,-200,-4600,0,3000
7209,-400,7400,2800,8200,-950,17050
7210,9300,-3900,0,-4900,1950,2450
7211,-3600,-1400,0,9000,0,4000
7212,7700,12000,0,-2900,1950,18750
7213,200,-7700,0,9200,-1200,500
7214,6000,300,0,9400,-11400,4300
7215,-1200,6700,0,-2800,-1200,1500
7216,10800,-2000,-1200,1200,-950,7850
7217,1100,4300,-1800,-2000,12000,13600
7218,9400,0,4700,-11500,1950,4550
7219,-3700,-2800,0,-500,-450,-7450
7220,8500,9900,-1200,-2800,0,14400
7221,-3300,-700,0,-1000,-950,-5950
7222,6700,13100,0,10000,-950,28850
7223,-3000,-4300,0,-3900,2900,-8300
7224,10300,-7500,0,8100,1950,12850
7225,-2800,-2100,0,-800,-1200,-6900
7226,9300,9100,0,11400,-2400,27400
7227,-3400,-2200,0,-800,-2150,-8550
7228,-600,-8300,-1200,11400,-1200,100
7229,-3800,7800,-900,-2900,1000,1200
7230,7500,-2200,1000,-2800,-950,2550
7231,-900,8900,2800,-7700,2900,6000
7232,10200,100,0,-1700,-200,8400
7233,-4200,12200,0,-1000,0,7000
7234,5100,400,0,8100,1950,15550
7235,-2500,0,0,0,-950,-3450
7236,11100,9700,0,8100,2900,31800
7237,-3600,100,0,-5900,1950,-7450
7238,6200,-700,-1200,1400,-1200,4500
7239,3800,-4600,0,-1000,0,-1800
7240,8400,11500,0,10000,-950,28950
7241,-4500,-1100,0,1200,-1200,-5600
7242,10200,-2200,0,-3900,1950,6050
7243,-4400,-2900,-1200,400,-2150,-10250
7244,-5300,-2200,-1800,-5900,2900,-12300
7245,9200,9900,4700,-4400,-1200,18200
7246,-2500,-700,0,12000,-950,7850
7247,-5000,0,-1200,-1800,-950,-8950
7248,8200,10100,0,-3900,2900,17300
7249,9900,-4400,0,8300,750,14550
7250,-1800,-3100,0,-4000,0,-8900
7251,8500,100,-2400,1400,-950,6650
7252,-7800,400,-1800,11000,0,1800
7253,7000,12100,4700,-8500,1950,17250
7254,-1700,-2300,0,0,-950,-4950
7255,15600,-6900,0,-5900,2900,5700
7256,-900,-800,0,9000,0,7300
7257,6700,-500,-10200,10200,0,6200
7258,-3300,12100,0,-1600,-2400,4800
7259,6200,100,10800,-800,0,16300
7260,3600,5200,0,-2000,0,6800
7261,-6200,200,-1800,-3000,-950,-11750
7262,9900,-5300,4700,-8400,-1200,-300
7263,-400,-4600,0,-2700,750,-6950
7264,-2700,9000,0,10000,-950,15350
7265,-500,-4300,0,-4900,1950,-7750
7266,8300,-2900,-1200,12200,0,16400
7267,-3100,7600,0,-2000,-950,1550
7268,13300,-6200,0,-3900,1950,5150
7269,-4100,12900,0,6100,2900,17800
7270,-5900,-700,-10200,9200,0,-7600
7271,300,-6800,0,-1000,0,-7500
7272,-2600,12100,12000,-3000,0,18500
7273,9200,-3100,0,1200,-1200,6100
7274,-100,9700,0,0,0,9600
7275,10200,100,-1200,11200,0,20300
7276,-4800,7900,-1800,-3000,0,-1700
7277,8500,-3800,2300,-4200,0,2800
7278,-2800,-1300,-1800,-2000,0,-7900
7279,-900,8900,2300,-5200,0,5100
7280,9000,-2100,-1800,-1000,0,4100
7281,-4400,-2200,4700,4400,0,2500
7282,13400,7400,-1200,400,-1200,18800
7283,-3000,-2900,-1200,-800,0,-7900
7284,-5000,-700,-1800,12000,-950,3550
7285,6400,7200,4700,-7600,-950,9750
7286,-1300,-3600,0,8300,1700,5100
7287,-1800,8900,0,-3900,1950,5150
7288,8300,-2800,0,0,0,5500
7289,-6600,200,0,11000,0,4600
7290,11800,8900,0,0,0,20700
7291,-3600,1200,0,0,0,-2400
7292,4000,9200,0,11000,0,24200
7293,-3600,-1200,-1200,1200,0,-4800
7294,8500,-3000,0,0,0,5500
7295,-1800,-2300,0,200,-1200,-5100
7296,11300,-6700,0,0,0,4600
7297,-2200,6800,0,0,0,4600
7298,4300,200,0,0,-950,3550
7299,-6100,9200,0,0,-950,2150
7300,12100,-6800,0,-2900,2900,5300
7301,-6100,-3000,0,-3900,1950,-11050
7302,11500,7600,0,0,0,19100
7303,-1300,-5200,0,0,0,-6500
7304,7600,9900,0,-1000,0,16500
7305,-4900,-800,0,-1000,0,-6700
7306,6000,100,0,-800,-1200,4100
7307,-3500,9800,0,0,0,6300
7308,-100,-2300,0,-1800,-1200,-5400
7309,9800,9100,0,-1000,0,17900
7310,8500,300,0,12200,-1200,19800
7311,-6700,100,0,-1000,-950,-8550
7312,6000,9900,-1200,1200,-950,14950
7313,-3000,-4400,-900,-3900,2900,-9300
7314,-1900,-3000,1000,-6700,1950,-8650
7315,9300,-3100,1600,-2600,0,5200
7316,8600,12100,0,-2000,0,18700
7317,-4300,0,0,-1000,0,-5300
7318,1300,7500,0,11000,0,19800
7319,8500,-600,0,-1000,0,6900
7320,-2500,100,0,13200,-1200,9600
7321,11600,7500,0,0,0,19100
7322,-4400,200,0,0,-950,-5150
7323,11600,-4500,0,0,0,7100
7324,-2700,-3100,0,-2900,1950,-6750
7325,11600,-4400,0,0,-950,6250
7326,11800,8900,0,-3700,1700,18700
7327,-1800,100,0,400,-2400,-3700
7328,-5100,200,0,0,0,-4900
7329,11900,9700,0,12200,-2150,31650
7330,-3600,-500,0,0,0,-4100
7331,-4300,-600,0,-2900,1000,-6800
7332,7200,-3500,0,0,-950,2750
7333,-8600,12500,0,-2900,2900,3900
7334,-3600,-2900,-1200,-2700,1950,-8450
7335,-800,-5700,0,0,-950,-7450
7336,7800,-3100,-1800,-3900,2900,1900
7337,-2100,-6100,4700,-9600,0,-13100
7338,-6200,10700,-1200,13400,-1200,15500
7339,9400,-3000,0,-1000,0,5400
7340,-700,-6800,-10200,9200,0,-8500
7341,6600,9100,0,-1000,0,14700
7342,-4300,0,10800,-800,0,5700
7343,7700,-3000,-900,-1800,-1200,800
7344,-6200,9800,3800,-6600,0,800
7345,8400,-2000,0,-2000,0,4400
7346,10800,6700,-10200,8200,-950,14550
7347,-5300,-2100,0,-1000,-950,-9350
7348,7100,11300,12000,-4900,2900,28400
7349,-5400,-2100,0,-2900,1950,-8450
7350,10000,7500,0,10200,-1200,26500
7351,-6100,-2000,0,-2000,0,-10100
7352,11200,-800,-1200,-2800,0,6400
7353,-4400,12000,-2100,-600,-1200,3700
7354,7000,100,1000,9200,0,17300
7355,1000,5300,2800,-4800,-950,3350
7356,8400,-2100,0,-2000,0,4300
7357,-2700,-3100,0,-5700,750,-10750
7358,8500,-700,0,200,-2150,5850
7359,-6700,12000,0,6300,1700,13300
7360,10000,-2100,0,11000,-950,17950
7361,-200,9800,0,-2000,-950,6650
7362,8400,-3700,0,-4900,2900,2700
7363,6000,2000,0,8100,1950,18050
7364,-4900,-800,-1200,-1800,0,-8700
7365,12000,0,0,-2000,0,10000
7366,-2700,-600,0,-800,-1200,-5300
7367,6800,13100,0,11000,0,30900
7368,-3500,-2300,0,-2000,-950,-8750
7369,9200,-2100,0,-1000,0,6100
7370,11800,-2300,0,8100,1950,19550
7371,-4600,-3000,-1200,-800,-950,-10550
7372,7600,-2000,0,-3900,2900,4600
7373,-1300,7400,-1800,-1000,0,3300
7374,9100,-2700,2300,5800,0,14500
7375,-7700,400,-1200,-1800,0,-10300
7376,-4200,-700,-1800,-1000,0,-7700
7377,6700,10700,2600,-4400,0,15600
7378,4800,-2600,1000,6200,0,9400
7379,-3600,-2100,2800,-2800,0,-5700
7380,6700,-2100,0,-1000,0,3600
7381,-1200,6800,0,20200,-10200,15600
7382,8700,0,0,200,-1200,7700
7383,3700,-6900,0,0,0,-3200
7384,9300,8900,0,0,12000,30200
7385,-2700,-2900,0,0,0,-5600
7386,-5400,10100,0,-1000,0,3700
7387,10300,-2300,-1200,-800,0,6000
7388,8500,200,0,2400,-2400,8700
7389,700,8900,0,0,0,9600
7390,-3500,100,0,0,-950,-4350
7391,13300,6600,0,-1000,-950,17950
7392,5100,1000,0,-2900,2900,6100
7393,-1100,-2900,0,-2900,1950,-4950
7394,11500,-4300,-1200,-1800,0,4200
7395,-1300,6900,0,-2000,0,3600
7396,-4900,-4100,-1800,9000,0,-1800
7397,-500,-4500,4700,-4200,-2400,-6900
7398,11000,9000,0,-2000,0,18000
7399,-4500,-3500,0,8200,-11150,-10950
7400,-4100,12100,0,-1000,11050,18050
7401,-1300,-3700,0,-4900,2900,-7000
7402,-2700,-2900,0,-4700,750,-9550
7403,11600,6600,0,-2000,0,16200
7404,-3100,-5100,0,400,-2400,-10200
7405,7300,7700,0,11000,-950,25050
7406,-3600,-2100,0,12200,-2150,4350
7407,11500,6800,0,-2500,-450,15350
7408,-6600,100,0,-3900,1950,-8450
7409,200,5300,0,0,-950,4550
7410,13900,-7600,0,9100,1950,17350
7411,-1000,9800,0,-2900,1950,7850
7412,11600,-5300,0,0,-950,5350
7413,-1000,-3100,0,-4900,2900,-6100
7414,-900,12000,0,-2700,750,9150
7415,10300,-800,-1200,200,0,8500
7416,-2500,12100,0,12000,-950,20650
7417,-1800,100,0,-1000,-950,-3650
7418,-4200,12100,-1200,-2500,1700,5900
7419,8600,100,-1800,-3900,1950,4950
7420,-2900,9900,4700,-6600,0,5100
7421,500,-4500,0,-800,-1200,-6000
7422,9500,100,0,10000,0,19600
7423,-2500,-700,-1200,1400,-1200,-4200
7424,-4600,-2300,0,12000,-950,4150
7425,8700,12100,0,0,-950,19850
7426,-1900,-2200,-1200,-4700,2900,-7100
7427,-3300,100,0,-1700,750,-4150
7428,9300,200,-3000,-800,0,5700
7429,-2400,0,3500,-5200,-2150,-6250
7430,11100,100,0,12000,-950,22250
7431,-1900,-2300,-1800,-4900,2900,-8000
7432,-1800,200,2300,-9900,750,-8450
7433,8200,-5900,-1200,1200,0,2300
7434,-3500,1000,-1800,10000,0,5700
7435,-1800,9700,4700,-6400,-2150,4050
7436,11100,-3100,0,11200,-2150,17050
7437,-1200,-2200,-1200,-6700,2900,-8400
7438,700,9700,-2100,-1500,-200,6600
7439,11100,-700,1000,4400,-10200,5600
7440,-4400,300,2800,10600,-3350,5950
7441,-3600,9700,0,-5900,13950,14150
7442,-3500,-2100,-1200,-3700,1950,-8550
7443,-2200,-4500,-1800,11000,-950,1550
7444,-2700,-3000,2300,-7900,1700,-9600
7445,4800,-1900,-900,-3700,750,-950
7446,-6800,100,1000,16400,-11150,-450
7447,11000,8100,2800,-2800,0,19100
7448,-4800,-3400,0,-7900,1950,-14150
7449,7000,12200,-2400,1600,9850,28250
7450,-6000,-1600,0,9500,500,2400
7451,6200,1000,-1800,-1000,-950,3450
7452,-6900,12400,3500,6600,0,15600
7453,11000,-3000,0,-4900,1000,4100
7454,-3800,-3500,0,-800,-2150,-10250
7455,9300,-2300,-1200,-3700,2900,5000
7456,-5800,-700,-900,8100,1950,2650
7457,9900,-5200,1000,-2600,-2150,950
7458,-1100,10700,2800,-6700,2900,8600
7459,7700,-1500,0,11000,-950,16250
7460,-4400,-1300,0,200,-1200,-6700
7461,5200,12200,0,-2900,1950,16450
7462,-3600,-2000,0,12000,-950,5450
7463,5100,-600,0,-2900,2900,4500
7464,-5400,-2000,0,12000,0,4600
7465,12400,7500,0,-1000,0,18900
7466,-2100,-4400,0,200,-1200,-7500
7467,11600,-6200,0,-2000,0,3400
7468,-7800,300,-1200,400,-2150,-10450
7469,11100,9700,0,-1000,0,19800
7470,8500,-2300,0,-4900,1950,3250
7471,1300,-5300,0,200,-2150,-5950
7472,10900,9800,0,-5900,2900,17700
7473,-1200,-2000,0,0,-950,-4150
7474,-7600,11500,0,-2000,0,1900
7475,8400,-2200,-2400,8500,1950,14250
7476,-7200,-2000,-2100,12200,-950,-50
7477,7600,7600,-1400,-7300,2900,9400
7478,-6900,2000,2900,-4400,-1200,-7600
7479,6900,300,1000,-3800,0,4400
7480,8500,9800,4700,4400,0,27400
7481,-8500,200,0,0,0,-8300
7482,12400,-4400,0,21200,-10200,19000
7483,2000,-7700,0,-1000,0,-6700
7484,8700,0,0,-1000,12000,19700
7485,-5400,-3800,0,0,0,-9200
7486,6900,13000,0,-2000,0,17900
7487,-6200,-2100,-1200,200,0,-9300
7488,-2700,-2100,0,0,0,-4800
7489,9800,6000,0,-1000,0,14800
7490,9500,-6400,0,11000,0,14100
7491,-1100,7400,0,-2000,0,4300
7492,8600,-3100,-1200,200,0,4500
7493,-7900,12500,-900,200,-1200,2700
7494,6800,-3100,1000,-4800,0,-100
7495,-2000,-2100,2800,-4600,-1200,-7100
7496,11200,5300,0,0,-950,15550
7497,-2600,9000,0,6200,-11150,1450
7498,7100,-800,-1200,-3700,2900,4300
7499,-6100,200,0,-3900,13950,4150
7500,9200,9900,0,-3000,0,16100
7501,500,-4500,-1200,-800,0,-6000
7502,13900,-6900,-3000,12600,-2400,14200
7503,1400,6600,4700,-8600,0,4100
7504,12000,-800,0,200,-2150,9250
7505,-6200,300,0,-2000,-950,-8850
7506,-1900,9900,0,8100,1950,18050
7507,9300,9000,0,-2900,1950,17350
7508,-2800,-2100,0,11000,0,6100
7509,11000,-2200,-11400,7500,1950,6850
7510,6900,10600,0,0,-950,16550
7511,-2100,-3700,10200,-2700,1700,3400
7512,-4200,12100,4700,-5600,0,7000
7513,12300,-4400,0,-1000,0,6900
7514,-2800,-2800,0,0,0,-5600
7515,6000,100,0,11200,-1200,16100
7516,7700,9800,0,-800,-1200,15500
7517,-2700,-3000,-1200,200,-950,-7650
7518,10000,-2100,0,0,0,7900
7519,2200,-5400,0,-2900,1950,-4150
7520,8500,12200,0,-800,-2150,17750
7521,-1600,0,0,-6900,2900,-5600
7522,9300,300,0,200,-1200,8600
7523,-2800,9900,0,10200,-2150,15150
7524,11600,-4500,-1200,200,-950,5150
7525,-1400,-5200,0,-4900,1950,-9550
7526,-3900,-4300,-1100,-6500,1950,-13850
7527,-1000,-3000,1600,9400,-950,6050
7528,-5000,12100,-900,-3900,2900,5200
7529,-1300,-6700,3800,-8300,750,-11750
7530,800,2200,0,9200,-1200,11000
7531,-3700,10000,0,200,-1200,5300
7532,5400,-1600,0,-1000,-950,1850
7533,300,6100,0,9000,0,15400
7534,11500,-4400,-2400,-2500,1950,4150
7535,-7500,-600,-1800,-800,-2150,-12850
7536,9800,7500,4700,500,2900,25400
7537,-4300,-3000,0,-800,-1200,-9300
7538,8000,7800,0,11200,-2150,24850
7539,-6000,-500,0,-1000,-950,-8450
7540,12300,-6700,0,-6900,1950,650
7541,-7600,11400,-1200,10500,750,13850
7542,7600,-3800,-1200,-1800,-950,-150
7543,-2200,-2800,-900,-3900,2900,-6900
7544,9300,8900,-200,5500,1950,25450
7545,-6900,200,1600,-5600,0,-10700
7546,7100,12000,-2400,-600,0,16100
7547,-500,-4400,-1800,12200,-1200,4300
7548,9300,-3100,2900,-8600,0,500
7549,-2500,12000,4700,4600,-2150,16650
7550,10800,-2100,-1200,400,-1200,6700
7551,-6100,10800,-1200,-2500,750,1750
7552,6600,-1400,-3000,10200,-1900,10500
7553,-5800,7900,4700,-7100,500,200
7554,6600,-2800,0,7300,750,11850
7555,-2200,-4400,-1200,200,-1900,-9500
7556,6100,200,-900,8100,2900,16400
7557,-4300,-3000,1000,-7700,1000,-13000
7558,10100,9000,2800,-3800,0,18100
7559,-8000,-1000,0,9100,1950,2050
7560,13100,5300,0,-2000,-950,15450
7561,11700,-5400,0,9100,2900,18300
7562,-6700,-600,0,-2900,1950,-8250
7563,14100,7400,0,10000,0,31500
7564,-4500,-2800,0,-3000,0,-10300
7565,6800,-3000,0,12200,-1200,14800
7566,-2200,7800,0,200,-1200,4600
7567,11700,-4600,0,-1000,0,6100
7568,400,-5300,0,-1000,-950,-6850
7569,5300,12100,-1200,9300,1950,27450
7570,-2700,-3000,0,-2000,-950,-8650
7571,9300,9700,0,-3900,2900,18000
7572,-5000,200,0,-1000,0,-5800
7573,9900,9100,0,-1000,0,18000
7574,-4600,-1900,0,-2000,0,-8500
7575,7000,0,0,0,0,7000
7576,-900,9700,-2400,11400,0,17800
7577,8300,-2900,-900,-2000,0,2500
7578,-5500,10100,1000,-2600,-1200,1800
7579,9400,-2300,2800,-3600,-1200,5100
7580,8400,-2200,0,9400,-11400,4200
7581,-900,9700,-1200,200,12000,19800
7582,11100,-800,-3000,1400,-2150,6550
7583,-900,0,4700,-9500,1950,-3750
7584,11100,11300,0,0,-1900,20500
7585,-5000,-700,0,5300,-7300,-7700
7586,4200,1200,0,-2900,1950,4450
7587,-3200,-3500,-10200,8200,0,-8700
7588,2900,-6900,0,-4900,13950,5050
7589,9800,-5400,12000,0,0,16400
7590,-4300,-2900,0,-2000,0,-9200
7591,4300,10800,0,-1000,0,14100
7592,-5600,-3300,0,-1000,0,-9900
7593,7600,9800,-1200,11200,0,27400
7594,600,-6200,-900,200,-1200,-7500
7595,-7200,11000,1000,-4800,0,0
7596,9800,-5100,2800,-3600,-1200,2700
7597,-6600,12100,-2400,1400,0,4500
7598,7900,0,-900,10000,-950,16050
7599,-1400,-4400,-200,-1600,0,-7600
7600,8600,12200,2800,-5700,1950,19850
7601,-4400,-3100,0,-2000,-950,-10450
7602,11500,-4300,0,6300,-7300,6200
7603,-3100,6800,0,200,-1200,2700
7604,13000,-6700,-10200,7200,12000,15300
7605,-5800,-800,0,1600,-3600,-8600
7606,9800,6900,12000,0,0,28700
7607,-2600,12100,0,0,-950,8550
7608,5300,100,0,200,-1200,4400
7609,-400,-4500,0,-2900,1950,-5850
7610,10000,9100,-1200,600,-4300,14200
7611,-1300,-4300,0,-4900,2900,-7600
7612,9800,-4200,-1800,-2700,750,1850
7613,-4400,9200,4700,-4400,-3100,2000
7614,7800,-1500,0,9100,2900,18300
7615,-2200,8500,0,-3900,1000,3400
7616,11500,-4500,0,-2000,-950,4050
7617,6900,11400,-1200,9500,1700,28300
7618,-5800,200,0,-2900,1950,-6550
7619,-3100,-4300,-1200,-800,-1900,-11300
7620,6900,11300,-3300,10500,2900,28300
7621,-2600,-2200,100,-6700,1950,-9450
7622,6600,9900,3800,2600,-10200,12700
7623,-2800,-5300,2800,-6700,1950,-10050
7624,7700,200,0,-1000,0,6900
7625,-3600,-2200,0,-1000,12000,5200
7626,6000,12100,0,10200,-1200,27100
7627,-2100,-5300,0,-1000,0,-8400
7628,6700,-2100,0,12000,0,16600
7629,-2800,9900,-1200,-800,0,5100
7630,7900,-4900,0,-1000,0,2000
7631,-2700,-3800,0,0,0,-6500
7632,10700,8400,0,-3000,0,16100
7633,-6700,100,0,0,0,-6600
7634,10900,6700,0,11000,0,28600
7635,-4500,-2900,0,-1000,0,-8400
7636,10100,9900,0,0,0,20000
7637,-3500,-3100,0,-1000,0,-7600
7638,8500,13000,0,0,0,21500
7639,-4200,-800,-1200,-800,0,-7000
7640,11800,-1400,0,-2000,0,8400
7641,-2100,-2900,1000,-2800,0,-6800
7642,6800,300,1900,-5800,0,3200
7643,-2900,7500,-1200,200,0,3600
7644,7600,-2200,0,11000,0,16400
7645,-3500,-3000,0,-1000,0,-7500
7646,8400,-3000,0,-2000,0,3400
7647,-1300,8300,-1200,200,0,6000
7648,8500,-600,-900,11200,-1200,17000
7649,-2700,-2200,1000,-2800,0,-6700
7650,9100,10100,2800,-3800,0,18200
7651,-5000,-700,0,-2000,-950,-8650
7652,13400,-4600,0,-4900,1950,5850
7653,-3500,12100,0,1200,-2150,7650
7654,6900,-700,0,7300,1700,15200
7655,500,-4500,-1200,1600,-2400,-6000
7656,10000,9900,0,0,-950,18950
7657,-1100,-2900,0,12000,0,8000
7658,10200,-2200,0,-2000,-950,5050
7659,-3200,7800,0,-3900,1950,2650
7660,-3600,-2900,0,-1700,750,-7450
7661,11000,-2200,0,-2000,-950,5850
7662,-5000,-600,0,-3700,1700,-7600
7663,-1300,7500,0,-3900,1950,4250
7664,-1100,-2200,0,9200,-1200,4700
7665,7200,7700,-2400,-3600,-950,7950
7666,8800,-800,-900,1400,-3350,5150
7667,-1700,0,1000,-6700,2900,-4500
7668,-2700,12000,2800,5300,1000,18400
7669,7900,0,0,-1000,-950,5950
7670,-2000,-2000,0,-4700,1700,-7000
7671,11000,-3000,0,8100,1950,18050
7672,-2800,-2200,0,-1000,-950,-6950
7673,-3300,0,0,-2000,0,-5300
7674,8500,10600,0,9100,1950,30150
7675,-7700,1900,0,0,-950,-6750
7676,-5900,300,0,7100,2900,4400
7677,8100,-4400,0,-1000,0,2700
7678,-4200,-700,0,-2000,0,-6900
7679,12400,-4500,0,11000,0,18900
7680,-4200,11300,0,0,0,7100
7681,6700,-1900,0,-4000,0,800
7682,-2900,-4400,0,1200,-1200,-7300
7683,10900,9000,0,-2000,0,17900
7684,400,-4500,0,11000,0,6900
7685,5300,100,0,0,0,5400
7686,-1700,11300,0,-1000,0,8600
7687,7400,-2000,0,-1800,-1200,2400
7688,11600,7400,0,0,0,19000
7689,-8600,-600,-2400,-1600,0,-13200
7690,-1300,-4300,-900,-1000,-950,-8450
7691,8500,-3000,1000,9200,0,15700
7692,14800,5200,2800,-6700,1950,18050
7693,1300,-4600,-1200,-1700,1950,-4250
7694,-6100,11600,-2700,8400,-11400,-200
7695,7900,0,5600,-7400,-1200,4900
7696,-5900,200,-1200,200,0,-6700
7697,-6800,11400,0,-3000,11050,12650
7698,9800,-3600,0,-2000,0,4200
7699,-2500,100,-12600,19700,1950,6650
7700,10700,-6000,0,-1000,-950,2750
7701,-3300,100,12100,-5700,2900,6100
7702,-3600,12100,1600,-3600,0,6500
7703,13400,-4600,-1800,-2000,0,5000
7704,8600,12100,4700,-6600,0,18800
7705,-7100,400,0,-2800,-1200,-10700
7706,10200,-2300,-1200,23400,-10200,19900
7707,-1900,-2200,0,0,0,-4100
7708,-5000,-1500,0,-1000,12000,4500
7709,900,-5900,0,-1000,0,-6000
7710,9300,9800,-1200,-600,-1200,16100
7711,10200,-3800,-900,-2000,0,3500
7712,-1900,-1400,1000,-4600,-2150,-9050
7713,-2700,9000,2800,-2400,-2400,4300
7714,8500,200,0,9300,750,18750
7715,2100,7500,0,-3000,-1900,4700
7716,5200,-600,0,-4900,2900,2600
7717,-1900,-2200,-1200,10500,-200,5000
7718,-5600,-4500,0,-2000,0,-12100
7719,-1800,9000,0,-2900,1950,6250
7720,11600,-4600,0,11000,-950,17050
7721,-1700,-800,0,-4900,2900,-4500
7722,10900,9800,0,-2900,1950,19750
7723,0,0,0,9000,0,9000
7724,10300,12100,-1200,400,-1200,20400
7725,-2900,-2100,-1800,0,0,-6800
7726,-4100,-700,4700,5400,-950,4350
7727,-200,-2200,0,200,-1200,-3400
7728,-2800,9800,0,-3900,1950,5050
7729,-6000,100,-1200,9400,-11150,-8850
7730,7500,-2000,0,-3700,1700,3500
7731,-1800,-2300,-1200,200,12000,6900
7732,9800,-5200,-900,-1000,-950,1750
7733,-6800,400,1000,-2800,0,-8200
7734,6000,11500,2800,6300,1950,28550
7735,-1000,-4600,0,-2000,-950,-8550
7736,8700,7800,0,-1700,1700,16500
7737,-3200,-800,0,12000,0,8000
7738,11600,-4500,0,-2800,-1200,3100
7739,-5200,12300,-1200,2400,-1200,7100
7740,13900,-7600,0,0,0,6300
7741,-3700,-2000,0,0,-950,-6650
7742,9200,9100,-1200,200,-950,16350
7743,-7700,200,0,-2700,1700,-8500
7744,-200,7400,-1800,-2700,750,3450
7745,9500,-800,4700,-6400,-1200,5800
7746,0,0,0,-1000,-950,-1950
7747,8400,-700,0,12200,-2150,17750
7748,-3900,8500,0,-3900,1950,2650
7749,8500,-2100,0,-3900,1950,4450
7750,-2700,-3000,-1200,13200,-950,5350
7751,-2800,-2100,0,-3900,2900,-5900
7752,6700,9100,0,-3900,1950,13850
7753,-1800,-2300,-10200,8200,0,-6100
7754,11700,9900,0,-1000,0,20600
7755,-5800,-700,-1200,200,0,-7500
7756,-2000,-2200,11100,9200,-10200,5900
7757,14100,7400,1900,-2800,0,20600
7758,-1800,100,1900,-2800,12000,9400
7759,10100,-3700,0,0,0,6400
7760,-5500,-1000,-1200,200,0,-7500
7761,-2700,9700,0,-1000,0,6000
7762,-2500,-3100,0,1200,-1200,-5600
7763,10000,-2200,0,0,0,7800
7764,-3300,0,0,0,-950,-4250
7765,7500,12400,-1200,200,-950,17950
7766,-3500,-2300,-1800,-3900,2900,-8600
7767,9300,-3000,4700,-8300,750,3450
7768,-6000,200,-10200,8200,0,-7800
7769,-6700,0,-1200,-800,0,-8700
7770,3500,12300,0,9200,-10200,14800
7771,200,-6700,12000,-1000,0,4500
7772,11500,-4400,0,-2000,12000,17100
7773,-4100,-800,-2100,200,0,-6800
7774,9800,-5200,1000,-4600,-1200,-200
7775,-6200,9900,1600,-3600,0,1700
7776,5100,500,0,-800,-2150,2650
7777,-5300,9100,-2100,200,0,1900
7778,10300,-2300,-200,-7300,750,1250
7779,3100,10300,2800,8400,-2150,22450
7780,-5900,0,-1200,-1500,1700,-6900
7781,7600,-3000,-900,11200,-2150,12750
7782,-6800,200,1000,-3800,0,-9400
7783,9300,9700,400,6700,1000,27100
7784,-4100,0,-900,200,-2150,-6950
7785,8400,-2200,1000,-7700,2900,2400
7786,-2700,-3000,2800,-5700,1000,-7600
7787,9300,100,0,11200,-2150,18450
7788,-5400,10000,-10200,4300,2900,1600
7789,8400,-2100,-1200,-500,750,5350
7790,-1200,-5300,12000,-1800,-2150,1550
7791,9200,-2100,0,-4900,1950,4150
7792,-2200,7600,0,10000,-950,14450
7793,5300,-600,-10200,8500,1700,4700
7794,-2000,-4400,0,-4900,1950,-9350
7795,8200,10000,10800,-800,-950,27250
7796,-4500,-2700,-1200,-1800,0,-10200
7797,12300,-6800,100,-6700,1950,850
7798,13200,6800,2800,8200,-950,30050
7799,-5000,-700,0,-3900,2900,-6700
7800,9500,100,-1200,-800,0,7600
7801,-5200,12200,-900,10000,0,16100
7802,3400,500,1000,-2800,0,2100
7803,-100,-2300,2800,-2800,0,-2400
7804,7100,8000,0,11000,0,26100
7805,-4800,-5800,0,0,0,-10600
7806,9200,-2100,0,0,0,7100
7807,-4500,10100,0,12000,0,17600
7808,6100,200,0,0,0,6300
7809,-4900,-700,0,-1000,0,-6600
7810,11000,9700,0,-1000,0,19700
7811,-500,-7600,0,1200,-1200,-8100
7812,11300,5300,0,0,0,16600
7813,-1600,0,0,200,-1200,-2600
7814,5000,11600,0,-1000,0,15600
7815,9300,-2200,-1200,1200,0,7100
7816,-6000,12300,0,0,-950,5350
7817,-3500,-2200,0,-1000,-950,-7650
7818,10700,-5300,0,-4900,2900,3400
7819,6400,-4500,0,-1700,750,950
7820,-5900,200,0,0,0,-5700
7821,-2600,8900,-1200,-4800,0,300
7822,9400,200,-2100,200,0,7700
7823,12100,-6600,-200,6400,0,11700
7824,-2700,9000,-200,-3600,0,2500
7825,9400,-600,4700,-6400,-1200,5900
7826,-3600,9900,-2100,-1800,0,2400
7827,13500,-2300,-900,-2000,0,8300
7828,-900,12000,4700,4400,-950,19250
7829,10300,0,0,-1000,-950,8350
7830,400,-4500,0,-3900,2900,-5100
7831,10400,-800,0,7100,1950,18650
7832,-1800,200,0,-2000,0,-3600
7833,8700,12000,0,12200,-1200,31700
7834,-2600,200,-1200,-2800,0,-6400
7835,-1900,-2300,0,13200,-1200,7800
7836,-1600,0,0,0,0,-1600
7837,10200,0,0,-2000,-950,7250
7838,-4400,-400,-2100,12200,0,5300
7839,1700,1200,1000,-6700,1950,-850
7840,-5000,200,2800,-5500,750,-6750
7841,-400,-4500,0,-1000,0,-5900
7842,10700,-6100,0,-1000,0,3600
7843,-5400,-1300,0,11400,-2400,2300
7844,5400,11300,0,-2000,0,14700
7845,-2100,-4300,-1200,1200,0,-6400
7846,7700,11300,0,12000,-950,30050
7847,-5000,100,-1200,200,-950,-6850
7848,7100,0,0,-2900,2900,7100
7849,-3400,12200,100,-6700,1950,4150
7850,7700,100,2800,-1600,-1200,7800
7851,-100,-2300,0,-1000,0,-3400
7852,10200,100,-10200,10200,-950,9350
7853,-3600,200,-1200,-600,-1200,-6400
7854,8500,-2100,10800,-2700,1950,16450
7855,-1900,-2200,-1800,0,-950,-6850
7856,9400,-700,3500,-10300,2900,4800
7857,-6800,100,0,400,-2400,-8700
7858,9300,-3000,0,11000,0,17300
7859,-5100,12900,0,-1000,0,6800
7860,9300,-2100,0,-1000,-950,5250
7861,-5100,-700,0,11000,-950,4250
7862,11400,-4300,-1200,-1500,1700,6100
7863,200,-6700,-900,-4900,1950,-10350
7864,8900,-4300,700,-4600,-950,-250
7865,7000,9800,700,10400,0,27900
7866,-7600,1100,-900,-3900,1950,-9350
7867,-800,5500,-200,-3600,-950,-50
7868,-4400,-3100,400,-6100,1700,-11500
7869,4300,300,-900,10000,0,13700
7870,11100,5600,700,-3400,-1200,12800
7871,-5000,100,1900,-3800,0,-6800
7872,6700,9000,-1800,11200,-2150,22950
7873,-3600,-2900,3500,-4400,-950,-8350
7874,6100,13000,0,9300,1700,30100
7875,500,-5400,-2400,5900,-9450,-10850
7876,10100,-2200,0,200,-2150,5950
7877,-4300,9000,-13200,10400,12000,13900
7878,5900,-2100,3800,-8500,1950,1050
7879,-2100,-4400,-1800,0,-1900,-10200
7880,9500,11300,17600,-9500,2900,31800
7881,-3700,-2100,0,-2900,1950,-6750
7882,12500,7500,0,-1000,0,19000
7883,-2600,-700,0,8100,1950,6750
7884,9500,100,-1200,1200,0,9600
7885,-7800,400,0,12000,0,4600
7886,7800,12200,0,0,0,20000
7887,-2700,-2300,0,-1000,0,-6000
7888,12400,-4600,0,-1000,0,6800
7889,9200,-3000,0,0,0,6200
7890,-3400,100,-1200,-2800,0,-7300
7891,6800,9900,0,0,0,16700
7892,-4200,100,-1800,-1000,0,-6900
7893,6800,-500,4700,-6400,-1200,3400
7894,-1500,-6600,0,-2000,0,-10100
7895,13800,5300,0,-3000,0,16100
7896,1300,-5400,0,11000,0,6900
7897,14100,-5400,0,0,0,8700
7898,-1900,9900,0,-800,-1200,6000
7899,-4200,-700,0,10200,-1200,4100
7900,-1700,100,0,-1000,0,-2600
7901,-1500,7500,0,-2000,-950,3050
7902,-1900,-2900,0,-2900,1950,-5750
7903,6700,9900,0,11000,-950,26650
7904,-3500,-2900,0,-3900,2900,-7400
7905,-6800,200,0,-2000,0,-8600
7906,-3600,9800,0,-2000,0,4200
7907,5800,-2800,0,0,0,3000
7908,-7600,11400,-1200,9400,-1200,10800
7909,6700,-1200,-1200,1400,-1200,4500
7910,-1300,7600,-2100,400,-2150,2450
7911,9300,-2200,3800,-7600,0,3300
7912,-7900,-2800,0,-2900,1950,-11650
7913,8800,0,0,-3000,-1900,3900
7914,400,7500,0,9100,2900,19900
7915,11000,-2200,0,-3900,1950,6850
7916,-3400,-1600,-2400,11600,-2150,2050
7917,4700,-800,-3000,-3700,2900,100
7918,-3300,-800,2600,3800,-10200,-7900
7919,8300,9100,1000,-4800,0,13600
7920,-5000,200,1600,6600,1800,5200
7921,9000,8400,-900,-1000,0,15500
7922,9400,-2200,1000,-3800,12000,16400
7923,-600,-5200,2800,-4800,0,-7800
7924,2700,11600,-1200,12200,0,25300
7925,-1300,-4500,-1200,-1800,0,-8800
7926,6700,-2000,-1800,-1000,0,1900
7927,-400,6700,1900,8200,0,16400
7928,10200,-2200,2800,-4800,0,6000
7929,-4400,12200,-2400,400,0,5800
7930,10100,-3100,-1800,12000,0,17200
7931,1300,-4600,4700,-7600,0,-6200
7932,11500,7600,-2400,-600,0,16100
7933,-3300,-700,-2100,200,0,-5900
7934,11600,-2000,1000,-3600,-1200,5800
7935,-7200,-3000,1600,10400,0,1800
7936,11700,7500,-900,-1000,0,17300
7937,10200,-2200,3800,-5400,-2150,4250
7938,-4400,9100,0,11000,0,15700
7939,-1100,-3100,0,-4900,1950,-7150
7940,9200,10700,-1200,200,-950,17950
7941,-2500,-700,0,8100,2900,7800
7942,9500,-800,0,-1000,0,7700
7943,-5900,13000,0,-800,-1200,5100
7944,-2500,0,0,-2000,0,-4500
7945,6600,500,0,-1000,0,6100
7946,-4100,0,0,0,-950,-5050
7947,13000,-6700,0,8100,1950,16350
7948,-3400,-3000,0,-2000,-950,-9350
7949,10300,100,-1200,-2700,2900,9400
7950,-6200,500,-900,0,0,-6600
7951,-6600,12100,-200,9400,0,14700
7952,9200,-2200,2800,-2800,0,7000
7953,5300,-700,0,-1000,0,3600
7954,-1400,-6000,0,0,0,-7400
7955,8900,-2600,-1200,12200,0,17300
7956,-2000,6800,-900,-1000,0,2900
7957,8400,-2900,1000,-2600,-1200,2700
7958,-1900,-2200,2800,-2800,0,-4100
7959,10200,9700,0,-2000,0,17900
7960,-1800,-600,-1200,1200,0,-2400
7961,6900,12200,0,0,0,19100
7962,-3400,100,0,12000,0,8700
7963,6600,10000,0,0,0,16600
7964,-6100,-600,0,0,0,-6700
7965,3200,-1000,0,-1000,0,1200
7966,-100,-2300,0,200,-1200,-3400
7967,5900,-3600,0,-1000,0,1300
7968,-3500,-1300,0,0,-950,-5750
7969,9400,9700,0,-1000,-950,17150
7970,-1000,-3100,0,-3900,2900,-5100
7971,9300,-600,0,-2500,-450,5750
7972,-6200,-1200,0,-1000,0,-8400
7973,10700,7400,0,-2000,-950,15150
7974,-4100,0,0,11400,-12350,-5050
7975,8600,-800,-1200,-3700,2900,5800
7976,-2500,0,0,-2900,13950,8550
7977,10300,12000,-1800,0,0,20500
7978,-6100,300,4700,-7600,0,-8700
7979,6900,0,0,0,0,6900
7980,-3000,-4500,0,-2000,0,-9500
7981,11600,-5200,0,11000,0,17400
7982,-2800,-2800,0,-1800,-1200,-8600
7983,3900,-1900,0,-1000,0,1000
7984,-2200,7700,-2400,400,-950,2550
7985,6900,100,-900,11000,0,17100
7986,-5600,11200,-200,-6500,1950,850
7987,7600,-2200,2800,-2600,-2150,3450
7988,-5200,9900,0,-3900,2900,3700
7989,12400,-4500,0,0,0,7900
7990,-200,-3100,0,-1000,0,-4300
7991,10900,-2200,-1200,11200,0,18700
7992,-3500,200,-1800,200,-1200,-6100
7993,14200,6600,4700,7600,-1200,31900
7994,8400,200,-1200,200,-950,6650
7995,-1900,9700,0,-1000,-950,5850
7996,8500,-2200,0,-3700,1700,4300
7997,-900,-3100,-1200,13400,-2150,6050
7998,-4300,100,-900,-2900,2900,-5100
7999,-2600,12200,-200,-3600,-950,4850
8000,7800,0,2800,-2800,-950,6850
8001,0,0,0,-5900,2900,-3000
8002,9300,200,-1200,-1500,750,7550
8003,-4100,-700,-1800,12000,0,5400
8004,10100,-1300,4700,-8600,0,4900
8005,-5000,100,0,10200,-11150,-5850
8006,-4300,-700,0,-3700,750,-7950
8007,-2900,-2900,0,0,11050,5250
8008,5900,12400,0,-4900,2900,16300
8009,-1900,-1400,-1200,200,0,-4300
8010,11700,-4600,0,-1000,0,6100
8011,-3600,-2900,-1200,12200,0,4500
8012,5000,-1900,-900,-1000,0,1200
8013,-4200,10400,-200,8400,0,14400
8014,-6700,1000,2800,-2600,-1200,-6700
8015,11800,-2200,-1200,-800,0,7600
8016,-6000,11400,-2100,1200,-950,3550
8017,9200,-1300,1000,-3800,0,5100
8018,-1800,-2300,2800,-7700,1950,-7050
8019,9800,-5200,-2100,200,-950,1750
8020,-3700,-2000,1000,-7500,1700,-10500
8021,8800,-800,-7400,6600,-1200,6000
8022,11100,12000,-1200,13200,0,35100
8023,-900,0,0,-2000,-950,-3850
8024,7800,12100,12000,-1000,0,30900
8025,-1800,100,-1200,-3700,1950,-4650
8026,6100,100,-900,12000,-950,16350
8027,-2800,-2100,1000,-6700,2900,-7700
8028,9800,-4200,1600,-5600,0,1600
8029,-3400,-2300,-10200,9200,0,-6700
8030,-5300,-500,0,-4000,0,-9800
8031,6100,200,12000,1200,-1200,18300
8032,-300,7400,0,-1000,0,6100
8033,9500,0,0,11000,0,20500
8034,-1700,-800,0,-1000,0,-3500
8035,9300,200,0,-2000,0,7500
8036,-2200,-4500,0,0,0,-6700
8037,9300,9100,0,11000,0,29400
8038,-3100,-4300,0,-2000,0,-9400
8039,-5000,100,-2400,400,0,-6900
8040,-3500,-2100,-900,-1000,0,-7500
8041,3400,10600,1000,-2800,0,12200
8042,-5000,1000,2800,-2800,0,-4000
8043,10700,6700,0,-2000,0,15400
8044,-4500,-1300,0,-2000,0,-7800
8045,10200,-3100,0,200,-1200,6100
8046,-6000,300,0,10000,0,4300
8047,5900,-1900,-1200,1200,-950,3050
8048,-3700,9800,-12000,7200,0,1300
8049,10700,-5100,3500,-7100,750,2750
8050,8500,-2200,12000,-2000,-950,15350
8051,1900,5300,0,-4900,2900,5200
8052,8500,-700,-1200,200,0,6800
8053,-1800,-3000,0,10000,0,5200
8054,9400,12100,-1800,0,0,19700
8055,-5200,100,1900,-2800,0,-6000
8056,8000,7900,2800,8200,0,26900
8057,1300,-5300,-1200,-800,0,-6000
8058,11500,-4300,0,-1000,0,6200
8059,-3700,8400,0,-1000,0,3700
8060,-1100,-3700,-1200,-3800,0,-9800
8061,11600,-4500,-12300,11400,0,6200
8062,-1000,9000,1000,-3800,0,5200
8063,-3300,-800,14800,-2600,-1200,6900
8064,-1100,9700,0,-2000,0,6600
8065,8700,0,0,-2800,-2150,3750
8066,-3600,200,-1200,400,-1200,-5400
8067,9300,9800,-900,9300,750,28250
8068,-4300,-500,1000,-2800,-1900,-8500
8069,11900,-2300,2800,-8700,2900,6600
8070,-4200,0,-11400,6500,1950,-7150
8071,-2600,12200,0,200,-2150,7650
8072,9100,-2100,12000,7300,-7300,19000
8073,-5900,100,0,-2000,-950,-8750
8074,12500,-4600,0,9200,1800,18900
8075,-5900,-1500,-1200,-1500,750,-9350
8076,-3300,900,-2400,400,-950,-5350
8077,7700,100,-2700,-2900,14900,17100
8078,-1200,10000,6600,-9200,-1200,5000
8079,10100,-2200,700,-2600,0,6000
8080,-100,-2300,0,-1000,-950,-4350
8081,7700,-600,0,12000,0,19100
8082,-400,-4600,0,0,-950,-5950
8083,-900,100,0,9100,2900,11200
8084,9800,6900,0,-2700,750,14750
8085,-5100,200,0,0,0,-4900
8086,-6000,12100,0,8200,-10200,4100
8087,-2900,-4400,-1200,200,0,-8300
8088,8400,-2900,-1800,0,12000,15700
8089,-4200,100,4700,-5600,0,-5000
8090,12500,7400,0,-1000,0,18900
8091,0,0,0,-1000,0,-1000
8092,5900,-600,0,0,0,5300
8093,-4500,-2000,0,-3000,0,-9500
8094,8300,9900,-10200,8200,0,16200
8095,-500,-4500,0,-600,-2400,-8000
8096,6700,-2900,9600,2400,0,15800
8097,-6300,-1900,-2100,200,-950,-11050
8098,-2800,9000,1000,-4800,-950,1450
8099,-8500,-500,1600,-6500,2900,-11000
8100,5900,-1400,-1200,-4700,1950,550
8101,-2100,6800,-1800,-2000,0,900
8102,7200,-4500,4700,-7600,0,-200
8103,9800,6900,-1200,10200,0,25700
8104,-5800,-600,-1800,-1000,0,-9200
8105,1800,500,-5500,14800,-1200,10400
8106,400,5100,0,0,0,5500
8107,9000,-4400,12000,-2000,0,14600
8108,-2600,9000,0,-800,-2150,3450
8109,7100,0,0,12000,-950,18150
8110,-300,6700,0,-3900,2900,5400
8111,8500,-700,0,-3900,1950,5850
8112,-6900,13000,0,1400,-2400,5100
8113,12500,-4500,-1200,12200,0,19000
8114,-5300,-4500,0,0,-950,-10750
8115,5100,1900,0,0,0,7000
8116,-6000,300,0,-2900,1950,-6650
8117,12500,7400,0,200,-2150,17950
8118,1000,-7600,0,-3900,2900,-7600
8119,7600,-2000,-10200,9400,-1200,3600
8120,6900,-600,-1200,200,-950,4350
8121,900,4600,7800,400,-950,12750
8122,5200,300,4700,-8500,2900,4600
8123,-4200,11300,-1800,-3900,1950,3350
8124,1700,1200,4700,-6600,0,1000
8125,-2600,9800,0,0,0,7200
8126,5400,100,0,11000,0,16500
8127,-6800,-600,0,-1000,0,-8400
8128,7800,100,0,-1000,0,6900
8129,4300,12400,0,12000,0,28700
8130,-2700,-2100,-1200,-800,0,-6800
8131,8400,-2100,0,0,0,6300
8132,1900,-6800,0,-1000,0,-5900
8133,10100,-3000,0,0,0,7100
8134,1300,-4600,0,12000,0,8700
8135,7600,-500,0,0,0,7100
8136,-5400,10100,0,0,0,4700
8137,13300,-4500,0,0,0,8800
8138,-6800,-600,0,0,0,-7400
8139,9300,9800,0,-800,-1200,17100
8140,1100,-8500,0,1200,-1200,-7400
8141,9400,12200,0,-1000,0,20600
8142,-4300,100,0,0,-950,-5150
8143,11900,-2300,0,-4700,750,5650
8144,-4500,12300,0,-1000,0,6800
8145,7500,-2100,0,-1700,750,4450
8146,-1400,7600,-1200,200,-950,4250
8147,7000,-700,-900,-1000,-950,3450
8148,-4100,100,-2100,-3700,1950,-7850
8149,12400,-4500,4700,-10500,2900,5000
8150,-4600,10000,0,10400,-11400,4400
8151,8700,-800,0,-1000,0,6900
8152,-2600,-2200,0,0,11050,6250
8153,10000,9700,0,10000,0,29700
8154,-3000,-6200,-2100,-1500,750,-12050
8155,8300,-1200,1000,-4800,-950,2350
8156,-7600,11300,2800,-7300,500,-300
8157,10200,-2300,0,-1000,0,6900
8158,-800,0,0,0,0,-800
8159,-5100,12100,-11400,21400,-950,16050
8160,14100,-4500,0,-2000,0,7600
8161,-4200,100,0,-4900,1950,-7050
8162,9300,-600,12000,-2700,750,18750
8163,-3700,-2100,0,-1000,0,-6800
8164,12600,7400,0,-1000,-950,18050
8165,-1200,-2200,-1200,-600,-1200,-6400
8166,-7100,-3500,0,9300,750,-550
8167,5900,-1300,-3000,-800,-950,-150
8168,8300,9900,3500,-7300,1950,16350
8169,-5300,-2900,-1800,12000,-950,1050
8170,5300,200,4700,-9500,2900,3600
8171,-1800,9700,0,-2900,1950,6950
8172,4300,-700,0,11000,0,14600
8173,-9400,400,0,-2000,0,-11000
8174,10200,-2300,-2400,1400,0,6900
8175,-6700,12100,-900,12200,-1200,15500
8176,7900,100,1000,-2800,0,6200
8177,-1000,-2300,2800,-2800,0,-3300
8178,10800,-2000,0,-3000,0,5800
8179,10100,-3000,-10200,10400,-1200,6100
8180,-5100,300,0,-1000,0,-5800
8181,-1400,-5100,12000,-1000,-950,3550
8182,9300,10600,-1200,200,0,18900
8183,9800,-5100,0,-3900,1950,2750
8184,-5000,-700,0,-600,-3350,-9650
8185,-2700,9900,0,-2900,2900,7200
8186,9100,-2000,0,12000,-950,18150
8187,7900,12100,-1200,-800,0,18000
8188,-6100,300,0,-2900,1950,-6750
8189,10800,-4400,-1800,-1000,-950,2650
8190,-5900,0,4700,-10500,2900,-8800
8191,7700,-500,0,0,0,7200
8192,-4400,-2200,0,11000,0,4400
8193,5100,12000,0,0,0,17100
8194,-5300,-2200,0,11000,0,3500
8195,9300,-2300,0,-800,-1200,5000
8196,-2700,-3800,0,-1000,0,-7500
8197,11600,-3700,0,0,0,7900
8198,0,11200,0,-1000,0,10200
8199,9300,200,0,0,0,9500
8200,-5500,-1900,-1200,-800,0,-9400
8201,9200,9800,0,-1000,0,18000
8202,-1800,-3800,0,-2000,0,-7600
8203,8400,-1300,0,0,0,7100
8204,-2700,9700,0,11000,0,18000
8205,5300,200,0,1200,-1200,5500
8206,-3300,-800,0,-1000,0,-5100
8207,6800,200,0,-2000,-950,4050
8208,-100,-2300,0,1200,-1200,-2400
8209,10000,9700,0,-4900,1950,16750
8210,-5300,200,0,0,-950,-6050
8211,7600,-2000,0,-5900,2900,2600
8212,-2800,-2100,0,1200,-1200,-4900
8213,9200,-2800,0,11000,0,17400
8214,-4400,-3000,0,-1000,-950,-9350
8215,-2600,9800,-1200,200,0,6200
8216,11500,-4500,-900,-3900,1950,4150
8217,-5600,6900,1000,-4800,-950,-3450
8218,13900,-6800,1600,-6500,2900,5100
8219,10700,-5300,0,200,-1200,4400
8220,-300,7400,0,12000,0,19100
8221,-3500,-700,0,-1000,0,-5200
8222,9200,-3000,-1200,-800,0,4200
8223,-500,7600,-900,14400,-2400,18200
8224,8400,-2200,1000,-2800,0,4400
8225,8500,9000,2800,-2800,-950,16550
8226,-6000,200,0,9200,-11150,-7750
8227,-1900,-3100,0,-3700,1700,-7000
8228,8500,10600,0,-2900,1950,18150
8229,-5200,-400,0,-1000,11050,4450
8230,4900,9200,0,-800,-1200,12100
8231,-500,-4500,0,-3900,1950,-6950
8232,7500,10800,0,0,0,18300
8233,-3700,-2900,0,8100,1950,3450
8234,6900,100,0,0,0,7000
8235,7000,10400,0,-2000,0,15400
8236,-300,-4500,0,200,-1200,-5800
8237,5000,-1300,0,11000,0,14700
8238,-6100,10100,0,200,-1200,3000
8239,8400,-3800,0,-1800,-2150,650
8240,-3500,-1400,0,1200,-2150,-5850
8241,8400,9000,0,-4700,1700,14400
8242,-100,-2300,0,-3700,-200,-6300
8243,9000,9800,0,0,0,18800
8244,-300,-5400,0,-5900,1000,-10600
8245,8500,300,0,-2900,1950,7850
8246,-1000,-2300,-1200,10200,-950,4750
8247,12000,12000,0,-3900,2900,23000
8248,-1800,-700,0,9100,1950,8550
8249,8700,100,0,-2000,0,6800
8250,-1200,-2100,0,-1000,0,-4300
8251,9300,9800,-1200,200,0,18100
8252,-3200,0,0,12200,-1200,7800
8253,-4000,-1800,-1800,-1000,0,-8600
8254,-4900,-800,4700,-6600,0,-7600
8255,6600,-1900,-1200,-1800,-950,750
8256,-4900,11200,-1200,-800,-950,3350
8257,-6800,200,-3000,10500,750,1650
8258,7500,-1200,4700,-9500,2900,4400
8259,3800,-4300,-1200,12200,0,10500
8260,-200,-5400,0,-1000,0,-6600
8261,10700,-4500,1000,-2600,-1200,3400
8262,-1700,11300,1900,9200,0,20700
8263,9500,0,0,0,-950,8550
8264,-4300,12100,0,-4000,0,3800
8265,12500,-4600,0,-2700,750,5950
8266,-2600,-800,-1200,13200,-950,7650
8267,5100,200,0,-3900,2900,4300
8268,-6300,10100,0,-1000,0,2800
8269,6100,-700,0,-1000,0,4400
8270,-3700,-1400,0,-1000,0,-6100
8271,7900,-700,0,-1000,0,6200
8272,-2000,-4500,0,0,0,-6500
8273,10400,0,0,12000,0,22400
8274,-2700,12100,0,-1000,0,8400
8275,6900,200,-2400,1600,-1200,5100
8276,-2200,-4400,-1800,-1000,0,-9400
8277,13100,-6800,4700,-5600,-950,4450
8278,4900,-2600,0,0,0,2300
8279,-1300,-5100,0,-4900,1950,-9350
8280,7100,11200,0,-3000,-950,14350
8281,-2300,-5000,-1200,-3300,500,-11300
8282,11300,5300,-900,11000,0,26700
8283,-2700,-2100,1000,-4800,0,-8600
8284,7000,-1500,1600,-3600,-950,2550
8285,300,8500,0,11000,-950,18850
8286,9200,-2200,0,-3900,2900,6000
8287,-1800,8900,-1200,-5700,1950,2150
8288,-3400,0,0,12200,-1200,7600
8289,11800,-2300,-900,-200,-4800,3600
8290,-200,9000,1000,-4600,-1200,4000
8291,10200,200,2800,8200,0,21400
8292,-1900,-2200,0,-1000,-950,-6050
8293,-3700,9100,0,0,-950,4450
8294,-1300,-3600,0,8100,1950,5150
8295,-1800,8900,-1200,-3500,750,3150
8296,7900,-1500,0,-3700,-200,2500
8297,-7100,12600,0,-800,-1200,3500
8298,-3400,-1400,0,8100,1950,5250
8299,6700,-2000,-1200,-800,-1900,800
8300,-1000,9000,0,9300,1700,19000
8301,9400,100,1000,-5700,1950,6750
8302,300,-4400,1900,-3800,-950,-6950
8303,7900,0,0,-2900,1950,6950
8304,-6900,12300,0,8100,1950,15450
8305,9300,-2200,0,-2000,-950,4150
8306,-2500,100,0,10300,1700,9600
8307,6800,-600,-1200,-4700,1950,2250
8308,-4400,-2800,0,-600,-2400,-10200
8309,6100,1000,0,-1000,0,6100
8310,-6000,12300,0,11000,-950,16350
8311,5300,100,0,0,-950,4450
8312,-3000,-4400,0,-4900,2900,-9400
8313,13300,-4600,0,-3700,750,5750
8314,-5500,-2700,0,-800,-1200,-10200
8315,7900,-700,-1200,-1800,-950,3250
8316,-1400,7600,-2100,21400,-10200,15300
8317,8500,-2100,-200,-6300,750,650
8318,-3100,6900,-200,-2600,-950,50
8319,5100,400,4700,-10500,14900,14600
8320,-3900,-4500,0,-1000,-950,-10350
8321,11800,5800,0,-2000,-950,14650
8322,-3900,-3400,0,9100,2900,4700
8323,4400,11500,0,-1000,-950,13950
8324,-4400,-3600,0,-3900,2900,-9000
8325,2500,1300,0,12000,0,15800
8326,-1900,9800,0,-1000,0,6900
8327,9700,-4200,-1200,1200,0,5500
8328,-1100,7500,-900,12000,0,17500
8329,8300,-5300,1000,-2800,0,1200
8330,9600,0,2800,-2800,0,9600
8331,-2800,8200,0,-1000,0,4400
8332,7600,1100,-1200,200,0,7700
8333,-5900,12200,0,10000,0,16300
8334,11500,-4400,-1200,600,-2400,4100
8335,-1300,-5100,-2100,1200,0,-7300
8336,7600,-3000,1000,-2600,-1200,1800
8337,-1300,-4400,2800,-2800,-950,-6650
8338,6200,12100,0,-1000,-950,16350
8339,-3400,-800,0,-4900,2900,-6200
8340,9200,9900,0,-2900,1950,18150
8341,-5100,200,0,11200,-1200,5100
8342,10200,9700,0,-1000,0,18900
8343,1500,-2300,0,-800,-2150,-3750
8344,7600,-600,-1200,1400,-1200,6000
8345,15000,-4600,-900,8100,1950,19550
8346,-3600,12100,1000,-5700,1000,4800
8347,10100,-2300,2800,-3800,0,6800
8348,-2400,0,0,-3900,1950,-4350
8349,-5900,-600,0,-2000,-950,-9450
8350,300,-4300,-1200,7300,2900,5000
8351,9700,7000,0,-2600,-2400,11700
8352,-5000,200,-1200,13200,0,7200
8353,6200,200,-900,-3000,0,2500
8354,-4000,-4300,-200,-3600,-950,-13050
8355,1100,4400,2800,-4800,-950,2550
8356,12800,-8900,0,-2900,2900,3900
8357,-1200,6800,0,6100,1950,13650
8358,16500,-7700,0,-2000,0,6800
8359,-2600,100,0,9400,-11400,-4500
8360,-4200,11300,-3300,12400,0,16200
8361,600,-3000,-900,0,0,-3300
8362,-1100,9700,4700,-5600,12000,19700
8363,9500,100,0,-1000,0,8600
8364,-3500,300,-1200,200,0,-4200
8365,-1700,12000,0,0,0,10300
8366,-4000,-4100,-3000,12400,-1200,100
8367,5900,-2100,4700,-5600,0,2900
8368,-4300,9000,0,-1000,0,3700
8369,-700,-6700,-1200,200,-950,-9350
8370,500,6600,-11100,6300,1950,4250
8371,12600,-3000,700,-1600,-950,7750
8372,-2800,-3000,13900,-6700,2900,4300
8373,7800,11400,0,1200,-1200,19200
8374,400,-3700,0,-1000,0,-4300
8375,7000,12100,0,-1000,0,18100
8376,-2000,-3000,0,12200,-1200,6000
8377,-5100,100,0,-3000,0,-8000
8378,6900,11300,-1200,2400,-2150,17250
8379,-3700,-1200,-900,-1000,0,-6800
8380,12400,7500,1900,-6700,1950,17050
8381,-1800,-2300,1900,-2800,-950,-5950
8382,12500,-5300,0,-4900,2900,5200
8383,-300,-3000,0,-800,-1200,-5300
8384,-1800,12200,-1200,9400,-10200,8400
8385,6900,100,0,12200,-1200,18000
8386,-5200,10000,-1200,-600,-2150,850
8387,-5100,200,-900,2400,9600,6200
8388,-1900,-3000,1000,-5500,-200,-9600
8389,6000,300,2800,-6700,1950,4350
8390,3600,5100,-11400,10400,0,7700
8391,-1900,-3100,-1200,-3700,1000,-8900
8392,8500,100,0,1200,-2150,7650
8393,6700,-2200,13000,-7700,2900,12700
8394,-6800,11300,1900,-4300,-1400,700
8395,-1000,-8800,0,8300,750,-750
8396,10000,-4600,0,-1000,-1900,2500
8397,-5300,9200,0,-5900,2900,900
8398,12500,-5400,0,-1500,-450,5150
8399,-6000,100,0,19200,-11150,2150
8400,6700,7300,0,-3700,750,11050
8401,200,-5000,0,-4900,13950,4250
8402,6700,9100,-10200,9200,-1900,12900
8403,-4100,100,0,-3900,2900,-5000
8404,13900,5200,12000,-3900,1950,29150
8405,-3600,-400,-1200,8400,-11150,-7950
8406,10800,7400,-1200,-3700,2900,16200
8407,600,-2300,-900,-3900,13950,7450
8408,10300,11200,3800,3600,-10200,18700
8409,1200,-4500,0,-2000,0,-5300
8410,-5000,-700,0,0,12000,6300
8411,-600,7700,0,-2000,0,5100
8412,-6800,-700,-1200,12200,0,3500
8413,-2600,9700,-1200,600,-2400,4100
8414,8600,-6400,-2100,13200,0,13300
8415,1300,7400,1000,-2800,0,6900
8416,13000,-7600,2800,-2800,-950,4450
8417,-5300,-3800,0,-1000,-950,-11050
8418,-1900,10700,0,-2700,1700,7800
8419,7000,-1600,-1200,-2700,1950,3450
8420,-4700,-4300,-1800,-2000,0,-12800
8421,-6200,10900,3500,6600,0,14800
8422,9200,-2900,0,-1000,0,5300
8423,-4200,9800,0,-2000,0,3600
8424,13300,-5400,0,-1000,0,6900
8425,-2700,12300,0,-3000,0,6600
8426,4400,-700,0,12200,-1200,14700
8427,500,-4500,0,-1000,0,-5000
8428,9400,12100,0,0,-950,20550
8429,2100,-5400,0,-2000,0,-5300
8430,8500,12300,-1200,-2500,750,17850
8431,1200,-5200,-900,-3000,-950,-8850
8432,7900,12900,-200,-3300,1700,19000
8433,1200,-5200,2800,8200,0,7000
8434,-6100,300,0,9200,-11150,-7750
8435,-1900,9800,0,-2000,-950,4950
8436,7600,-3000,-1200,-2700,2900,3600
8437,4300,-9100,-900,-2900,13950,5350
8438,-1000,-2300,1000,-4600,-1200,-8100
8439,-2600,-600,2800,-4800,0,-5200
8440,8600,11200,0,10000,0,29800
8441,-5100,-600,0,1200,-1200,-5700
8442,-1400,8600,0,-1000,0,6200
8443,11000,-2300,0,11000,-950,18750
8444,-1900,-2200,0,-3000,-950,-8050
8445,9200,9100,-1200,-3500,1700,15300
8446,1300,-4500,-2100,-1700,1950,-5050
8447,-2800,9100,1000,8200,0,15500
8448,-6000,100,1600,6600,-10200,-7900
8449,-1900,9700,-1200,200,0,6800
8450,-2400,0,-900,-1000,12000,7700
8451,11000,-3100,1000,-4600,-1200,3100
8452,-1800,100,400,-2400,0,-3700
8453,5500,10200,-900,-800,-2150,11850
8454,-5800,100,1000,-4800,0,-9500
8455,8500,-2100,2800,6300,1950,17450
8456,-400,-5400,0,-2000,-950,-8750
8457,7500,-2100,0,-4900,2900,3400
8458,-3000,-5100,0,11000,0,2900
8459,4200,12300,0,0,0,16500
8460,-4800,0,0,-1800,-1200,-7800
8461,10600,7600,-1200,13200,0,30200
8462,-6800,-400,0,-2000,0,-9200
8463,7500,-2200,0,0,-950,4350
8464,1800,-7600,0,12000,-950,5250
8465,5800,10100,0,-3900,2900,14900
8466,-1700,-3100,0,-2900,1950,-5750
8467,10700,7600,0,-2000,0,16300
8468,1400,-5400,0,-800,-1200,-6000
8469,9300,11200,0,-2000,0,18500
8470,-6800,1100,-2400,-600,0,-8700
8471,7600,-2100,-2100,12200,0,15600
8472,-4500,9100,100,-1600,-1200,1900
8473,-900,-2300,3800,-6600,0,-6000
8474,5900,400,2800,-4800,-950,3350
8475,-2900,7600,0,0,-950,3750
8476,7100,-800,0,6100,2900,15300
8477,-1800,100,0,-2900,1950,-2650
8478,10300,100,0,0,0,10400
8479,-4700,10000,0,10000,0,15300
8480,8700,100,-11400,11400,0,8800
8481,5300,200,0,-1000,0,4500
8482,500,-5400,12000,-1000,0,6100
8483,7800,100,0,1200,-1200,7900
8484,-900,100,0,200,-1200,-1800
8485,10200,12100,0,-2000,0,20300
8486,-4300,200,0,-1000,0,-5100
8487,10000,-2200,-1200,200,-950,5850
8488,-4100,0,-900,-2000,-950,-7950
8489,-2700,-2100,1000,-6700,2900,-7600
8490,10900,-2300,1600,-5300,750,5650
8491,-2600,-600,0,-2000,0,-5200
8492,6900,200,-1200,-2800,0,3100
8493,-1000,9700,-3000,13400,-1200,17900
8494,6800,0,3500,-7400,0,2900
8495,-2400,0,-900,12000,-950,7750
8496,-4300,200,1000,-3600,-1200,-7900
8497,9900,-4400,2800,-6500,750,2550
8498,-300,-3100,0,-800,-2150,-6350
8499,9300,-2200,-1200,9500,750,16150
8500,-4500,-2800,0,-800,-1200,-9300
8501,-3600,9900,0,5300,750,12350
8502,-5500,-2000,-1200,1200,-1900,-9400
8503,8500,9000,-1800,9100,2900,27700
8504,14000,-6800,1900,-5700,1000,4400
8505,-5900,100,2800,-4800,0,-7800
8506,-2800,8100,0,-2900,1950,4350
8507,10700,-3500,-10200,18300,1950,17250
8508,-3700,10000,0,-800,-2150,3350
8509,7500,-2800,12000,-2900,2900,16700
8510,-1000,-3100,0,-2000,0,-6100
8511,7500,9900,0,-800,-1200,15400
8512,-2800,-3600,0,0,0,-6400
8513,-7200,11700,0,11000,-950,14550
8514,9000,-5200,-1200,1400,-1200,2800
8515,-4500,-2000,0,-2900,1950,-7450
8516,9300,9000,0,0,-950,17350
8517,-2000,-4600,0,-3500,500,-9600
8518,7600,8900,-10200,10200,0,16500
8519,10400,-6700,0,0,-950,2750
8520,-4900,11300,12000,0,0,18400
8521,6100,100,0,-2500,-450,3250
8522,-1800,-2200,0,0,-950,-4950
8523,3900,10100,0,-2900,2900,14000
8524,-1200,-5300,0,-1000,-950,-8450
8525,7600,-3000,0,0,-950,3650
8526,-1000,9800,0,-3900,2900,7800
8527,8600,0,0,10300,750,19650
8528,-300,9000,0,0,0,8700
8529,10100,-2200,0,0,-950,6950
8530,7800,-700,-1200,200,0,6100
8531,-5100,12300,0,-2900,1950,6250
8532,6000,1000,-3000,200,0,4200
8533,-6000,-800,4700,-9300,750,-10650
8534,5700,-1100,0,400,-2400,2600
8535,-6800,300,0,11000,0,4500
8536,11600,-4600,0,0,-950,6050
8537,-3600,-2900,0,12000,0,5500
8538,6900,100,0,-2900,1950,6050
8539,-1000,9800,0,0,-950,7850
8540,7000,-800,0,-3900,2900,5200
8541,-1900,-3000,0,-1000,0,-5900
8542,5300,1000,-1200,400,-1200,4300
8543,-900,9700,0,0,0,8800
8544,8500,200,100,-3800,-950,4050
8545,-4300,0,2800,-4800,0,-6300
8546,8200,-2000,-1200,-4700,1950,2250
8547,-5400,-2900,0,-1000,-950,-10250
8548,7500,-2000,0,-5900,2900,2500
8549,-5000,-800,0,11000,0,5200
8550,6800,10800,-1200,-1800,0,14600
8551,-1800,-3900,0,-800,-1200,-7700
8552,7600,-1300,-1800,9000,0,13500
8553,-1600,0,4700,6400,0,9500
8554,7600,11300,0,-2000,0,16900
8555,-5000,900,-1200,9600,-11400,-7100
8556,8700,0,0,-3000,0,5700
8557,-300,-3800,-1200,-800,-950,-7050
8558,6700,-1300,-900,0,12000,16500
8559,-2000,-2000,1000,-8700,1950,-9750
8560,8100,-4300,2800,-5800,-950,-150
8561,-8400,11400,0,-2700,1700,2000
8562,5200,200,0,11000,0,16400
8563,-2700,8900,0,9400,-11400,4200
8564,10700,-3500,0,9000,0,16200
8565,-3700,-3000,-2400,400,0,-8700
8566,9800,-6000,0,1200,9850,14850
8567,-5500,-200,-1800,-1000,-950,-9450
8568,10300,8100,4700,-9500,2900,16500
8569,-6000,1100,0,-2700,750,-6850
8570,7000,8900,-10200,8400,-1200,12900
8571,-4900,-1600,0,-1000,-950,-8450
8572,9900,6700,10800,200,0,27600
8573,-9500,600,-1200,9300,1950,1150
8574,9300,-2300,0,-2900,1950,6050
8575,-2700,9900,-1800,0,0,5400
8576,6600,-2200,4700,-6600,0,2500
8577,4900,-2900,-11400,10600,-1200,0
8578,300,-7600,0,0,0,-7300
8579,9300,9900,12000,-3000,0,28200
8580,1000,-7500,-1200,1200,-950,-7450
8581,5200,12300,-1800,0,-950,14750
8582,-3500,-3700,4700,-10500,1950,-11050
8583,6500,10900,0,-3700,1700,15400
8584,-1400,-4400,-1200,200,0,-6800
8585,5400,-1500,0,-1800,-1200,900
8586,-6700,13100,0,12000,0,18400
8587,2600,200,0,200,-1200,1800
8588,-5100,200,0,0,-950,-5850
8589,7000,12100,0,11000,0,30100
8590,-900,-2300,0,-2700,750,-5150
8591,11300,-6700,0,0,-950,3650
8592,-8600,-400,0,6300,-8250,-10950
8593,4100,-2100,-1200,200,-950,50
8594,8800,-6700,-900,-3900,2900,200
8595,-5000,11400,1000,-6700,13950,14650
8596,8100,-5000,2800,-3800,0,2100
8597,-4200,12200,-10200,8200,0,6000
8598,8700,-6500,0,0,0,2200
8599,-5100,11400,1800,9200,0,17300
8600,4000,-2000,0,-1000,0,1000
8601,-5000,11300,-1200,-600,-1200,3300
8602,12100,-6800,12000,-2000,0,15300
8603,-4000,0,0,1200,-1200,-4000
8604,8000,6900,0,-1000,0,13900
8605,10800,-4600,0,-1000,-950,4250
8606,-3500,9000,0,-1000,-950,3550
8607,12500,-5400,0,-3700,1700,5100
8608,-2000,-4400,0,-2900,1950,-7350
8609,5400,12100,-1200,8400,-10200,14500
8610,2000,-8400,-900,-2000,0,-9300
8611,4200,400,-9200,6400,12000,13800
8612,-6300,10100,400,-2400,0,1800
8613,10700,-4400,11100,0,0,17400
8614,-3600,10000,-9200,6400,0,3600
8615,11600,-6200,2800,-3800,0,4400
8616,400,8300,0,1600,-3600,6700
8617,10800,-5300,10800,200,0,16500
8618,-1400,-5100,0,0,-950,-7450
8619,9300,9100,0,0,0,18400
8620,6100,100,0,-3900,1950,4250
8621,-6800,-500,0,-2900,1000,-9200
8622,-5300,13100,-10200,8200,-950,4850
8623,5300,-700,0,-2900,2900,4600
8624,8300,10800,0,-3900,1950,17150
8625,-4600,-1900,12000,-1000,0,4500
8626,9400,9000,0,-2000,0,16400
8627,2800,-7700,-1200,200,0,-5900
8628,10000,7600,-900,12000,0,28700
8629,-3600,-2100,1000,-3800,0,-8500
8630,-1900,9100,2800,-2600,-1200,6200
8631,7700,100,0,-1000,0,6800
8632,10800,7600,0,200,-1200,17400
8633,-6100,-500,0,11000,0,4400
8634,7900,0,0,-2000,0,5900
8635,-3400,100,0,200,-2150,-5250
8636,11800,9700,0,-4000,-950,16550
8637,0,0,-2400,-1500,2900,-1000
8638,9200,-3000,0,-4900,1950,3250
8639,-1700,900,-1800,-1000,0,-3600
8640,8600,-700,2300,7000,-1200,16000
8641,-3500,200,-1800,-3000,0,-8100
8642,8900,7800,4700,-4400,-2150,14850
8643,-1800,-2200,0,-2000,0,-6000
8644,13300,-5400,-10200,18300,1950,17950
8645,10100,-3000,0,-4000,-950,2150
8646,-1200,-2000,10800,-4700,2900,5800
8647,10600,-4400,0,-1000,0,5200
8648,-400,6600,-1200,10200,0,15200
8649,7700,-3100,0,0,0,4600
8650,-4400,10000,-2700,9000,0,11900
8651,14100,-4600,5600,-5600,0,9500
8652,-3600,-500,0,-2000,0,-6100
8653,9400,9700,0,-4000,0,15100
8654,-1100,-2300,0,0,0,-3400
8655,-1100,9700,-1200,10200,0,17600
8656,7400,-2900,0,0,0,4500
8657,10300,9700,0,-2000,0,18000
8658,-2500,100,-1200,-2800,0,-6400
8659,-5200,12300,-2100,12200,0,17200
8660,-3300,0,2600,-6400,0,-7100
8661,7400,-2100,-2100,-800,0,2400
8662,-4500,-2000,-6400,1600,0,-11300
8663,7900,-800,0,1200,-1200,7100
8664,-4400,-2100,0,-2000,0,-8500
8665,3000,7400,12000,200,-2150,20450
8666,9300,-600,0,11000,0,19700
8667,-1600,0,-1200,-2700,1950,-3550
8668,11200,-800,-1800,-2000,-950,5650
8669,-1800,12900,3500,-10300,2900,7200
8670,10200,200,-1200,400,-1200,8400
8671,11000,-4600,-900,12000,0,17500
8672,-3700,500,3800,-7600,-950,-7950
8673,-7500,-600,0,2600,-3600,-9100
8674,-1000,-2300,0,7100,1950,5750
8675,-2600,0,0,-1000,-1900,-5500
8676,9500,12000,0,10500,500,32500
8677,-2700,300,0,-4900,1950,-5350
8678,8200,-2800,0,9200,-12100,2500
8679,-7500,1000,-1200,-3700,2900,-8500
8680,-2700,-2100,0,-5900,1950,-8750
8681,6900,-600,0,-2000,11050,15350
8682,-5900,200,0,-2900,2900,-5700
8683,-3300,12000,0,11000,0,19700
8684,5300,100,0,-2000,0,3400
8685,-2800,-2100,0,-2000,0,-6900
8686,6600,-1800,0,11000,0,15800
8687,-1500,-6700,0,-2000,0,-10200
8688,8400,-3800,-1200,200,0,3600
8689,-5300,-1100,-900,0,0,-7300
8690,8500,9000,1000,-5800,0,12700
8691,1300,-4500,2800,-5800,0,-6200
8692,8500,-700,0,-2000,0,5800
8693,-2500,11300,-1200,12200,0,19800
8694,10100,-1400,0,0,0,8700
8695,0,12000,0,10000,0,22000
8696,9400,100,-1200,200,0,8500
8697,-200,-2200,-900,-1000,0,-4300
8698,10300,-800,-10400,6600,0,5700
8699,-6800,300,1600,-2400,-1200,-8500
8700,14000,-4500,11100,200,-1200,19600
8701,-2800,9800,-900,-1000,0,5100
8702,8700,100,4700,-6600,-950,5950
8703,-400,-5400,-1200,10500,750,4250
8704,-200,-3100,0,0,0,-3300
8705,9100,9900,0,-4900,1950,16050
8706,-2700,-2200,0,-1000,-950,-6850
8707,-1000,9800,0,-1000,-950,6850
8708,9400,100,0,9100,2900,21500
8709,-6900,-600,0,-3900,1950,-9450
8710,-3500,-2100,0,-2000,0,-7600
8711,9400,12100,0,-1000,0,20500
8712,-4000,0,-10200,9200,0,-5000
8713,8400,200,0,-800,-1200,6600
8714,-3600,-2200,12000,0,0,6200
8715,5800,-2100,0,-800,-1200,1700
8716,-4900,-700,0,-2000,0,-7600
8717,10900,-2200,-1200,10600,-11400,6700
8718,-3800,-2100,-900,-1600,-3350,-11750
8719,9800,6600,-1400,-1400,11050,24650
8720,-3600,-2800,2800,-5700,1950,-7350
8721,9800,-3600,100,-5700,1950,2550
8722,2700,-7600,-7400,5400,-950,-7850
8723,13100,5200,0,-2700,1700,17300
8724,400,-5300,0,-2900,1950,-5850
8725,-2000,6800,12000,-1000,-950,14850
8726,-2100,-4500,0,11000,0,4400
8727,-4500,-3000,0,-2900,1950,-8450
8728,400,5900,0,-1000,-950,4350
8729,-4400,-1200,0,9100,2900,6400
8730,9900,5900,0,-1000,0,14800
8731,-3400,900,-1200,-1800,0,-5500
8732,12600,8900,-1200,-800,0,19500
8733,-2500,100,-3000,-800,0,-6200
8734,9900,10000,4700,6600,-1200,30000
8735,-1900,-2900,0,200,-1200,-5800
8736,1200,-6900,-1200,-800,0,-7700
8737,13400,9000,0,0,-950,21450
8738,-900,-700,-1800,10200,-2150,4650
8739,-5100,1000,3500,-8300,2900,-6000
8740,1300,6700,0,-3900,1950,6050
8741,-3300,-700,0,-2000,0,-6000
8742,-5300,13100,0,-1000,0,6800
8743,-800,-6600,0,0,0,-7400
8744,7400,-2700,0,11000,0,15700
8745,-2700,9800,0,-1000,0,6100
8746,-5000,100,0,11000,0,6100
8747,-3500,9000,0,0,0,5500
8748,10900,-4600,0,-1800,-1200,3300
8749,-3300,11200,0,-800,-1200,5900
8750,7600,200,0,0,-950,6850
8751,-300,-6100,0,-800,-1200,-8400
8752,8500,13000,0,-4900,1950,18550
8753,1300,-4500,-1200,1600,-3350,-6150
8754,6800,11500,0,-4900,1950,15350
8755,-3000,-3500,-1800,-1000,-950,-10250
8756,11300,-6700,4700,-8500,1950,2750
8757,-3500,8300,-10200,18300,1950,14850
8758,6600,-1900,0,-1000,-950,2750
8759,-500,7600,0,-3900,2900,6100
8760,-5900,-600,12000,-2900,1950,4550
8761,10000,-4500,0,12000,0,17500
8762,-3600,9000,0,-2000,0,3400
8763,-1000,-2200,0,-3000,0,-6200
8764,9400,12100,-1200,13600,-2400,31500
8765,10900,-2200,0,-2800,-1200,4700
8766,0,11200,0,200,-2150,9250
8767,-3500,300,0,0,0,-3200
8768,10100,-3700,-1200,-5700,1000,500
8769,-2400,7200,-900,200,-2150,1950
8770,-400,-5300,1000,-7700,2900,-9500
8771,-2700,-2200,2800,500,-8250,-9850
8772,8600,-1600,0,200,-2150,5050
8773,-1300,8400,-1200,-3700,14900,17100
8774,10100,-2100,0,8000,-950,15050
8775,-3400,11300,0,-1000,0,6900
8776,-2900,-2000,-1200,6300,1950,2150
8777,9000,7800,-3000,200,-950,13050
8778,-6800,-600,4700,-9500,2900,-9300
8779,-4800,-4400,0,11000,0,1800
8780,9900,7600,0,-2000,0,15500
8781,300,-7600,0,11400,-2400,1700
8782,4200,-2900,0,0,0,1300
8783,-2700,9800,0,-2000,0,5100
8784,-5300,-3000,0,12000,-950,2750
8785,8700,100,0,0,0,8800
8786,-2800,9900,0,-2900,1950,6150
8787,8700,-700,-1200,-3700,1950,5050
8788,-6500,9400,0,-2000,0,900
8789,10500,-6000,-1800,-2000,0,700
8790,-4200,-600,4700,7600,-1200,6300
8791,1800,12400,0,-1000,0,13200
8792,-1600,-6700,-10200,10200,0,-8300
8793,7300,7700,0,200,-1200,14000
8794,-2900,-6100,12000,-2000,0,1000
8795,9100,-6000,0,0,0,3100
8796,-7100,11800,0,0,-950,3750
8797,9000,-5300,0,-800,-2150,750
8798,7500,-2800,0,-3900,2900,3700
8799,-2700,9900,-1200,-3700,1950,4250
8800,9800,-4400,-1200,-800,0,3400
8801,-3500,9100,-1800,-800,-1200,1800
8802,8500,-3100,4700,5400,0,15500
8803,-5000,12000,0,400,-2400,5000
8804,6600,-2100,0,0,-950,3550
8805,-1200,7500,0,12000,-950,17350
8806,7600,-3100,0,-2900,2900,4500
8807,-8500,500,0,-3900,1000,-10900
8808,4300,12300,-1200,200,-950,14650
8809,600,-4600,0,-2900,2900,-4000
8810,6000,12100,-1200,9300,1950,28150
8811,-1900,-3000,-2100,200,0,-6800
8812,11700,-2100,-1400,-4400,0,3800
8813,-2800,8300,-8300,7400,0,4600
8814,4500,300,1000,-2600,-1200,2000
8815,-6800,12200,14800,-3800,0,16400
8816,9200,-1300,0,-3000,0,4900
8817,-5100,200,-10200,8200,0,-6900
8818,5900,-2200,0,-1000,0,2700
8819,-2000,-2100,12000,-2000,0,5900
8820,6100,-600,0,-800,-1200,3500
8821,9300,-2100,0,-1000,0,6200
8822,-3600,8200,-1200,-800,0,2600
8823,7500,-1200,-900,10000,-950,14450
8824,-3000,-4300,-200,-6500,1950,-12050
8825,6900,100,2800,-2800,-950,6050
8826,-4100,10400,0,-4900,2900,4300
8827,5700,-1800,0,0,0,3900
8828,-7200,10900,-10200,21200,0,14700
8829,-2700,-2200,0,200,-1200,-5900
8830,6100,-500,0,0,0,5600
8831,13900,-6800,12000,-2000,0,17100
8832,-8300,200,0,-2000,0,-10100
8833,10700,6700,0,-800,-1200,15400
8834,-900,-2300,-1200,-800,0,-5200
8835,10200,11300,-900,1200,-2150,19650
8836,-2700,200,3800,-6600,0,-5300
8837,5300,-700,0,-3900,1950,2650
8838,-6700,13000,0,-2000,-950,3350
8839,4200,200,0,-5900,2900,1400
8840,-3700,-2000,0,11200,-1200,4300
8841,8500,-2200,0,-1800,-1200,3300
8842,-1300,-4500,-1200,12200,-950,4250
8843,7000,100,-1200,-1800,0,4100
8844,1000,-7600,-2100,-4500,750,-12450
8845,9300,-3000,1000,7200,0,14500
8846,-2800,9800,2800,-6700,1000,4100
8847,8600,-800,0,-1000,0,6800
8848,2200,-4600,0,7100,1950,6650
8849,6600,12300,0,0,-950,17950
8850,-1800,-3000,-1200,-4500,1700,-8800
8851,6600,10800,0,11000,0,28400
8852,-3000,-5200,-1800,-2000,0,-12000
8853,9300,-3000,1900,8200,0,16400
8854,-400,6700,2800,-4600,-1200,3300
8855,9200,-2200,-1200,400,-1200,5000
8856,-5800,12100,0,10000,-950,15350
8857,8500,200,0,-1000,0,7700
8858,9300,9800,0,-1000,-950,17150
8859,-2800,-2200,-1200,8300,1950,4050
8860,13200,-5300,0,-3700,1700,5900
8861,-1300,-4500,1000,-3800,0,-8600
8862,6500,-1900,1900,-3800,-950,1750
8863,-3600,7500,0,10000,0,13900
8864,9600,-3500,0,-4700,750,2150
8865,-11100,12400,0,-3000,-950,-2650
8866,8600,-2200,0,10300,1700,18400
8867,-400,-5300,0,-2000,0,-7700
8868,11000,9800,-10200,8200,-950,17850
8869,-5000,-700,0,0,0,-5700
8870,-6200,9000,-1200,-4700,1950,-1150
8871,8900,-3400,12000,-2000,0,15500
8872,7800,12100,0,-2900,1950,18950
8873,-2700,-3100,-1200,-2800,0,-9800
8874,8400,-2200,-1200,12200,0,17200
8875,900,2100,-1800,0,0,1200
8876,6700,-2200,4700,5600,-1200,13600
8877,-5900,300,0,0,0,-5600
8878,9200,-2900,0,-1000,0,5300
8879,-4400,9900,0,-1000,0,4500
8880,9800,7700,0,11000,0,28500
8881,-5800,-600,0,-1000,0,-7400
8882,8400,-2100,0,-1000,0,5300
8883,-6800,11500,0,0,0,4700
8884,11000,-2300,0,0,0,8700
8885,-2900,-2100,0,0,0,-5000
8886,8700,12000,0,0,0,20700
8887,-1900,-2200,0,0,0,-4100
8888,9400,100,0,0,0,9500
8889,-2800,-3000,0,0,0,-5800
8890,13200,-4400,0,-1000,0,7800
8891,-7800,10700,0,-800,-1200,900
8892,8400,-1400,-2100,1600,-2400,4100
8893,-3700,-2200,1000,-5800,0,-10700
8894,8200,7500,2800,-3600,-2150,12750
8895,4400,-10000,-1200,-800,-950,-8550
8896,11500,-5300,0,-4700,750,2250
8897,-5300,9100,-1200,-3700,1950,850
8898,9200,-2100,-900,11000,-950,16250
8899,-1300,-4500,-2600,-5100,1950,-11550
8900,8500,9100,1900,5300,1950,26750
8901,-2800,-2800,1000,-5800,-950,-11350
8902,10900,9800,2800,-6700,2900,19700
8903,-5800,0,0,17300,-8250,3250
8904,7700,200,0,-1000,0,6900
8905,9300,9800,0,-1000,0,18100
8906,2100,-5400,0,-1800,10800,5700
8907,9200,9800,-10200,21200,0,30000
8908,-5200,200,0,0,0,-5000
8909,-1000,9000,12000,-800,-1200,18000
8910,12400,-5300,-1200,200,0,6100
8911,-5900,1000,-900,-3000,-950,-9750
8912,11800,8900,1000,-2600,-1200,17900
8913,8500,100,2800,-7700,1950,5650
8914,-1000,-2200,-1200,-1800,0,-6200
8915,11000,9800,-1200,-2700,1950,18850
8916,-900,100,-1800,9000,0,6400
8917,8600,-700,4700,-5400,-1200,6000
8918,-1200,-2000,0,-1000,0,-4200
8919,7600,10000,0,12000,-950,28650
8920,-100,-2300,0,-1000,0,-3400
8921,-1900,-2900,0,9100,1950,6250
8922,-5200,200,0,-2700,750,-6950
8923,8400,9900,0,11000,0,29300
8924,1000,-7500,0,0,0,-6500
8925,-3400,200,0,0,0,-3200
8926,10100,-2200,0,0,0,7900
8927,-5900,-1600,0,-2000,0,-9500
8928,-1200,8400,0,-1000,0,6200
8929,12200,-5200,0,-2000,0,5000
8930,-2000,9200,0,200,-1200,6200
8931,8300,-1100,0,400,-2400,5200
8932,-5900,-700,-1200,12400,-2150,2450
8933,-5900,12100,0,200,-2150,4250
8934,-3500,-2200,0,-3900,1950,-7650
8935,-1900,9700,0,-2700,750,5850
8936,8400,-2300,0,0,0,6100
8937,6400,-5300,0,-4900,1000,-2800
8938,-3100,-4200,-10200,10200,-950,-8250
8939,7500,-2100,0,-4700,1700,2400
8940,-3500,9000,12000,-3900,1950,15550
8941,11900,-2300,-10200,8200,-1900,5700
8942,-6900,11500,-1200,-2700,2900,3600
8943,11600,-4500,10200,-2900,1950,16350
8944,-300,7400,4700,-7600,-950,3250
8945,9300,-3100,0,8100,2900,17200
8946,-4200,-700,0,-1800,-1200,-7900
8947,8500,12200,0,-1000,0,19700
8948,6100,100,-1200,400,-1200,4200
8949,-5000,11300,0,9000,0,15300
8950,3300,1200,0,-2000,-950,1550
8951,-5800,0,0,-1000,0,-6800
8952,9300,-2300,0,-3900,1950,5050
8953,1300,-4600,0,12000,-950,7750
8954,9400,0,0,-4900,2900,7400
8955,-1100,-3800,0,-1000,0,-5900
8956,6200,13000,0,0,0,19200
8957,9900,-2100,0,11200,-1200,17800
8958,-3500,200,0,-1000,0,-4300
8959,7000,100,0,0,0,7100
8960,-100,-2300,0,12000,0,9600
8961,10300,-800,0,0,0,9500
8962,-1800,100,-1200,200,0,-2700
8963,8300,10000,-900,0,0,17400
8964,-6700,300,1000,-2800,0,-8200
8965,-2000,-4600,1600,-2600,0,-7600
8966,-4400,-500,0,0,0,-4900
8967,12200,-6800,0,0,0,5400
8968,-1300,-5300,0,0,0,-6600
8969,5700,10100,0,0,0,15800
8970,-5300,-2800,0,0,0,-8100
8971,300,-6700,0,0,0,-6400
8972,9300,8200,0,-800,-1200,15500
8973,-2000,-3700,0,200,-1200,-6700
8974,9800,6800,0,200,-1200,15600
8975,-2600,200,0,0,-950,-3350
8976,6700,-3100,-1200,200,-950,1650
8977,-1800,9800,-900,-2900,1950,6150
8978,7700,100,-200,-6500,1950,3050
8979,-2600,12100,-8600,7600,-950,7550
8980,10100,-2300,-1800,-3900,2900,5000
8981,1300,-4500,16700,-9500,1950,5950
8982,8500,11200,-1200,200,0,18700
8983,700,-2300,0,10000,0,8400
8984,8500,300,0,-1000,0,7800
8985,-900,8900,0,11000,0,19000
8986,-300,-3000,-1200,-1800,0,-6300
8987,-9400,13300,-2100,-800,0,1000
8988,400,-4400,-6400,3800,-1200,-7800
8989,5200,-700,0,-1000,0,3500
8990,-3600,-2300,12000,-1000,0,5100
8991,10000,-4500,0,0,0,5500
8992,-2800,9100,0,-2000,0,4300
8993,5900,400,0,-800,-1200,4300
8994,-1000,-2200,0,-800,-1200,-5200
8995,-6700,12200,0,-2000,0,3500
8996,11200,-7300,-1200,13200,-950,14950
8997,-3600,-2100,-900,-4700,750,-10550
8998,9500,4800,1000,-2800,-950,11550
8999,-5900,300,2800,-6700,2900,-6600
9000,6700,-2900,0,-1000,-950,1850
9001,-1800,9700,0,10000,-950,16950
9002,8300,9100,0,-2900,2900,17400
9003,-1200,-4400,0,-3900,1950,-7550
9004,10100,-2200,0,10200,-1200,16900
9005,-3200,10400,0,-3000,0,4200
9006,8400,-1300,0,0,0,7100
9007,-1200,9900,-1200,10200,0,17700
9008,9200,-2900,-1200,-1800,0,3300
9009,-4200,200,-2100,400,-1200,-6900
9010,-1300,7600,1900,-6800,0,1400
9011,11800,-2200,700,8600,-10200,8700
9012,-5100,-700,-900,-1800,-2150,-10650
9013,10300,0,-1400,6800,1800,17500
9014,-1600,12000,2800,-5700,1950,9450
9015,10200,0,-1800,-2000,-950,5450
9016,-5100,100,4700,-7300,13700,6100
9017,6200,0,0,-1000,0,5200
9018,-2600,100,-10200,22200,-950,8550
9019,-4600,-1900,0,-1000,0,-7500
9020,6200,0,12000,-2900,1950,17250
9021,-3200,-800,0,-4900,1950,-6950
9022,8400,1000,0,11600,-12600,8400
9023,-3300,100,0,-2000,0,-5200
9024,5100,100,0,-3000,-950,1250
9025,-3200,0,-1200,400,10800,6800
9026,6800,100,0,-4900,1950,3950
9027,5100,300,0,0,-950,4450
9028,-7600,-600,0,-4900,2900,-10200
9029,11200,-5900,0,-1000,0,4300
9030,-3000,-5300,0,11000,0,2700
9031,6700,-2100,0,-3000,0,1600
9032,-4700,7000,0,-2000,0,300
9033,7000,-700,0,10200,-1200,15300
9034,2200,-4600,0,-3000,0,-5400
9035,7900,11200,0,-2000,-950,16150
9036,-3700,-2000,0,8200,-10200,-7700
9037,6600,9900,-1200,-3500,750,12550
9038,2000,-6900,-900,-2000,-950,-8750
9039,-3600,9000,3800,-8500,14900,15600
9040,9100,-2200,0,-2000,0,4900
9041,-5100,-600,0,-2000,0,-7700
9042,7000,12000,0,10200,-1200,28000
9043,-2700,-2900,-1200,200,0,-6600
9044,10900,9800,0,0,-950,19750
9045,-1900,-3000,0,19200,-10200,4100
9046,10100,-2200,-1200,-3700,1950,4950
9047,-3900,8500,0,-1000,-950,2650
9048,10300,-1500,-1800,-4900,14900,17000
9049,-2000,-1200,3500,-6400,0,-6100
9050,11100,9700,0,12200,-1200,31800
9051,1200,-4600,0,-2000,0,-5400
9052,12000,-800,0,200,-1200,10200
9053,-1800,0,0,11000,0,9200
9054,9600,12000,0,-1000,-950,19650
9055,-4500,300,0,0,0,-4200
9056,-4200,100,0,-3900,1950,-6050
9057,-2800,-2100,0,-2000,-950,-7850
9058,11000,-2200,0,-2900,2900,8800
9059,-5400,-2700,0,-800,-1200,-10100
9060,-4200,-2200,0,11000,0,4600
9061,9200,8400,0,-1000,0,16600
9062,-4300,-1400,-1200,-2800,0,-9700
9063,-300,-2200,-3000,400,-1200,-6300
9064,11100,10500,4700,-7600,0,18700
9065,9200,-1300,0,11000,-950,17950
9066,-1900,9800,0,-1000,-950,5950
9067,11800,-2300,0,-4700,1700,6500
9068,-3500,100,0,12000,-950,7650
9069,-3600,-3000,0,-3900,2900,-7600
9070,2500,-8900,-10200,8200,0,-8400
9071,9300,-3000,-1200,-600,-1200,3300
9072,-1300,6900,9000,200,0,14800
9073,-7800,300,4700,-5400,-2150,-10350
9074,7600,9800,-1200,-800,-950,14450
9075,-4500,-2800,-2400,-2500,2900,-9300
9076,-4900,100,100,-6700,1950,-9450
9077,9200,9700,1000,7200,0,27100
9078,-4100,100,3500,-5200,-1200,-6900
9079,11700,9800,-2100,-1800,0,17600
9080,-4400,-3600,-200,10400,-950,1250
9081,9100,-1300,2800,-3800,0,6800
9082,-2700,-2100,0,9700,-1650,3250
9083,6800,11400,0,-2000,0,16200
9084,-4300,-2100,0,-2700,-200,-9300
9085,11800,-2300,0,12000,0,21500
9086,-3500,100,0,-6900,1950,-8350
9087,12700,9700,-3300,2400,-1900,19600
9088,9300,100,1900,5300,2900,19500
9089,-2900,-6200,1900,-6700,1950,-11950
9090,-2100,-2100,0,0,-950,-5150
9091,6700,9900,0,8100,2900,27600
9092,-500,-4300,0,0,0,-4800
9093,-3500,9700,0,12200,-1200,17200
9094,-4900,-700,0,0,0,-5600
9095,7700,0,0,0,0,7700
9096,-100,9700,0,0,0,9600
9097,6800,100,0,0,0,6900
9098,-6200,-2800,-1200,200,0,-10000
9099,9500,-6400,-1800,-2000,0,-700
9100,-3700,-2100,4700,-5400,-1200,-7700
9101,7100,11300,0,-1000,0,17400
9102,-6800,300,-1200,-1800,-950,-10450
9103,7400,-2200,-1200,13200,0,17200
9104,1400,5800,-900,-2000,-950,3350
9105,6700,-1200,3800,-8300,750,1750
9106,-5100,200,0,-4900,2900,-6900
9107,11900,-2300,0,-1000,0,8600
9108,-7700,11500,0,11200,-1200,13800
9109,9300,-2100,0,-3000,0,4200
9110,-1900,-2200,0,1200,-1200,-4100
9111,7500,9900,0,11000,-950,27450
9112,400,-5400,0,-1000,-950,-6950
9113,8500,-2100,0,-2700,1700,5400
9114,600,-3100,0,-2900,1950,-3450
9115,12000,11200,0,12000,-950,34250
9116,-1400,-3500,0,-1000,0,-5900
9117,8600,0,0,-2900,1950,7650
9118,-5000,11200,0,0,-950,5250
9119,7800,100,0,-5900,2900,4900
9120,-1900,9800,-1200,400,-1200,5900
9121,-1800,100,0,-1600,-2400,-5700
9122,6700,-2000,0,12200,-1200,15700
9123,500,-4500,0,0,0,-4000
9124,10200,0,0,-1800,-2150,6250
9125,-100,-3100,-1200,-1300,-450,-6150
9126,9300,300,-900,-1000,-1900,5800
9127,-1900,9800,1000,4500,1700,15100
9128,-1900,-2200,2800,-5700,1000,-6000
9129,-2300,-5300,0,-1000,0,-8600
9130,500,-4500,0,-3900,1000,-6900
9131,7800,11300,0,12000,-950,30150
9132,-1900,-2100,0,-5900,2900,-7000
9133,-400,6700,-1200,-2700,1950,4350
9134,-4200,-600,0,10000,-950,4250
9135,6500,-1000,0,-4900,2900,3500
9136,-4900,12100,0,-2900,1950,6250
9137,-2500,-800,0,10000,0,6700
9138,10300,12000,0,-1000,0,21300
9139,9100,-2100,-1200,11200,0,17000
9140,-1000,-3000,-1800,-1000,0,-6800
9141,9000,-3500,3500,-5400,0,3600
9142,-4400,-2300,0,-1000,0,-7700
9143,-200,-3100,0,-1000,0,-4300
9144,9300,-800,0,-2000,0,6500
9145,-1000,9800,0,13200,-1200,20800
9146,10900,-2100,0,-1000,0,7800
9147,-5400,-1800,0,0,0,-7200
9148,-4900,11200,-2400,12400,0,16300
9149,-800,-6700,-1800,-1000,0,-10300
9150,-4300,-2200,1100,-4000,0,-9400
9151,10100,9000,-900,-1000,0,17200
9152,-3600,200,-1100,-2600,0,-7100
9153,6000,200,4700,-6600,0,4300
9154,-2000,7500,1900,6400,-10200,3600
9155,7500,-2100,0,-1000,0,4400
9156,-3500,-2900,0,-1000,0,-7400
9157,11600,-5300,0,-1000,12000,17300
9158,-1100,9800,0,10200,-1200,17700
9159,9300,-500,0,0,0,8800
9160,-5100,12100,0,200,-1200,6000
9161,7700,-2200,0,-1000,-950,3550
9162,3600,5100,-1200,-800,-950,5750
9163,-900,100,-1800,-4700,1700,-5600
9164,3400,-400,3500,-8300,1950,150
9165,8800,-800,0,-2000,-950,5050
9166,-6900,13300,0,200,-1200,5400
9167,-3700,-2000,0,8100,1950,4350
9168,-2500,-6600,-1200,400,-2150,-12050
9169,9300,-3100,0,7100,2900,16200
9170,-3300,-800,-3000,9400,-10200,-7900
9171,10200,9700,4700,-7600,-950,16050
9172,8300,-2100,-1200,200,11050,16250
9173,-6600,12000,0,-3900,2900,4400
9174,10100,-2200,100,-8700,1950,1250
9175,-1800,200,400,9600,0,8400
9176,-2700,-3000,-900,0,0,-6600
9177,7700,200,1000,8200,0,17100
9178,8600,12000,2800,-4600,-1200,17600
9179,500,-4600,0,-1000,0,-5100
9180,9300,0,0,11000,0,20300
9181,400,-5400,-1200,-2800,0,-9000
9182,10400,0,0,0,0,10400
9183,-2600,12200,0,-1000,0,8600
9184,-8400,200,0,11000,0,2800
9185,-2800,-2100,0,-1000,0,-5900
9186,7800,-800,0,-1000,0,6000
9187,-3300,0,0,0,0,-3300
9188,11100,12000,0,-3000,0,20100
9189,-900,100,0,9200,-1200,7200
9190,6900,100,-2400,2400,0,7000
9191,-800,0,-1800,-2000,-950,-5550
9192,8600,100,4700,-5400,-2150,5850
9193,-5400,-2000,0,-5900,2900,-10400
9194,300,-6900,0,-2000,-950,-9550
9195,11800,-3100,0,9300,1700,19700
9196,-1800,200,0,-3800,-1200,-6600
9197,-3300,0,-1200,1400,-2150,-5250
9198,11100,12100,-1800,11000,-950,31450
9199,-3300,0,4700,-8500,2900,-4200
9200,-1300,-2000,-10200,5300,1000,-7200
9201,5300,-500,0,-2900,1950,3850
9202,-400,-4500,0,-1000,-950,-6850
9203,-1000,9700,12000,-2900,2900,20700
9204,-3400,-800,0,11000,0,6800
9205,7800,100,0,0,0,7900
9206,-1200,-2100,0,11000,0,7700
9207,9200,9800,-1200,1200,0,19000
9208,-2400,0,0,-1000,0,-3400
9209,7600,200,0,0,0,7800
9210,-9300,400,0,-1000,0,-9900
9211,-5300,-2000,-2400,-1600,0,-11300
9212,11600,-5400,-2100,-2800,0,1300
9213,-2600,-2300,-200,-2600,0,-7700
9214,9300,100,1000,-3800,0,6600
9215,-5000,11300,4700,-7200,-2400,1400
9216,10900,-2100,-1200,400,-1200,6800
9217,-4300,12200,0,10000,0,17900
9218,11000,-2200,100,-3800,-950,4150
9219,-2600,0,2800,6200,0,6400
9220,5800,-2900,-1200,-4500,750,-2050
9221,-3300,-3600,0,1400,-3350,-8850
9222,10900,-5400,0,17300,-7300,15500
9223,-4600,-3000,-1200,-1800,-950,-11550
9224,1100,5200,-3000,-800,-950,1550
9225,8300,-3000,4700,-8500,13950,15450
9226,-4600,-2800,0,8100,1950,2650
9227,-5200,9100,0,-1000,-950,1950
9228,-6800,1200,0,-3900,2900,-6600
9229,6700,-2000,0,-4700,750,750
9230,-4400,9100,0,11000,0,15700
9231,8500,-2300,0,-1000,0,5200
9232,-2100,7600,0,12000,0,17500
9233,10700,-4400,0,-2000,0,4300
9234,-4200,11200,0,-3000,0,4000
9235,8900,-5900,0,0,0,3000
9236,6700,-1200,0,-3800,-1200,500
9237,-4400,9900,-1200,200,0,4500
9238,10100,-3100,-1800,12000,0,17200
9239,-6700,300,3500,-8400,-950,-12250
9240,8700,12000,-1200,400,-2150,17750
9241,-6600,100,-900,-3700,1700,-9400
9242,6600,10000,3800,-10500,1950,11850
9243,-5000,-700,0,9200,-10200,-6700
9244,10500,-6800,0,12200,-2150,13750
9245,-2000,-2100,0,-3000,12000,4900
9246,11000,8100,-2400,10700,750,28150
9247,-7200,-1100,0,200,-2150,-10250
9248,10400,5500,-1800,-5900,1950,10150
9249,-7000,-2800,3500,-4400,-950,-11650
9250,10200,-3100,0,-3900,2900,6100
9251,-4200,12100,0,10000,-950,16950
9252,11400,-6700,0,-4700,1700,1700
9253,400,-5400,-2400,12600,-1200,4000
9254,8600,12200,-1800,-1000,0,18000
9255,-4600,9300,4700,-5600,-950,2850
9256,7800,100,0,12200,-2150,17950
9257,-900,-2300,0,-4900,1950,-6150
9258,11800,8900,0,-2900,1950,19750
9259,0,-1600,0,9000,0,7400
9260,7700,1800,0,-1000,-950,7550
9261,-3500,12200,-1200,-5700,2900,4700
9262,7500,-2000,-900,-4900,1950,1650
9263,-1000,-2300,-3300,12600,-1200,4800
9264,4200,-500,4700,-7600,0,800
9265,7700,-2100,-3000,-800,0,1800
9266,-4600,9100,3500,3600,0,11600
9267,8000,-4300,-1800,200,-1200,900
9268,-4400,-2200,4700,-7600,0,-9500
9269,-400,-4500,0,11000,-950,5150
9270,10100,-3100,-1200,-1600,-1200,3000
9271,-400,7600,-10200,18300,1950,17250
9272,7800,-1600,0,0,-950,5250
9273,-2800,10800,12000,-4900,2900,18000
9274,13000,-7600,0,0,0,5400
9275,8000,-4300,0,11000,0,14700
9276,-5300,9800,0,-1000,0,3500
9277,7700,-3800,-1200,200,0,2900
9278,-800,6200,-3000,200,0,2600
9279,-200,-5400,4700,-7600,0,-8500
9280,6600,-2800,0,0,0,3800
9281,-3500,9800,0,-4000,0,2300
9282,7800,-1600,0,-2000,0,4200
9283,-5000,13000,0,13200,-1200,20000
9284,9200,-2300,0,-2000,0,4900
9285,-4200,100,0,-1000,-950,-6050
9286,7400,10000,0,-1000,0,16400
9287,-4400,-3000,0,-4900,1950,-10350
9288,12500,7500,0,12000,-950,31050
9289,-2100,-2200,0,-4900,2900,-6300
9290,6800,9200,-1200,-600,-1200,13000
9291,-2500,0,-900,-1000,0,-4400
9292,10200,100,1400,5800,0,17500
9293,-500,7600,0,0,0,7100
9294,9600,-800,-1800,11000,0,18000
9295,-5200,300,2300,-4200,0,-6800
9296,8400,9700,-2100,400,-1200,15200
9297,-2800,-2000,1900,-3800,0,-6700
9298,6900,100,1900,-3800,0,5100
9299,500,-5300,0,12200,-2150,5250
9300,10900,-2200,0,-1000,-950,6750
9301,-4300,11400,0,-2900,2900,7100
9302,7000,-700,0,7100,1950,15350
9303,-2800,-1300,-1200,1200,0,-4100
9304,-3100,7800,100,-4800,0,0
9305,8400,-2100,2800,-5800,0,3300
9306,-1800,-3100,0,400,-2400,-6900
9307,7400,-2700,0,-1000,0,3700
9308,-3700,10700,-1200,10400,-2150,14050
9309,11700,-5400,0,-1000,-950,4350
9310,-5500,-2100,0,-4900,2900,-9600
9311,1300,6600,0,7100,1000,16000
9312,10300,-3100,-1200,400,-2150,4250
9313,-8000,9900,1000,2500,-7300,-1900
9314,-3600,-2100,1900,-6500,750,-9550
9315,6000,11500,-1200,-800,0,15500
9316,-2800,-2000,0,0,11050,6250
9317,6000,-2200,0,11000,0,14800
9318,-4200,12200,-11400,7500,1950,6050
9319,9900,-4500,0,0,-950,4450
9320,-4700,-5100,13000,-5700,2900,400
9321,5200,300,1900,-3800,0,3600
9322,-2700,-3000,0,0,0,-5700
9323,7100,12000,0,0,0,19100
9324,9200,-2100,0,12000,0,19100
9325,1100,7700,0,-1000,0,7800
9326,-2600,-3100,0,-1000,0,-6700
9327,10900,-2100,0,1200,-1200,8800
9328,6900,10600,-1200,-800,0,15500
9329,-2000,-1300,0,-2000,0,-5300
9330,-3400,0,0,-2000,0,-5400
9331,7500,10000,0,-4000,0,13500
9332,-3500,200,0,0,0,-3300
9333,8300,-1900,-1200,10200,0,15400
9334,-2200,-5300,0,0,0,-7500
9335,9300,-2100,-1800,-1000,0,4400
9336,-3500,-2300,4700,-5600,0,-6700
9337,11000,9000,0,-3000,0,17000
9338,500,-4600,0,-2000,0,-6100
9339,9100,9200,0,-1000,0,17300
9340,-1400,-4500,0,10000,0,4100
9341,11600,6700,0,-1000,0,17300
9342,-4000,-800,-1200,11200,0,5200
9343,-4300,-600,0,-1000,0,-5900
9344,-4500,10900,0,-1000,0,5400
9345,5700,-2000,-1200,-800,0,1700
9346,-1700,9700,-900,-1000,0,6100
9347,7900,-800,1000,8200,0,16300
9348,-4400,300,1600,-2600,0,-5100
9349,6700,10000,0,-1000,0,15700
9350,-4500,-2100,-1200,-800,0,-8600
9351,3400,300,-1800,-800,-1200,-100
9352,-5300,-2700,3500,7600,0,3100
9353,5300,100,0,200,-2150,3450
9354,1100,-6800,0,-2000,0,-7700
9355,13000,5200,0,-3900,1950,16250
9356,2900,-7700,0,13200,-2150,6250
9357,10300,-800,0,-5900,2900,6500
9358,-2700,200,-2400,400,-950,-5450
9359,5100,11600,-900,-1000,0,14800
9360,-6700,200,3800,-11500,1950,-12250
9361,13400,6600,0,-2000,-950,17050
9362,-6100,1100,-1200,8300,2900,5000
9363,8300,-2100,-1800,0,0,4400
9364,-5300,9100,4700,3400,0,11900
9365,7500,-2000,0,-2000,0,3500
9366,-8600,12400,0,-1000,0,2800
9367,8300,-2000,0,10000,0,16300
9368,-2600,-2200,0,-2000,0,-6800
9369,10700,-5300,-1200,11200,0,15400
9370,6600,-1900,0,0,0,4700
9371,-1400,6900,0,-3000,0,2500
9372,-900,-3100,0,-2600,-2400,-9000
9373,9000,7500,0,0,0,16500
9374,400,-5200,0,-1000,-950,-6750
9375,8300,10000,0,11000,-950,28350
9376,8500,-3000,-1200,-2500,1700,3500
9377,300,4300,-1800,-2900,1950,1850
9378,-4400,-1200,3500,-8400,0,-10500
9379,7600,9000,0,-1000,0,15600
9380,-500,-5300,0,11200,-1200,4200
9381,7500,9900,0,-1000,0,16400
9382,6100,-500,0,0,-950,4650
9383,-4500,-2000,0,11000,0,4500
9384,-3400,9800,0,-1000,-950,4450
9385,7300,-1900,0,9500,500,15400
9386,-10100,11300,0,-2900,1950,250
9387,6100,100,0,0,0,6200
9388,-500,-4400,0,0,-950,-5850
9389,6700,9900,0,-2000,-950,13650
9390,-4500,-2900,0,-2900,2900,-7400
9391,10000,-4600,-1200,-3700,1950,2450
9392,-7600,300,-11100,9400,-1200,-10200
9393,10200,8900,1000,-2400,-2400,15300
9394,-2000,-2300,14800,-4800,0,5700
9395,10800,-4600,-1200,1200,-950,5250
9396,-2700,11400,0,-2800,-1200,4700
9397,10800,-4600,0,-2900,1950,5250
9398,-300,-2100,0,9100,1950,8650
9399,7700,11300,0,-2800,-2150,14050
9400,6800,-2900,0,-1800,-2150,-50
9401,-500,7500,-1200,10300,2900,19000
9402,4300,200,-1800,-7900,1000,-4200
9403,-4400,-2100,3500,7200,-13550,-9350
9404,8400,-2200,0,-3900,2900,5200
9405,-5100,10600,-11400,6500,13000,13600
9406,7500,-1200,0,-2000,0,4300
9407,-900,-3100,11100,-4900,1950,4150
9408,7700,13000,3800,-5400,-2150,16950
9409,-3400,100,0,-4900,2900,-5300
9410,11000,-2200,0,9000,0,17800
9411,-2700,200,0,-2000,0,-4500
9412,4400,-600,0,11000,0,14800
9413,9900,-5100,0,-3000,0,1800
9414,-5800,12100,0,13200,-1200,18300
9415,7600,1100,0,-1000,0,7700
9416,-5400,-2100,0,-2000,-950,-10450
9417,6900,-3000,-1200,-600,-2150,-50
9418,-3400,200,0,-3900,2900,-4200
9419,11000,8100,0,8300,750,28150
9420,7700,1900,0,-2000,0,7600
9421,-2900,-2900,0,-2000,-950,-8750
9422,10800,-4500,0,-1800,-1200,3300
9423,-4200,100,-1200,-2700,1950,-6050
9424,9400,100,-900,11200,-2150,17650
9425,1300,7400,1000,-8700,2900,3900
9426,8600,-800,1600,-2600,-950,5850
9427,600,-2200,0,-4000,0,-5600
9428,11100,0,0,8100,1950,21150
9429,11800,8900,0,-1000,-950,18750
9430,-5200,1100,0,6500,-8500,-6100
9431,-1700,-3100,0,10000,0,5200
9432,-900,0,-2400,-600,0,-3900
9433,-1900,9700,-1800,-1000,12000,17000
9434,-2700,0,4700,5400,0,7400
9435,7300,-3600,0,-1000,0,2700
9436,-7200,-400,0,9400,-11400,-9600
9437,10700,-5100,-2100,1400,-1200,3700
9438,-400,-4500,1900,-2800,11050,5250
9439,-1200,6700,1900,-3600,-1200,2600
9440,-2100,-5100,-1200,-3300,-450,-12150
9441,-100,-3100,-1200,200,-1900,-6100
9442,11300,5300,1000,-5700,2900,14800
9443,-5800,100,1900,6300,1950,4450
9444,8100,6800,0,-2000,-1900,11000
9445,-3800,-4400,0,-3900,2900,-9200
9446,-2600,9000,0,8100,1950,16450
9447,11600,-5300,0,-2000,-950,3350
9448,1000,-6700,0,-3900,2900,-6700
9449,10900,8900,0,19200,-10200,28800
9450,-5400,-2000,-2400,1400,0,-8400
9451,5200,10800,-1800,-2000,12000,24200
9452,-2200,-3700,4700,-7600,0,-8800
9453,-300,-4600,-1200,400,-1200,-6900
9454,5300,11300,-1200,-1600,-1200,12600
9455,-1100,-2200,-1800,-3000,0,-8100
9456,10100,9000,3500,-6400,0,16200
9457,-4600,-1900,0,11000,-950,3550
9458,5300,12300,0,-5000,-950,11650
9459,-1300,-4500,0,-1700,1700,-5800
9460,5800,-2900,0,7100,1950,11950
9461,-700,5300,0,-3000,0,1600
9462,13400,-5400,-10200,8400,-1200,5000
9463,-3400,11400,0,11000,0,19000
9464,5200,-500,0,200,-2150,2750
9465,-500,-3600,10800,-1800,0,4900
9466,11000,8100,0,-6900,1950,14150
9467,-1900,-1300,-1800,1400,-2400,-6000
9468,11700,9100,4700,2500,1950,29950
9469,-5600,-2000,0,-2000,-950,-10550
9470,-900,9700,-10200,9200,-950,6850
9471,5300,200,0,-4900,2900,3500
9472,-4800,7100,12000,-2900,1950,13350
9473,-1300,-5200,0,-2000,0,-8500
9474,13900,-6000,-2400,12400,0,17900
9475,-5000,11200,-1800,-800,-1200,2400
9476,1400,-5400,700,9400,0,6100
9477,9400,12100,700,-2600,0,19600
9478,-2400,0,1000,-2800,-950,-5150
9479,10200,12200,2800,-3800,-950,20450
9480,-5200,-600,0,-4900,2900,-7800
9481,-3000,8500,-1200,9500,750,14550
9482,9600,-800,-1200,-800,0,6800
9483,-1100,-2300,-900,10000,0,5700
9484,-3400,12200,-200,-2600,0,6000
9485,10200,-2300,2800,-3600,-1200,5900
9486,0,-800,-2400,9600,-10200,-3800
9487,5800,400,-900,200,-1200,4300
9488,-3500,-2200,1000,-2400,8650,1550
9489,9000,-5000,2800,-2800,-950,3050
9490,-7800,13100,-1200,-4700,1950,1350
9491,-1200,-5200,0,-2700,750,-8350
9492,8400,-2100,-1800,-3000,-950,550
9493,-3600,9100,4700,2700,1700,14600
9494,9100,-5300,-1200,-2700,1000,900
9495,-2700,-1400,0,-3000,-950,-8050
9496,14100,6600,0,9100,2900,32700
9497,0,-800,0,-4900,1950,-3750
9498,10200,12200,0,12000,0,34400
9499,-3600,-2100,0,-3000,0,-8700
9500,-2100,6800,0,-600,-2400,1700
9501,-4300,900,-1200,13200,0,8600
9502,-2100,-5300,-1800,-2000,0,-11200
9503,6500,-2000,4700,6400,-950,14650
9504,-3600,9200,0,-1000,-950,3650
9505,5400,0,0,-3700,1700,3400
9506,500,-4500,0,-2900,1950,-4950
9507,7900,6000,0,-1000,-950,11950
9508,-5500,-1100,0,10200,-2150,1450
9509,-1800,-3100,0,-6900,2900,-8900
9510,5000,10000,-1200,-1700,1950,14050
9511,7600,-2200,0,11000,0,16400
9512,-1800,9800,0,-1000,0,7000
9513,12500,-5400,0,9200,-10200,6100
9514,-1800,-2200,0,0,0,-4000
9515,11100,-800,0,-3000,12000,19300
9516,-900,12100,0,-1000,0,10200
9517,6800,200,-1200,-800,0,5000
9518,-2700,9800,-900,-400,-3600,2200
9519,10100,-2200,1000,6400,-10200,5100
9520,-5900,-700,2800,-2800,-950,-7550
9521,-1100,-2100,-1200,-1600,9850,3850
9522,8300,-2100,0,-2900,1950,5250
9523,-2800,8900,-1200,-3700,1950,3150
9524,-2700,-2100,-900,11000,-950,4350
9525,7500,-2300,1900,-5700,1950,3350
9526,-3500,9900,700,-8500,2900,1500
9527,12500,-4600,0,0,0,7900
9528,-5300,-300,0,21400,-11400,4400
9529,6200,-4300,0,-2000,0,-100
9530,-2800,9200,0,-1000,0,5400
9531,9300,-2200,0,-1000,11050,17150
9532,1000,4400,-1200,-800,-950,2450
9533,-5100,100,-900,-2900,2900,-5900
9534,-5300,-2700,1900,-5700,1950,-9850
9535,8400,9000,1900,9200,0,28500
9536,-2000,-3600,0,-1000,0,-6600
9537,3300,9300,0,0,0,12600
9538,-4700,-5100,0,11000,0,1200
9539,3500,-500,0,200,-1200,2000
9540,-7000,11000,0,0,0,4000
9541,8300,-2100,0,0,0,6200
9542,-1300,7600,0,-1800,-1200,3300
9543,4500,-2400,-1200,-800,0,100
9544,-2700,-500,0,1200,-1200,-3200
9545,13800,4500,0,-1000,-950,16350
9546,1100,-6800,0,-2800,-2150,-10650
9547,6000,-1300,-10200,8500,1700,4700
9548,1000,5400,0,-3700,-200,2500
9549,8100,-4400,9900,1200,0,14800
9550,-400,6600,1900,-6700,1000,2400
9551,9400,-2300,1900,-2600,-1200,5200
9552,-3000,6800,0,9100,1950,14850
9553,6600,-3000,0,-2000,-950,650
9554,12300,4400,0,-6900,1950,11750
9555,-1900,-2900,0,10500,500,6200
9556,5800,9800,-1200,200,0,14600
9557,-3100,-4100,-1200,-2800,-950,-12150
9558,8400,-2200,-3000,400,-1200,2400
9559,-2700,9000,4700,2700,750,14450
9560,8500,-2200,0,-3900,1000,3400
9561,100,4300,0,-2000,0,2400
9562,7000,100,0,-4900,1950,4150
9563,-1800,9000,-10200,21200,-950,17250
9564,8400,-2100,0,-2700,1700,5300
9565,-3700,-2800,1800,10200,0,5500
9566,7800,12900,0,0,-950,19750
9567,8300,-2900,12000,0,0,17400
9568,-1900,9900,0,-2900,1950,7050
9569,6200,100,0,-1000,-950,4350
9570,-2800,9800,0,-2900,2900,7000
9571,9200,-2900,-1200,-800,0,4300
9572,-4300,200,-2400,9600,-10200,-7100
9573,7100,12000,-1800,0,0,17300
9574,-1800,0,1400,-8200,0,-8600
9575,10100,9800,3800,-5400,10800,29100
9576,-4200,-700,-1800,-1000,0,-7700
9577,5100,1100,4700,-6400,-1200,3300
9578,-2000,-4500,-1200,12200,0,4500
9579,7700,-700,0,9200,-10200,6000
9580,500,-4500,0,0,-950,-4950
9581,9300,12100,0,0,11050,32450
9582,-5000,-1400,0,-2900,2900,-6400
9583,7500,-1900,0,-3900,1950,3650
9584,-4600,10700,0,-3000,0,3100
9585,-3400,-2200,-1200,200,0,-6600
9586,8300,-2900,-1800,10000,0,13600
9587,-900,-2300,4700,-5600,0,-4100
9588,9300,100,0,-1000,0,8400
9589,-2200,7500,0,-1000,0,4300
9590,2200,-1800,0,11000,0,11400
9591,-1500,-5100,-1200,-800,0,-8600
9592,5400,-700,0,-1000,0,3700
9593,-4200,12100,-10200,8200,0,5900
9594,9200,-3000,-1200,-800,0,4200
9595,-1100,8300,11100,-1000,0,17300
9596,11600,-5300,1000,-3800,0,3500
9597,-6700,100,2800,-2800,0,-6600
9598,10700,-5300,0,-3000,0,2400
9599,3700,4300,0,0,0,8000
9600,7400,-2800,0,11000,0,15600
9601,-4600,10900,0,200,-1200,5300
9602,9300,-3100,0,-1000,0,5200
9603,-3900,-4300,0,-1000,0,-9200
9604,1900,4500,0,-800,-1200,4400
9605,8000,-4300,0,0,0,3700
9606,-300,5800,0,0,-950,4550
9607,-6100,-2100,0,11000,0,2800
9608,-4100,12100,-1200,-2700,1950,6050
9609,7600,-3000,0,0,-950,3650
9610,3700,5100,0,-4900,2900,6800
9611,6600,-700,-1200,-800,0,3900
9612,-6000,12300,-1800,0,0,4500
9613,6700,-2000,700,-3600,0,1800
9614,-4700,7500,2800,6200,0,11800
9615,13200,-7600,-2400,1400,0,4600
9616,0,-9800,-3000,-800,0,-13600
9617,13300,6700,4700,1600,-10200,16100
9618,-4300,100,-3000,-800,0,-8000
9619,12500,5800,4700,-6600,12000,28400
9620,-5200,1100,-11400,9400,0,-6100
9621,7000,11400,-900,-1000,0,16500
9622,-4200,100,13000,-2800,0,6100
9623,0,12000,2800,-2800,0,12000
9624,11100,0,0,11000,0,22100
9625,-900,100,0,9200,-10200,-1800
9626,10100,8900,0,200,-1200,18000
9627,-2000,-1300,0,-1000,12000,7700
9628,-7700,12400,0,-1000,0,3700
9629,-5900,200,0,-2000,0,-7700
9630,10800,-4600,0,1200,-1200,6200
9631,1300,-6100,0,-1000,0,-5800
9632,8300,-1200,0,-2000,-950,4150
9633,-3400,-600,-1200,-2500,750,-6950
9634,13900,5200,0,1200,-2150,18150
9635,-1000,9000,0,-4900,2900,6000
9636,-2500,0,0,-1800,-2150,-6450
9637,-3500,12200,0,0,-950,7750
9638,6900,200,0,7100,2900,17100
9639,2200,-4600,-1200,-4700,1950,-6350
9640,11100,100,-2100,1200,0,10300
9641,-3500,-500,1000,-2800,0,-5800
9642,-4300,-2200,2800,7200,0,3500
9643,700,9700,0,-2000,0,8400
9644,-3500,-1500,0,0,0,-5000
9645,-1900,-1400,-1200,-800,0,-5300
9646,15000,-4600,0,10200,-1200,19400
9647,-2700,11300,-1800,1200,-1200,6800
9648,5700,-1800,4700,-5600,-950,2050
9649,-2400,0,0,12200,-1200,8600
9650,-3000,7800,-1200,-2700,1950,2850
9651,-500,-4400,-1200,-1800,-1900,-9800
9652,-4400,-3700,0,-3700,1700,-10100
9653,8000,-4200,-1800,-3700,750,-950
9654,-5800,12200,4700,4400,-950,14550
9655,14500,-9900,0,-2900,2900,4600
9656,-2700,-2100,0,-3000,-950,-8750
9657,11700,6600,-1200,200,0,17300
9658,1200,-4600,0,-4900,1950,-6350
9659,-2600,11300,0,10000,-950,17750
9660,15000,-4600,-1200,-2700,2900,9400
9661,-900,11300,-2700,10000,0,17700
9662,-2800,-2000,-4600,3600,0,-5800
9663,-4200,200,0,-1000,0,-5000
9664,-6800,12200,12000,-800,-1200,15400
9665,1300,-4500,0,11000,0,7800
9666,5900,11600,0,0,0,17500
9667,1300,-4500,0,-1000,0,-4200
9668,9300,-2200,0,0,0,7100
9669,-3400,11400,0,-2000,0,6000
9670,13300,-4600,-1200,200,0,7700
9671,-3400,11300,-1200,13200,0,19900
9672,-1100,-2100,-1800,0,0,-5000
9673,11600,-4400,3500,-6400,0,4300
9674,-1100,-3000,-1200,1200,0,-4100
9675,-5900,12200,-2100,-800,0,3400
9676,-1900,-2100,1000,-2800,0,-5800
9677,-3700,9800,2800,-3800,0,5100
9678,-1900,-3000,0,-800,-1200,-6900
9679,6100,300,-1200,-800,0,4400
9680,10100,9800,-3000,11400,-2150,26150
9681,-4200,100,4700,-5200,-3350,-7950
9682,-1200,-2300,-1200,-4500,1700,-7500
9683,9900,-5100,-1200,11400,-12100,2900
9684,-2400,0,-1800,-4900,1950,-7150
9685,9300,11300,3500,-8300,1950,17750
9686,-4100,900,-4200,10500,13950,17050
9687,10000,-2100,4700,-7400,-1200,4000
9688,-4300,-600,-1800,-2900,1950,-7650
9689,500,-4500,4700,1500,1950,4150
9690,8300,9900,-1200,200,0,17200
9691,-2500,-700,0,20200,-10200,6800
9692,9000,-4300,0,200,-1200,3700
9693,-300,-5400,0,-1000,12000,5300
9694,-900,12100,0,-2000,0,9200
9695,7700,100,-1200,1200,-950,6850
9696,-3400,200,-900,-2000,-950,-7050
9697,11800,9800,1000,-5700,2900,19800
9698,-5100,100,2800,-5700,1950,-5950
9699,-1700,100,0,21200,-10200,9400
9700,8600,200,0,0,0,8800
9701,-3300,0,0,0,0,-3300
9702,-2600,200,0,0,12000,9600
9703,4200,400,0,200,-1200,3600
9704,-4900,0,0,-1000,0,-5900
9705,11000,-2200,-2400,1400,0,7800
9706,-5100,-700,-1200,200,0,-6800
9707,-6000,300,-900,200,-1200,-7600
9708,10000,-4500,1000,-2600,-1200,2700
9709,8600,12100,2800,-3800,0,19700
9710,-1700,0,0,-800,-2150,-4650
9711,8400,100,-1200,200,-950,6550
9712,2200,-4600,-1800,9100,1950,6850
9713,7800,-800,4700,-8500,1950,5150
9714,0,0,0,-2000,0,-2000
9715,7500,300,0,-4900,1950,4850
9716,-5200,9800,0,9100,1950,15650
9717,-3200,0,-10200,8200,0,-5200
9718,-2500,0,0,0,0,-2500
9719,10200,-800,0,-1000,0,8400
9720,-2500,900,12000,-2000,0,8400
9721,-1700,0,0,14400,-2400,10300
9722,10200,-700,0,-1000,0,8500
9723,-1300,-3500,-1200,1600,-3350,-7750
9724,17200,-10000,0,0,-950,6250
9725,-1800,100,0,-4900,2900,-3700
9726,1300,-5400,0,-1700,-200,-6000
9727,-3400,12100,-1200,-2700,1950,6750
9728,600,-3000,-900,-3000,0,-6300
9729,-4900,7800,3800,-9500,1950,-850
9730,-3200,-5200,0,-1000,0,-9400
9731,10800,-4500,-1200,-1800,0,3300
9732,-1800,9000,0,11000,0,18200
9733,-1800,-2300,0,-800,-1200,-6100
9734,-2700,9000,0,11000,0,17300
9735,-1800,-2200,0,-2000,-950,-6950
9736,14100,-6200,-1200,1200,0,7900
9737,-1800,12200,1000,6300,1950,19650
9738,12400,7600,1900,-2800,-950,18150
9739,-1900,-1300,0,-3900,2900,-4200
9740,-4200,-1500,-10200,10200,0,-5700
9741,-1900,10600,0,0,0,8700
9742,-900,100,12000,0,0,11200
9743,6000,11400,-1200,200,0,16400
9744,-3700,-2000,-1200,200,0,-6700
9745,-2600,-2200,-900,-2000,0,-7700
9746,6100,12000,-200,-2600,0,15300
9747,-5500,-1900,2800,-3800,0,-8400
9748,5200,100,0,-1000,0,4300
9749,500,-5400,0,-1800,-1200,-7900
9750,10800,-4500,0,11000,0,17300
9751,-1600,11200,0,-1000,0,8600
9752,11100,0,-2400,400,0,9100
9753,-4500,12400,-900,-2000,0,5000
9754,5300,300,1000,-4800,0,1800
9755,-4300,-2300,-8600,7800,-1200,-8600
9756,5200,200,-900,-2000,0,2500
9757,-1000,-2200,13900,-2800,0,7900
9758,400,-5300,1900,-4600,-2150,-9750
9759,10200,-800,-1200,13400,-2150,19450
9760,-3600,10700,0,6300,-8250,5150
9761,9500,-700,-3600,-4300,1950,2850
9762,-7800,300,0,1200,-2150,-8450
9763,8500,-2200,100,-6700,14900,14600
9764,11000,9000,1000,-6700,1950,16250
9765,-3600,-1300,4700,-6600,0,-6800
9766,-7000,-600,0,-1000,0,-8600
9767,13100,-6800,0,12000,0,18300
9768,-8500,12300,0,-1000,0,2800
9769,10200,-3000,0,0,0,7200
9770,-3500,-2300,-1200,11200,0,4200
9771,7700,300,0,1200,-1200,8000
9772,400,7500,-1200,12200,0,18900
9773,10300,-1500,-3000,400,-2150,4050
9774,6100,1000,4700,-6600,0,5200
9775,-3400,200,0,-2700,750,-5150
9776,-2000,9900,0,-3900,1950,5950
9777,8000,-4400,0,9200,-11150,1650
9778,-6700,-500,0,200,-1200,-8200
9779,10700,-4400,-1200,-1700,13950,17350
9780,-1000,-3100,-900,0,-950,-5950
9781,5900,9200,1000,-6700,2900,12300
9782,-4300,-1300,-7400,7400,0,-5600
9783,-2700,12200,0,-2000,0,7500
9784,13300,-5300,10800,200,0,19000
9785,-5300,200,0,-2000,0,-7100
9786,10900,7500,-1200,12200,0,29400
9787,8300,-2000,-900,-1000,0,4400
9788,200,-7500,-200,-2600,0,-10100
9789,-1000,-3000,2800,-3800,0,-5000
9790,8300,9900,0,0,0,18200
9791,-3600,-2900,0,-1000,0,-7500
9792,7500,-2200,0,0,0,5300
9793,-1200,6700,0,10000,0,15500
9794,-2500,100,0,-1000,0,-3400
9795,7800,11300,0,-1000,0,18100
9796,-1700,900,0,200,-1200,-1800
9797,5900,12300,0,200,-1200,17200
9798,-6800,200,0,-1000,-950,-8550
9799,12200,-6800,0,-2000,0,3400
9800,-5900,-600,0,-4900,1950,-9450
9801,9400,-2200,-2400,-1600,-950,2250
9802,-2700,200,-900,-4900,2900,-5400
9803,7600,9100,1000,-4800,0,12900
9804,-3300,0,2800,9200,0,8700
9805,11700,9900,0,-2000,0,19600
9806,-5100,-600,-11400,21400,0,4300
9807,6800,400,0,-1800,-1200,4200
9808,-3500,-1300,9000,400,-1200,3400
9809,7800,100,4700,-6600,0,6000
9810,700,-3100,0,-1000,-950,-4350
9811,5000,200,0,-4700,750,1250
9812,-5000,12000,0,0,-950,6050
9813,5200,100,0,8100,1950,15350
9814,-1200,-4400,0,0,0,-5600
9815,5800,-2100,0,8100,1950,13750
9816,2800,-7600,0,1200,-2150,-5750
9817,10100,-3000,-1200,5500,-7300,4100
9818,-6400,10000,-2100,1200,0,2700
9819,11000,-3100,1000,-2800,12000,18100
9820,-5900,11400,2800,-2600,-1200,4500
9821,7600,-1400,0,-1000,0,5200
9822,-1000,-2300,-1200,200,0,-4300
9823,11500,7600,-900,-1000,-950,16250
9824,-1100,-2900,3800,6400,-950,5250
9825,10000,-3800,-1200,-3500,1700,3200
9826,-5500,11000,0,-2900,1950,4550
9827,6100,100,0,-2000,0,4200
9828,-7500,12300,0,-2000,0,2800
9829,-6800,200,0,11200,-1200,3400
9830,7800,0,-1200,200,0,6800
9831,-3300,0,-900,-2000,-950,-7150
9832,8500,-2100,1000,-4800,0,2600
9833,-300,-9600,1600,-5100,-450,-13850
9834,-1800,-2300,0,11000,-950,5950
9835,12300,4400,-1200,-5700,2900,12700
9836,10900,-2200,0,-800,-2150,5750
9837,-3400,-1400,-3000,-800,-950,-9550
9838,9800,7600,4700,2500,2900,27500
9839,-1400,-5200,0,-4900,1950,-9550
9840,6200,12900,-1200,11200,0,29100
9841,-3500,-2900,-1800,-800,-1200,-10200
9842,9100,-2200,2300,-5000,-1200,3000
9843,-100,8900,-1800,12200,-2150,17050
9844,6800,200,4700,-7600,0,4100
9845,-3300,12100,0,8300,750,17850
9846,9400,200,0,-1000,-1900,6700
9847,-2700,8900,0,6100,2900,15200
9848,8600,900,-1200,-2700,1950,7550
9849,-2800,-2200,0,0,-950,-5950
9850,-1700,0,0,8100,2900,9300
9851,7500,-2800,0,-2000,0,2700
9852,700,-2300,0,11000,0,9400
9853,12700,8900,-1200,-800,0,19600
9854,-1800,200,-900,-1000,0,-3500
9855,-4200,0,1000,-2800,0,-6000
9856,-4400,12300,2800,-4800,0,5900
9857,7800,100,0,-1000,0,6900
9858,-8500,300,0,11000,0,2800
9859,1900,-6800,0,0,0,-4900
9860,7600,-2100,0,-2800,-1200,1500
9861,-100,-3100,0,-1000,0,-4200
9862,6600,400,-1200,1200,-950,6050
9863,-900,9700,0,11000,0,19800
9864,9200,-2200,0,-3900,1950,5050
9865,200,-7600,0,-1000,-950,-9350
9866,-5900,300,0,-5900,2900,-8600
9867,6000,-600,0,-1000,0,4400
9868,-5300,10000,0,200,-1200,3700
9869,-2700,-2200,0,11000,0,6100
9870,8700,11200,0,0,0,19900
9871,-4300,100,0,-2000,0,-6200
9872,7900,100,0,-600,-2400,5000
9873,-2900,9800,-1200,-1800,0,3900
9874,6900,200,-900,1200,-2150,5250
9875,7500,-2100,3800,6600,-2150,13650
9876,-3600,-2100,0,-3900,1000,-8600
9877,9900,-5300,0,-3900,2900,3600
9878,-1500,-6600,0,-4900,1950,-11050
9879,4700,-2600,-1200,11400,-2150,10150
9880,-2800,9800,-1200,-4700,2900,4000
9881,8500,-3000,-2400,400,0,3500
9882,-1300,7500,-1800,11000,-950,14450
9883,9900,-4400,3800,-5600,-950,2750
9884,-2200,6700,1000,4300,2900,12700
9885,7700,9000,2800,-6700,1950,14750
9886,600,-4600,0,-2000,0,-6000
9887,9000,-2900,-1200,-2800,0,2100
9888,100,4700,-1200,1400,-1200,3800
9889,9400,-2300,100,8200,0,15400
9890,-2700,8100,2800,8200,0,16400
9891,-3700,-1200,0,-1000,0,-5900
9892,-3500,9000,0,-1000,0,4500
9893,7300,-5200,0,10000,0,12100
9894,-3600,9200,0,0,0,5600
9895,4100,1200,0,-1000,0,4300
9896,-5100,100,0,-2000,0,-7000
9897,7600,9900,0,-1000,0,16500
9898,600,-4600,0,11000,0,7000
9899,3500,300,0,-2000,0,1800
9900,-3700,9000,-1200,-2800,0,1300
9901,12600,-4600,-1200,1200,0,8000
9902,-4400,9100,-2100,-800,0,1800
9903,11700,-2100,1900,-3800,0,7700
9904,-3400,-1500,-8300,5400,0,-7800
9905,-7600,13100,0,-1000,0,4500
9906,9100,-2200,12000,-3000,0,15900
9907,9600,12000,0,400,-2400,19600
9908,-6000,300,-1200,13200,0,6300
9909,11000,-2200,0,-1000,-950,6850
9910,-3300,0,-1800,200,-2150,-7050
9911,8400,200,4700,-8500,2900,7700
9912,-100,-3100,0,-2900,1000,-5100
9913,6000,1100,0,9200,-10200,6100
9914,-4200,-700,0,-5900,1950,-8850
9915,8400,9900,-10200,11600,-3350,16350
9916,-2500,0,0,-3900,14900,8500
9917,10200,100,9600,-600,0,19300
9918,400,-4600,-1800,-2000,-950,-8950
9919,5100,300,1900,-3600,-2150,1550
9920,-4200,-700,2800,-8700,2900,-7900
9921,6100,200,-1200,-1500,750,4350
9922,200,5100,0,-4000,0,1300
9923,10700,-4300,0,12200,-2150,16450
9924,-3600,-3000,0,0,0,-6600
9925,9200,-2100,0,7300,750,15150
9926,-400,6700,0,-2000,-950,3350
9927,7800,200,0,7100,2900,18000
9928,700,-3100,0,0,-950,-3350
9929,11700,9800,-10200,8200,-950,18550
9930,-1800,200,0,-5900,2900,-4600
9931,8600,12100,-2400,-1500,1950,18750
9932,-3300,0,10200,-1000,0,5900
9933,-4100,100,1900,-3800,0,-5900
9934,-7000,300,2800,9200,0,5300
9935,-500,-4400,0,-1000,0,-5900
9936,10100,-6100,0,200,-1200,3000
9937,-4400,1100,0,12000,0,8700
9938,8500,9100,0,0,0,17600
9939,-2700,-2100,0,0,0,-4800
9940,11500,-4600,0,0,0,6900
9941,-5200,11500,0,0,0,6300
9942,8400,-2100,0,-2000,0,4300
9943,11000,-2200,0,-2000,0,6800
9944,-4300,11300,-1200,1200,0,7000
9945,12400,-4500,-2100,-2800,0,3000
9946,-500,-4500,2600,-5200,-1200,-8800
9947,-3300,11300,-3000,400,-1200,4200
9948,6900,100,2600,-6400,-950,2250
9949,-2800,-2000,1900,-4800,0,-7700
9950,-1000,9700,700,5500,1950,16850
9951,-6000,200,0,-1000,-950,-7750
9952,8500,-3800,0,19300,-7300,16700
9953,-1100,-1300,0,-1000,0,-3400
9954,8600,11300,0,-2000,12000,29900
9955,-3700,-1100,0,-1000,0,-5800
9956,6900,-600,0,11000,0,17300
9957,-100,-2300,0,0,0,-2400
9958,11000,-2300,-1200,200,0,7700
9959,-1800,11400,0,-800,-1200,7600
9960,8700,-700,100,-2800,0,5300
9961,-4300,1800,1600,-3600,0,-4500
9962,-4300,200,0,-2000,-950,-7050
9963,-1700,-2300,0,0,-950,-4950
9964,12500,-4700,0,8100,2900,18800
9965,-3500,1800,0,-2700,750,-3650
9966,3600,12300,0,0,0,15900
9967,-4400,-2300,-1200,12200,0,4300
9968,3600,-6800,-1800,0,0,-5000
9969,9300,-600,4700,-7600,0,5800
9970,-100,-2300,0,1200,-1200,-2400
9971,12000,12000,0,-2000,0,22000
9972,-2700,-600,0,200,-2150,-5250
9973,-3300,0,0,11200,-2150,5750
9974,14700,5200,-1200,-3700,2900,17900
9975,-1100,-2300,0,-2900,1950,-4350
9976,-200,-3000,0,-800,-2150,-6150
9977,-5400,-2100,-1200,-1800,-950,-11450
9978,-4100,-1500,0,-3900,2900,-6600
9979,-7600,13100,-1800,7100,1950,12750
9980,-1900,9000,4700,-5600,0,6200
9981,1700,1100,0,-1000,0,1800
9982,-5000,100,0,11000,0,6100
9983,6200,100,0,9200,-10200,5300
9984,-2900,-1900,0,-2000,0,-6800
9985,7800,-800,0,-1800,10800,16000
9986,400,-3600,0,-1000,0,-4200
9987,4400,-600,-1200,-1800,0,800
9988,-4400,-2100,-1200,-800,-950,-9450
9989,8500,9700,-900,200,-2150,15350
9990,-2100,-2800,1900,-8700,2900,-8800
9991,10200,-2300,1900,-5700,1950,6050
9992,-4200,12100,0,-2000,0,5900
9993,12600,-2200,-1200,12200,0,21400
9994,-2600,-1500,0,-4000,0,-8100
9995,10000,-1200,0,12200,-1200,19800
9996,-8500,-600,0,0,0,-9100
9997,8500,10700,0,11200,-2150,28250
9998,-5200,-1500,0,-2000,-950,-9650
9999,9300,-500,0,-2900,2900,8800
10000,-1900,-2200,0,9100,1950,6950
10001,12300,-5200,0,-1000,0,6100
10002,-1400,-4200,0,0,0,-5600
10003,7000,11200,0,0,0,18200
10004,2500,-9000,0,-1000,0,-7500
10005,9500,-800,0,-800,-1200,6700
10006,-4200,12200,0,200,-1200,7000
10007,14900,-5400,0,-3000,-950,5550
10008,-3400,12100,-3300,1600,-1200,5800
10009,10100,-2200,1000,-5700,1950,5150
10010,-4500,-2100,2800,9200,-950,4450
10011,-400,6800,-1200,-3700,1950,3450
10012,10400,-1600,-900,-4900,1950,4950
10013,-1800,900,700,10400,0,10200
10014,-5100,12200,1900,-6700,1950,4250
10015,6900,300,0,0,0,7200
10016,-5900,11400,-1200,10200,0,14500
10017,-4200,1000,-3000,600,-2400,-8000
10018,6200,100,4700,-7600,0,3400
10019,-2700,200,-3300,14400,0,8600
10020,7500,-2000,1000,-3800,-950,1750
10021,-1200,-4500,2800,-3400,-3350,-9650
10022,11000,-2200,0,-4700,1700,5800
10023,-7000,-700,0,-2700,750,-9650
10024,7600,-2100,0,-1000,-950,3550
10025,8100,7500,0,10000,-950,24650
10026,500,-5300,-2100,-1700,1950,-6650
10027,8400,-3000,1900,4300,1950,13550
10028,-7700,500,1900,-1600,-2150,-9050
10029,10700,7500,0,9100,2900,30200
10030,-4900,0,-1200,-3700,1950,-7850
10031,11500,6800,0,-1000,0,17300
10032,-4300,300,-2400,11600,-1200,4000
10033,-2100,-5200,-3000,1200,0,-9100
10034,5700,10100,2900,-6600,0,12100
10035,1100,-7600,4700,-6600,-950,-9350
10036,12100,-7400,0,-1800,-2150,750
10037,-4400,9900,-1200,-4500,1700,1500
10038,9000,-4300,-1200,8500,750,12750
10039,6500,9300,-900,-1000,0,13900
10040,-2700,-2200,1000,-3600,-2150,-9650
10041,5200,-10800,2800,9200,-950,5450
10042,4400,12200,0,-4900,1950,13650
10043,-2700,-2100,0,8300,750,4250
10044,8700,12000,0,0,-950,19750
10045,-2600,-600,0,17300,-7300,6800
10046,9200,9000,0,-3900,1950,16250
10047,-500,-4400,0,-1000,0,-5900
10048,4300,13200,-2400,400,12000,27500
10049,-5200,-3000,-900,0,0,-9100
10050,-2800,-2200,3800,5400,0,4200
10051,7800,11300,0,-2000,0,17100
10052,-6700,1000,0,0,0,-5700
10053,6500,10100,-1200,-2800,0,12600
10054,-900,-3100,-1200,200,0,-5000
10055,10700,-5300,0,13200,-1200,17400
10056,-6900,1000,-1800,0,0,-7700
10057,1700,11500,4700,-5400,-2150,10350
10058,-400,-4400,0,-1000,0,-5800
10059,11300,5300,-1200,-3700,1950,13650
10060,-4100,-1600,-2100,1200,-950,-7550
10061,5800,-2100,1000,5500,1700,11900
10062,-3600,-1400,1600,-3600,0,-7000
10063,11600,-5300,-1200,200,0,5300
10064,-5300,10000,-900,-1000,-950,1850
10065,13000,-7400,2600,5600,-950,12850
10066,-9300,12200,0,-3900,2900,1900
10067,10300,-3100,0,-4900,1950,4250
10068,-6100,200,0,200,-1200,-6900
10069,6100,12300,-2400,-600,0,15400
10070,-4300,8900,-900,12000,0,15700
10071,7700,1000,1000,-3800,0,5900
10072,-1100,-3000,2800,9200,0,7900
10073,9100,-2000,0,0,0,7100
10074,9600,11200,0,-3000,0,17800
10075,400,-3700,0,-2800,-1200,-7300
10076,11100,-800,0,13200,-1200,22300
10077,-4200,100,0,-1000,0,-5100
10078,9400,12200,0,-2000,-950,18650
10079,-2000,-3000,0,-1800,-2150,-8950
10080,8500,-1400,0,-3700,1700,5100
10081,-1500,-5100,0,-4900,1950,-9550
10082,8400,-2100,0,-1000,-950,4350
10083,-200,-4600,0,-1000,-950,-6750
10084,6000,11200,0,8100,2900,28200
10085,2900,-4500,0,-3700,750,-4550
10086,7500,-2900,0,12000,0,16600
10087,1300,7500,0,-1000,0,7800
10088,9500,-800,0,-1000,-950,6750
10089,-4500,11500,0,11000,-950,17050
10090,-2700,-1300,0,-1700,1700,-4000
10091,-3500,9800,0,-3900,1950,4350
10092,9200,-2100,0,-1000,0,6100
10093,-3500,-3100,0,-1800,-1200,-9600
10094,7300,-1700,0,-2000,0,3600
10095,400,6600,0,10000,-950,16050
10096,12500,-4500,0,1200,-1200,8000
10097,500,-4500,-1200,-800,-950,-6950
10098,-6700,11400,0,-2900,1950,3750
10099,-2800,-3100,-1800,-4900,2900,-9700
10100,-300,-2200,4700,-6600,0,-4400
10101,7500,9900,0,11000,0,28400
10102,-3600,-2000,-10200,9200,0,-6600
10103,7000,11400,0,0,0,18400
10104,-4400,200,0,-2000,0,-6200
10105,-5700,100,12000,200,-1200,5400
10106,10900,9700,0,-1000,0,19600
10107,11000,-2200,0,-3000,-950,4850
10108,-1800,0,0,1400,-2400,-2800
10109,2200,-7000,0,-2900,1950,-5750
10110,7500,2000,0,12000,-950,20550
10111,9000,7700,0,-2900,1950,15750
10112,500,-5300,0,-800,-2150,-7750
10113,-100,-2300,-10200,6300,2900,-3400
10114,-6200,-400,-1200,-2700,1950,-8550
10115,-4900,12100,12000,-3000,0,16200
10116,11000,-3000,-1200,400,-1200,6000
10117,-8000,13200,-4200,1400,0,2400
10118,-6000,-2100,4700,-7600,-950,-11950
10119,8600,-3100,-3000,200,0,2700
10120,6400,-4200,4700,2700,750,10350
10121,-1800,-2200,0,0,-950,-4950
10122,7500,9200,0,7100,2900,26700
10123,2100,-4600,0,0,0,-2500
10124,6900,11400,0,11200,-1200,28300
10125,-4200,100,0,-2000,0,-6100
10126,-4200,-700,0,1200,-1200,-4900
10127,11000,10600,0,-2000,-950,18650
10128,-1800,100,0,-1000,-950,-3650
10129,5900,200,0,-2900,2900,6100
10130,-1800,-2200,0,-6900,1950,-8950
10131,11000,-2200,0,200,-1200,7800
10132,-2600,-700,0,-800,-1200,-5300
10133,10400,-800,0,10000,-950,18650
10134,-2700,12900,0,0,-950,9250
10135,11000,-2200,0,-2900,2900,8800
10136,-1700,100,0,9300,750,8450
10137,9500,0,0,-1000,0,8500
10138,-2700,100,0,-1000,0,-3600
10139,-100,-2300,-1200,200,-950,-4350
10140,10200,100,-1200,12200,-950,20350
10141,-7100,-2800,-1800,-3900,2900,-12700
10142,-5200,-2200,4700,-9500,1950,-10250
10143,-2100,7600,0,-1000,0,4500
10144,-5800,-800,0,6400,-11400,-11600
10145,8400,300,-1200,1400,-1200,7700
10146,-4400,9800,-900,-800,10800,14500
10147,10200,-2200,1000,-2800,-950,5250
10148,-1900,-3000,2800,-4800,-950,-7850
10149,7700,100,-2400,10500,2900,18800
10150,1000,-7600,-3000,-4700,1950,-12350
10151,6900,12200,700,-3600,0,16200
10152,-4500,-2100,1000,-3800,0,-9400
10153,6900,-1400,4700,5400,0,15600
10154,-5300,11600,0,-1000,0,5300
10155,12500,-5400,-1200,10400,-10200,6100
10156,13200,-4500,-1200,11400,-1200,17700
10157,-3300,-1500,0,0,0,-4800
10158,7700,13000,-1800,0,12000,30900
10159,-3600,-2100,4700,-5600,-950,-7550
10160,9000,6900,0,-1000,0,14900
10161,-2000,-2100,0,-5900,1950,-8050
10162,-400,-4500,0,-3900,1950,-6850
10163,11600,6600,-1200,12200,0,29200
10164,-2800,-3000,0,-3000,0,-8800
10165,-2500,12100,0,9200,-10200,8600
10166,13500,-2300,0,-1000,0,10200
10167,-3400,11200,0,-1000,12000,18800
10168,1100,-4300,0,-2000,0,-5200
10169,-5000,200,0,0,0,-4800
10170,10900,-2200,0,-1800,-1200,5700
10171,400,-4500,0,-2000,0,-6100
10172,-4200,12100,0,0,0,7900
10173,-4600,-2700,0,-2000,0,-9300
10174,9400,-2200,0,12000,0,19200
10175,-7600,12200,-1200,-1800,0,1600
10176,-200,-3800,0,-2000,0,-6000
10177,7800,100,100,-2600,-1200,4200
10178,-4400,12300,2800,-6800,0,3900
10179,7000,900,-1200,14400,-2150,18950
10180,-400,-4400,0,-1000,-950,-6750
10181,8700,0,0,-3900,2900,7700
10182,11100,-1600,0,9100,1950,20550
10183,-3500,1000,0,-2000,0,-4500
10184,-5100,12200,0,-4000,0,3100
10185,8300,-2900,0,1200,-1200,5400
10186,-8400,300,0,-1000,0,-9100
10187,5000,-1200,0,10000,-950,12850
10188,-3700,-2100,0,-1000,0,-6800
10189,9200,-2300,0,-3900,1950,4950
10190,-1200,-5300,0,0,-950,-7450
10191,5100,200,0,-4900,2900,3300
10192,-5000,10600,0,-3000,0,2600
10193,8300,-1300,0,9000,0,16000
10194,-2600,9800,-1200,400,-1200,5200
10195,8400,-2300,-3900,200,0,2400
10196,-5800,100,5600,-7400,-1200,-8700
10197,10100,-2900,0,7200,-1200,13200
10198,-2800,-2100,-2400,600,-1200,-7900
10199,8700,12100,-3000,200,-950,17050
10200,-7000,300,500,3900,1950,-350
10201,6200,0,4700,-7600,-1900,1400
10202,5900,400,-3000,-4700,2900,1500
10203,-7600,300,4700,-12500,1950,-13150
10204,8400,-2200,-10200,21200,-950,16250
10205,-2100,-4500,0,-3900,2900,-7600
10206,11700,-5300,12000,-4000,0,14400
10207,-5900,-700,-1200,1400,-1200,-7600
10208,7600,12200,-1800,10000,0,28000
10209,-5000,100,3500,-6400,0,-7800
10210,8500,-2100,0,0,0,6400
10211,-3800,10000,0,9000,0,15200
10212,11500,-4600,-2100,1400,-1200,5000
10213,-1700,-3100,1000,-2800,0,-6600
10214,-4300,-600,1600,8400,0,5100
10215,11000,9800,0,-1000,-950,18850
10216,6800,300,0,-1000,-950,5150
10217,-3600,9800,0,7100,2900,16200
10218,9100,-2100,0,-4700,750,3050
10219,-6800,300,0,11000,0,4500
10220,9300,-3000,-1200,-800,0,4300
10221,-300,-4600,-2100,11200,0,4200
10222,8300,10000,-200,-3600,0,14500
10223,-5100,-1500,1000,-3800,0,-9400
10224,7500,-1400,1900,-4800,0,3200
10225,-1800,9700,2800,-3600,-1200,5900
10226,12600,-3800,-10200,21400,-1200,18800
10227,-4200,900,0,-1000,-950,-5250
10228,9400,200,0,-2000,0,7600
10229,-2900,9800,12000,-3900,1950,16950
10230,7600,-3000,0,9100,1950,15650
10231,10800,-4500,0,-1000,0,5300
10232,3000,-4600,0,-3000,0,-4600
10233,7700,-1400,0,0,0,6300
10234,-4300,13000,0,10000,0,18700
10235,10000,-2000,-1200,1200,0,8000
10236,-1800,-3000,0,0,0,-4800
10237,6600,10000,0,0,0,16600
10238,-9400,400,0,0,0,-9000
10239,8400,-2200,0,0,0,6200
10240,-4400,10000,0,0,0,5600
10241,6200,-800,0,0,0,5400
10242,2200,-5400,0,-3000,0,-6200
10243,6700,1000,-2100,1200,0,6800
10244,-6600,11300,1000,-2800,0,2900
10245,6000,1100,2800,-2800,0,7100
10246,-2800,-2200,0,-2000,0,-7000
10247,10800,-6100,-1200,-800,0,2700
10248,-2800,-1300,0,-1000,0,-5100
10249,11000,-2200,0,12200,-1200,19800
10250,-900,11200,0,-800,-1200,8300
10251,-3600,100,-1200,200,-950,-5450
10252,3300,500,0,12000,0,15800
10253,8500,9800,100,-11500,750,7650
10254,-4500,-2200,2800,-2600,-2150,-8650
10255,4300,200,0,-4900,1950,1550
10256,-1200,-5300,0,-2000,0,-8500
10257,6100,200,0,8100,1950,16350
10258,500,7500,0,-3000,-950,4050
10259,10200,-3100,-1200,-2500,1700,5100
10260,-4600,-1900,0,-2000,0,-8500
10261,-4100,11200,-1200,13200,-950,18150
10262,6100,200,-1100,-5600,0,-400
10263,-1300,-4500,2800,-6500,750,-8750
10264,11900,9700,0,-2000,-950,18650
10265,8500,-600,0,7100,2900,17900
10266,-2800,-2100,0,-1000,0,-5900
10267,6000,-700,0,8000,0,13300
10268,-1900,10600,-1200,400,-1200,6700
10269,5200,300,-1800,-3000,0,700
10270,-4300,-2200,4700,3400,0,1600
10271,-1800,-2300,-1200,200,-950,-6050
10272,12000,-800,0,-2000,-950,8250
10273,-1800,0,0,8100,2900,9200
10274,8400,10600,0,-3900,1950,17050
10275,-3700,-500,0,10000,0,5800
10276,8500,-2200,0,-1000,0,5300
10277,10800,-5200,0,-1000,0,4600
10278,400,-4500,0,12000,0,7900
10279,-4700,9200,-1200,-1800,0,1500
10280,12500,-4500,-900,0,0,7100
10281,-6700,-600,1000,-3800,0,-10100
10282,9300,8900,400,9600,0,28200
10283,-4600,-1200,-1800,0,0,-7600
10284,4400,200,4700,-7600,0,1700
10285,-2100,6800,-2400,1400,0,3700
10286,7600,-2300,-900,-1000,0,3400
10287,-2600,9000,1000,8200,0,15600
10288,8300,-2000,2800,-3800,0,5300
10289,-6000,12300,0,-800,-1200,4300
10290,5300,100,0,0,0,5400
10291,-4100,0,-10200,20200,0,5900
10292,12000,0,0,1200,-1200,12000
10293,-4300,200,0,0,0,-4100
10294,13500,-2300,12000,0,-950,22250
10295,-1800,-700,0,-1000,0,-3500
10296,11900,-2300,-2400,-2500,1950,6650
10297,-1800,12000,0,-1800,-2150,6250
10298,9300,100,-1800,-500,500,7600
10299,-6000,-2100,3500,-6400,0,-11000
10300,10600,-4300,0,-1000,-950,4350
10301,1100,-7700,0,-1800,-1200,-9600
10302,9200,-2100,-1200,-3500,750,3150
10303,-3500,-600,0,11000,-950,5950
10304,-3200,11200,-1800,-3900,1950,4250
10305,8400,-1300,4700,-7600,-950,3250
10306,-3300,11200,0,-3700,1700,5900
10307,11700,-2200,-1200,-4500,750,4550
10308,-1100,-2300,0,11000,-950,6650
10309,-6200,12300,0,-2000,-950,3150
10310,6100,200,0,8100,2900,17300
10311,-1300,-4300,0,-3900,1950,-7550
10312,-6100,-2900,0,-3000,0,-12000
10313,8600,-2300,-2100,10200,0,14400
10314,400,6700,1000,-2600,-1200,4300
10315,8300,-2200,2800,7400,-1200,15100
10316,-1900,-2900,0,200,-2150,-6750
10317,8400,9000,0,11000,0,28400
10318,-5000,1000,0,-3700,750,-6950
10319,6700,11400,-1200,-2800,-950,13150
10320,-5400,-1200,0,-2900,1950,-7550
10321,8500,-3100,0,-2900,1950,4450
10322,-2400,0,-1200,10200,-950,5650
10323,7400,-1900,-900,-3900,2900,3600
10324,-5300,9200,-200,9400,0,13100
10325,12400,-5200,-7400,5400,0,5200
10326,-10300,1000,0,0,0,-9300
10327,8200,-4300,10800,-1800,0,12900
10328,-7600,11300,-1200,200,0,2700
10329,8500,-3000,-1800,11000,0,14700
10330,-5400,10000,4700,-5000,-3600,700
10331,10100,-2200,-1200,-600,-1200,4900
10332,-6300,-2100,-1800,400,-3350,-13150
10333,6200,100,4700,-6400,-2150,2450
10334,-400,7600,-1200,-4500,1700,3200
10335,4500,-1400,0,-2700,-200,200
10336,-1200,-3700,0,-1000,0,-5900
10337,10100,-2300,-10200,19500,-200,16900
10338,-6300,9300,0,-1000,-950,1050
10339,-600,-6700,12000,6300,-8250,2750
10340,8400,-3800,0,-2900,1950,3650
10341,-3600,10600,0,-1000,-1900,4100
10342,9800,-5000,0,-3700,13700,14800
10343,-7700,12200,0,-5900,1950,550
10344,8400,-3000,0,-1000,-1900,2500
10345,7500,9900,-1200,9300,2900,28400
10346,-2600,-2300,-900,-6900,1950,-10750
10347,10100,-3000,-200,-400,-2150,4350
10348,-8600,12300,2800,5300,2900,14700
10349,7000,100,0,-4900,1950,4150
10350,-5300,10000,0,-1000,-950,2750
10351,10700,-5300,-1200,8500,1700,14400
10352,-2800,-3000,-1200,-800,0,-7800
10353,13600,-8100,-1800,21200,-11150,13750
10354,11500,-5300,4700,-4400,-2150,4350
10355,-3100,7500,0,-2900,14900,16400
10356,8300,-3600,0,-2900,1950,3750
10357,-5300,9200,-10200,9400,-1200,1900
10358,8500,-1400,-1200,-1600,-1200,3100
10359,-3700,-5300,-2100,-800,-950,-12850
10360,10400,5400,13000,-3800,0,25000
10361,-5800,-800,2800,-5700,1950,-7550
10362,6200,12000,0,-1000,-950,16250
10363,-10400,-1100,0,5300,-7300,-13500
10364,13100,6100,0,0,0,19200
10365,-2000,-4500,0,-4000,12000,1500
10366,10100,9100,-11400,9400,0,17200
10367,-6000,-600,-1800,-1000,0,-9400
10368,6000,12300,15500,-5400,0,28400
10369,-2200,-4300,0,0,0,-6500
10370,5400,0,0,-2000,0,3400
10371,9100,9900,0,-1800,-1200,16000
10372,-4100,-2400,0,12000,0,5500
10373,9000,9300,0,-3000,0,15300
10374,-4200,-800,0,0,-950,-5950
10375,11600,-3600,0,12000,-950,19050
10376,-2100,9200,0,-3900,2900,6100
10377,7000,100,-1200,-3700,1950,4150
10378,-1600,0,-1200,200,0,-2600
10379,7600,12100,-1800,-3000,0,14900
10380,-100,-2300,4700,-4400,-1200,-3300
10381,9500,-800,0,200,-1200,7700
10382,-3500,200,0,11000,0,7700
10383,10900,9000,0,-2000,0,17900
10384,-5100,1100,0,12200,-2150,6050
10385,-6100,-500,0,-2900,1950,-7550
10386,6200,1000,0,0,0,7200
10387,9600,-6700,0,-2900,1950,1950
10388,-5300,-2100,0,-1000,0,-8400
10389,7800,-600,0,-1800,-1200,4200
10390,-8000,10200,0,0,0,2200
10391,5200,-500,-2400,11400,-950,12750
10392,-6800,100,0,0,0,-6700
10393,9300,-2200,-1800,-3900,1950,3350
10394,-4300,9800,2300,-5000,-2150,650
10395,6200,0,-900,-3700,1700,3300
10396,-2700,-2200,-1100,-2600,0,-8600
10397,6800,-700,2600,6800,-2150,13350
10398,1900,-6800,2800,-4800,0,-6900
10399,12500,-4600,-2100,10500,750,17050
10400,-1800,11300,-200,7600,-11150,5750
10401,7600,100,2800,-6700,1950,5750
10402,-2200,-4300,0,400,8650,2550
10403,6800,9700,-1200,-4700,2900,13500
10404,-4100,-700,-4500,-2300,1000,-10600
10405,10300,0,3800,6400,0,20500
10406,-3400,12100,-1800,-2900,1950,5950
10407,6800,300,4700,4400,-950,15250
10408,-8400,200,0,-1700,1700,-8200
10409,6500,-1900,0,-2000,0,2600
10410,-3700,-3700,-1200,10200,0,1600
10411,3500,1100,0,0,0,4600
10412,-2800,-2200,-3000,12200,0,4200
10413,11100,9700,4700,-6600,0,18900
10414,-400,-4500,0,-1000,0,-5900
10415,7000,-600,0,-1000,0,5400
10416,-5900,100,0,-2000,0,-7800
10417,13400,7400,-1200,-800,0,18800
10418,-1800,-700,0,11000,0,8500
10419,8600,-1500,-1800,-2000,0,3300
10420,-7800,2000,4700,-5600,0,-6700
10421,9800,7700,0,12000,0,29500
10422,-3400,-3800,0,-1000,0,-8200
10423,5100,1200,0,0,0,6300
10424,14800,3600,0,12000,0,30400
10425,-5500,-1000,0,0,0,-6500
10426,5200,400,0,-1000,0,4600
10427,-5300,-2100,0,0,0,-7400
10428,8400,9900,0,-1000,0,17300
10429,-4400,-3100,0,200,-1200,-8500
10430,7500,-2100,0,-1000,0,4400
10431,-1300,7500,-1200,200,-950,4250
10432,11600,-5400,0,-1000,-950,4250
10433,-2000,-5400,0,-2700,1700,-8400
10434,8500,9700,0,-2900,1950,17250
10435,1400,-3100,0,-800,-1200,-3700
10436,5200,11500,0,0,0,16700
10437,-400,-3600,0,12000,0,8000
10438,10300,11200,0,0,-950,20550
10439,-900,0,0,-800,-2150,-3850
10440,6000,12100,0,-2900,2900,18100
10441,-1800,-2200,0,-2900,1950,-4950
10442,12700,-2300,0,0,0,10400
10443,-4400,300,0,-1000,0,-5100
10444,8600,-700,0,0,0,7900
10445,9500,12100,-1200,-2800,0,17600
10446,-7300,-1600,-3000,13400,-1200,300
10447,9600,0,3500,-6400,0,6700
10448,-5000,-800,-3300,1600,-2150,-9650
10449,6700,-1200,100,-4800,0,800
10450,-6100,-2800,3500,-8300,1950,-11750
10451,12400,-3700,1900,-5800,-950,3850
10452,-3600,-3000,-1200,-2700,2900,-7600
10453,5000,-400,-900,12400,-2400,13700
10454,-3500,9800,3800,-5600,0,4500
10455,9300,-2100,0,11000,-950,17250
10456,-4200,100,0,-1000,0,-5100
10457,12500,6700,0,6300,-8250,17250
10458,-7000,400,-1200,12200,-950,3450
10459,9300,-2200,0,-4900,2900,5100
10460,9400,9800,0,-800,10800,29200
10461,-4300,200,0,0,0,-4100
10462,14100,-5300,0,-2000,-950,5850
10463,-2600,100,-1200,200,-950,-4450
10464,12400,7500,0,9100,2900,31900
10465,-1600,-800,100,-6700,1950,-7050
10466,11100,100,2800,-2800,0,11200
10467,-2500,0,0,-2000,0,-4500
10468,10800,9000,-1200,1400,-1200,18800
10469,11000,-1400,0,10000,0,19600
10470,-4200,-700,-1200,200,0,-5900
10471,7600,300,-1800,200,-1200,5100
10472,1300,-4600,3500,-7400,0,-7200
10473,200,5300,0,0,-950,4550
10474,8700,-700,0,-1000,0,7000
10475,-5100,100,-10200,19300,1950,6050
10476,-1900,-2300,0,0,-950,-5150
10477,-5100,11400,12000,-3900,2900,17300
10478,6100,100,0,0,0,6200
10479,700,8900,0,0,0,9600
10480,6000,1100,0,-600,-2400,4100
10481,-1600,-800,0,-800,-1200,-4400
10482,8500,1000,0,200,-1200,8500
10483,-500,-4500,0,-1000,-950,-6950
10484,8700,0,-2100,-800,-950,4850
10485,9400,-800,1000,-6700,1950,4850
10486,-400,-4600,400,-5100,750,-8950
10487,-2100,10000,-1200,8400,-11150,3950
10488,7000,-1500,-1800,-4900,2900,1700
10489,-6600,-3300,-5500,700,13950,-750
10490,-5000,-800,0,-1000,0,-6800
10491,-1300,8500,12000,-1000,0,18200
10492,7700,-3100,0,-1000,0,3600
10493,-400,-4400,0,11000,0,6200
10494,6000,11500,0,-1000,0,16500
10495,-2800,-2300,-1200,12400,-1200,4900
10496,11500,-4400,-2100,400,-1200,4200
10497,7000,12100,1000,-2800,0,17300
10498,-3600,-2900,2800,-3800,-950,-8450
10499,400,-4500,-10200,8400,-2150,-8050
10500,9900,6800,0,-2700,1700,15700
10501,-4200,0,0,-4700,-200,-9100
10502,7700,11400,12000,9200,-10200,30100
10503,-3600,-3000,0,-2700,750,-8550
10504,-600,-6000,0,0,10100,3500
10505,11800,9700,0,-5900,2900,18500
10506,-900,-700,-1200,-2700,1950,-3550
10507,9200,-2100,-1800,-2000,-950,2350
10508,-3600,9700,4700,2500,2900,16200
10509,8700,-700,0,-1000,0,7000
10510,-5200,200,0,-1000,0,-6000
10511,700,9700,-2400,-1600,0,6400
10512,8500,100,-10200,21200,0,19600
10513,1300,-4600,-3000,-800,0,-7100
10514,5900,-1300,16700,-7600,0,13700
10515,1100,-5900,-1200,1200,0,-4800
10516,-1700,8900,-1800,-1000,0,4400
10517,-4300,100,4700,-5600,0,-5100
10518,-1200,-2800,-1200,12200,0,7000
10519,5300,12200,-1200,-800,0,15500
10520,200,-6700,-900,-1000,0,-8400
10521,2100,-4600,1000,9400,-1200,6700
10522,9200,8300,2800,-2800,0,17500
10523,-6000,1000,0,-3000,-950,-8950
10524,9400,9000,0,-3000,0,15400
10525,-2500,-800,-1200,14400,-2150,7750
10526,-7700,13100,-1200,-3700,2900,3400
10527,-1800,-2300,0,-2900,1950,-5050
10528,8400,200,-1800,-800,-1200,4800
10529,-2700,-2200,4700,-5400,-1200,-6800
10530,8100,-5200,0,12000,0,14900
10531,-1900,-2200,0,-1800,-2150,-8050
10532,6800,-3000,-1200,1400,-2150,1850
10533,14700,5200,-1200,8300,1000,28000
10534,-900,-800,-900,-3900,2900,-3600
10535,11200,12000,3800,-8500,1950,20450
10536,-5500,-2800,0,-1000,-950,-10250
10537,400,-3700,0,5300,-7300,-5300
10538,-6000,11400,-1200,-800,0,3400
10539,10800,-4600,0,8200,-10200,4200
10540,-2600,-2200,0,-1000,12000,6200
10541,-2700,8100,0,0,0,5400
10542,6000,1200,0,-1000,12000,18200
10543,-3700,10000,0,-1000,0,5300
10544,8500,-2300,-1200,-800,0,4200
10545,-3000,-5200,0,0,0,-8200
10546,-2000,-2300,-1800,12000,0,5900
10547,10100,8900,3500,-5400,0,17100
10548,-2700,-2200,0,-800,-1200,-6900
10549,11400,6900,-10200,9400,-1200,16300
10550,-4400,-2100,0,0,0,-6500
10551,11600,-4400,12000,-2000,-950,16250
10552,-1900,9000,0,2400,-3350,6150
10553,3300,400,0,-3900,2900,2700
10554,-6800,11500,0,-3900,1000,1800
10555,200,-6600,0,0,0,-6400
10556,3400,12300,-1200,-3700,1950,12750
10557,-900,-3100,-900,-3900,1950,-6850
10558,7600,-2300,1000,-4600,-1200,500
10559,-1200,7600,2800,-3800,0,5400
10560,5200,-600,-1200,11400,-2150,12650
10561,-2200,-4200,0,-2000,0,-8400
10562,5100,300,0,-3900,1950,3450
10563,-500,6700,0,11000,-950,16250
10564,8400,-2000,0,-3500,500,3400
10565,-5100,12200,0,0,0,7100
10566,11600,-5200,0,10000,-950,15450
10567,-1300,-4500,0,0,-950,-6750
10568,10300,8900,0,-3700,1700,17200
10569,8400,-2000,0,12000,-950,17450
10570,-4100,-800,0,-4700,1700,-7900
10571,-4500,12300,0,200,-2150,5850
10572,6600,-2900,0,0,-950,2750
10573,-5900,12100,0,-4900,1950,3250
10574,5300,1100,0,-2900,1950,5450
10575,1200,-6900,0,0,-950,-6650
10576,6900,-600,0,7100,2900,16300
10577,6900,100,0,-1700,750,6050
10578,-4200,0,0,10000,0,5800
10579,10800,6700,-1200,1200,0,17500
10580,-1900,-1400,-900,0,0,-4200
10581,-6000,-600,1000,-4800,0,-10400
10582,9900,-2100,2800,-1600,-1200,7800
10583,11600,7500,0,-3000,0,16100
10584,-3700,-2900,0,-800,-2150,-9550
10585,6700,-2200,0,12000,-950,15550
10586,-2200,7700,0,-4900,2900,3500
10587,7900,-700,-1200,-2700,1950,5250
10588,-2800,-2900,0,12000,0,6300
10589,9300,10700,-1200,200,0,19000
10590,-5900,-700,-900,0,0,-7500
10591,8400,-2000,1000,-3800,0,3600
10592,-5000,0,2800,-4800,0,-7000
10593,9100,9900,0,-1000,0,18000
10594,-5000,-1500,0,-1000,0,-7500
10595,8200,-3500,0,9000,0,13700
10596,1200,7500,0,400,-2400,6700
10597,11000,-3000,0,0,0,8000
10598,-4500,-500,0,11000,-950,5050
10599,4300,1200,0,-1000,-950,3550
10600,2200,6600,-1200,-2700,2900,7800
10601,11600,-4500,0,-4900,1950,4150
10602,1300,-4600,0,-800,-1200,-5300
10603,8500,-3000,0,9200,-10200,4500
10604,-7000,11700,-1200,-800,0,2700
10605,-4200,100,0,-2000,11050,4950
10606,-2100,7500,-1100,-1600,-950,1750
10607,7300,-4500,2800,-8700,2900,-200
10608,-2800,-2900,-2400,-6500,1950,-12650
10609,9900,6800,-1800,0,0,14900
10610,-1200,-4500,4700,4400,0,3400
10611,7600,9900,0,9200,-10200,16500
10612,-300,-3800,0,-3000,0,-7100
10613,6100,1000,0,-2000,12000,17100
10614,700,9700,0,-2000,0,8400
10615,9300,-800,-1200,11400,-1200,17500
10616,-1900,9900,-900,0,0,7100
10617,6100,300,1000,8200,0,15600
10618,-8500,12400,2800,-3800,0,2900
10619,-400,-4500,0,-2000,0,-6900
10620,14500,-9000,0,0,0,5500
10621,-6100,-1500,0,12000,0,4400
10622,-1200,-5300,0,-1000,0,-7500
10623,9800,8600,0,-2000,0,16400
10624,-300,-5300,-1200,200,0,-6600
10625,5900,12400,0,-3000,0,15300
10626,-1000,-3000,0,0,0,-4000
10627,8400,9800,0,-1000,0,17200
10628,-2600,-2200,0,11000,0,6200
10629,9400,11300,0,-1000,0,19700
10630,-1500,-4200,-1200,200,0,-6700
10631,-1300,-4400,-900,-2000,0,-8600
10632,9100,6800,3800,-5400,-1200,13100
10633,-1600,-8100,0,200,-1200,-10700
10634,-5700,8700,0,0,0,3000
10635,-5500,-2700,0,11000,-950,1850
10636,12100,4600,0,200,-2150,14750
10637,-6600,200,-1200,-2700,1950,-8350
10638,8500,-2900,0,-3900,1950,3650
10639,-2100,7500,0,-1000,0,4400
10640,500,-4500,0,9100,1950,7050
10641,12100,3800,0,-1000,-950,13950
10642,-8800,-2200,0,-3900,2900,-12000
10643,7400,-1900,-10200,8200,0,3500
10644,8100,6900,0,-1000,0,14000
10645,-2000,-5300,12000,200,-1200,3700
10646,11600,-4400,0,0,0,7200
10647,-1900,8900,0,-1000,0,6000
10648,10200,-3000,0,-800,-1200,5200
10649,1300,7400,0,0,0,8700
10650,-4500,-2800,0,-1000,-950,-9250
10651,7800,11300,0,-3000,0,16100
10652,-6300,-1400,0,-3900,1950,-9650
10653,-2700,-2100,-1200,200,0,-5800
10654,9000,7600,-900,9100,1950,26750
10655,-5000,-800,3800,-6600,0,-8600
10656,8000,7800,0,-3000,0,12800
10657,400,-5300,0,-1000,0,-5900
10658,9200,9800,-1200,-800,0,17000
10659,-4400,-4500,0,11200,-1200,1100
10660,5200,1900,0,-1000,0,6100
10661,1400,7400,0,12200,-1200,19800
10662,5300,-2200,0,-1000,0,2100
10663,-2700,-500,0,0,0,-3200
10664,7800,12100,0,-1000,-950,17950
10665,-1400,-4300,0,-2000,-950,-8650
10666,8400,9800,-1200,8500,1700,27200
10667,2200,-5400,-2100,-2700,1950,-6050
10668,10600,-5100,700,-4600,0,1600
10669,-1800,9800,100,-2600,-1200,4300
10670,11900,-3100,4700,-8600,0,4900
10671,600,-2300,0,-1000,0,-2700
10672,-1800,11200,-1200,-1600,-2150,4450
10673,11000,-2300,0,10000,0,18700
10674,-900,12100,0,-2900,1950,10250
10675,-2500,0,-1200,10200,-950,5550
10676,-2000,10000,-900,-3900,2900,6100
10677,-1200,-4500,1000,-4600,-1200,-10500
10678,-2700,11500,2800,6200,0,17800
10679,13400,-4600,0,1200,-2150,7850
10680,-500,7700,-2400,-1600,0,3200
10681,-2500,-700,-900,6100,1950,3950
10682,-1000,9000,-200,-2400,-2150,3250
10683,-5400,-1300,400,-5100,1700,-9700
10684,8200,-3100,-1800,10000,-950,12350
10685,-2900,7500,4700,-5600,0,3700
10686,500,-5300,0,-3900,1950,-6750
10687,11500,7600,0,12000,-950,30150
10688,-1200,-5300,-1200,-3500,1700,-9500
10689,-3600,10000,-900,12000,0,17500
10690,6800,2000,1000,-2800,-950,6050
10691,-3500,9800,2800,6200,0,15300
10692,-1800,-2300,-2400,-1500,1950,-6050
10693,-5000,11300,-1800,0,-950,3550
10694,7500,-2800,1900,-6700,2900,2800
10695,1500,-9700,2800,8200,0,2800
10696,9800,8500,-10200,9200,0,17300
10697,-7700,-400,0,-2000,0,-10100
10698,10600,-5100,0,10400,-11400,4500
10699,-7900,10200,12000,-1000,0,13300
10700,2800,5200,0,0,0,8000
10701,6200,0,0,0,12000,18200
10702,6000,-1400,0,-800,-1200,2600
10703,-6100,9900,0,0,0,3800
10704,-1200,-3600,0,0,-950,-5750
10705,10700,-5200,0,-2000,0,3500
10706,10100,9800,0,-2700,750,17950
10707,-4400,9000,0,200,-1200,3600
10708,6100,200,0,-4700,750,2350
10709,-1000,-2200,-1200,-800,0,-5200
10710,9200,9100,0,200,-2150,16350
10711,2900,-6900,0,13200,-2150,7050
10712,11100,12000,0,-3900,1950,21150
10713,-1800,-600,0,-3900,1950,-4350
10714,11500,-4500,0,10200,-11150,6050
10715,2200,7400,0,-3900,2900,8600
10716,-5400,-600,-1200,-3700,1950,-8950
10717,-4100,100,-900,0,12000,7100
10718,-2900,7600,-200,-4600,0,-100
10719,-3000,-5100,2800,-3800,0,-9100
10720,8300,-2900,0,11000,0,16400
10721,-7600,12300,0,-3000,0,1700
10722,10500,-7500,-1200,1200,0,3000
10723,-7300,-3400,-1800,11000,0,-1500
10724,10700,6800,4700,-5400,-1200,15600
10725,-300,-5300,-1200,-600,-1200,-8600
10726,6200,12000,-1200,-2800,0,14200
10727,-1200,-2800,-900,200,-2150,-6850
10728,6000,0,-900,12000,-950,16150
10729,-5200,10000,4700,-9500,1950,1950
10730,5200,100,0,-3500,-450,1350
10731,-900,8900,0,0,-950,7050
10732,14900,-5400,0,-3900,2900,8500
10733,-4500,-2200,0,7100,1000,1400
10734,11800,9800,0,-3000,-950,17650
10735,-5200,200,0,-1500,500,-6000
10736,14800,5200,0,7100,1950,29050
10737,-1700,-800,0,1200,-2150,-3450
10738,12700,-2300,0,10000,0,20400
10739,-1800,11300,0,-5900,1950,5550
10740,-200,-2200,-1200,12200,-950,7650
10741,13500,9700,-1200,-4700,2900,20200
10742,-900,100,-2100,-800,0,-3700
10743,-4200,100,1000,-3800,0,-6900
10744,-2700,200,2800,-6800,0,-6500
10745,-3400,200,0,1400,-2400,-4200
10746,-1700,-2300,0,-2000,0,-6000
10747,-2000,-2100,-1200,11200,-950,4950
10748,-1900,-3100,-900,-1000,-950,-7850
10749,8600,100,1000,-6700,2900,5900
10750,-6100,12100,2800,6500,750,16050
10751,6100,200,0,-2000,0,4300
10752,1200,-7700,0,-1000,0,-7500
10753,-7800,1100,0,-1000,-950,-8650
10754,9400,-3000,0,12000,-950,17450
10755,-500,-5300,0,-3900,2900,-6800
10756,11400,7600,0,12000,-950,30050
10757,-5400,-2700,0,-5900,2900,-11100
10758,7900,100,-1200,200,0,7000
10759,-2700,9800,0,12000,0,19100
10760,-3600,-3000,0,-1000,0,-7600
10761,10200,9000,0,-2000,0,17200
10762,8300,-1300,0,200,-1200,6000
10763,-2700,8300,0,13200,-1200,17600
10764,9200,-2200,0,-1000,0,6000
10765,-4200,12900,-1200,200,-950,6750
10766,11500,-4500,0,0,0,7000
10767,-2800,-3000,-1800,-3900,1950,-9550
10768,7700,300,3500,-5400,0,6100
10769,-1800,-2300,0,-3900,1950,-6050
10770,400,5800,0,-2000,0,4200
10771,7700,1100,0,0,0,8800
10772,1300,7400,0,10000,0,18700
10773,-3500,-600,-11400,11600,-1200,-5100
10774,9300,-2300,-1800,0,0,5200
10775,-4400,9900,15500,-5400,0,15600
10776,-4200,-1600,0,0,0,-5800
10777,-1300,-4500,0,0,0,-5800
10778,9700,-4400,0,0,0,5300
10779,-3500,9900,0,-1000,0,5400
10780,11000,-2300,0,200,-1200,7700
10781,-3400,11300,0,0,0,7900
10782,8500,100,0,0,-950,7650
10783,-4600,-2000,0,-1000,0,-7600
10784,12400,7400,-1200,-1500,750,17850
10785,-500,-4500,0,-2000,-950,-7950
10786,-5000,-1500,-1800,-1500,500,-9300
10787,9900,-3600,4700,-7600,0,3400
10788,-1900,6700,0,2400,-3350,3850
10789,-200,-2300,0,11000,-950,7550
10790,-1800,-600,0,-2900,1950,-3350
10791,5100,12300,0,8100,1950,27450
10792,-5000,0,0,-2000,-950,-7950
10793,7500,9800,0,-1700,1700,17300
10794,-3600,-2100,-1200,-3700,1950,-8650
10795,8300,-3000,0,-3000,-950,1350
10796,-4100,100,0,-1000,0,-5000
10797,8700,11200,0,8100,1950,29950
10798,-6000,1100,0,0,-950,-5850
10799,9800,-4400,0,-5900,2900,2400
10800,-2800,-2200,-1200,200,0,-6000
10801,7500,-2900,-2100,9200,0,11700
10802,-1100,-4600,1000,-3400,-2400,-10500
10803,7800,12100,2800,-2800,0,19900
10804,-3500,-700,0,11000,0,6800
10805,8700,0,0,-2000,-950,5750
10806,-2000,8100,0,-1000,-950,4150
10807,5900,2100,0,8300,1700,18000
10808,-1400,-5300,0,-3900,1950,-8650
10809,9800,-4400,0,-3000,0,2400
10810,-8100,-1600,0,200,-1200,-10700
10811,6700,9300,0,12000,0,28000
10812,200,-6800,0,-2000,-950,-9550
10813,9400,-3100,-1200,-1800,0,3300
10814,-5200,9800,-3000,-3700,1950,-150
10815,-6300,-2500,4700,-5600,-950,-10650
10816,7300,7800,0,7100,2900,25100
10817,-1200,-5200,0,-1800,-1200,-9400
10818,9800,-4400,0,-2000,0,3400
10819,-3000,7000,0,11200,-1200,14000
10820,11600,-6100,0,-1000,0,4500
10821,-6800,1200,0,-2000,-950,-8550
10822,7500,8400,0,-2000,0,13900
10823,-4200,1000,0,-2700,750,-5150
10824,13000,5100,0,11000,0,29100
10825,-2000,-5300,0,-4700,750,-11250
10826,9900,-5200,0,200,-1200,3700
10827,8000,7600,0,-1000,0,14600
10828,-5800,-600,0,10000,-950,2650
10829,7900,12000,0,200,-2150,17950
10830,-2000,-4600,0,9100,1950,4450
10831,9900,-5300,0,-3900,1950,2650
10832,-400,7600,0,-2000,0,5200
10833,9400,-1500,0,-3900,1950,5950
10834,-3700,10800,0,-4900,1950,4150
10835,13100,-6900,-1200,200,0,5200
10836,400,6700,-900,9000,0,15200
10837,10300,-800,3800,-7600,0,5700
10838,-1000,9700,-1200,200,0,7700
10839,-1800,100,0,11200,-1200,8300
10840,9400,12100,-1200,9400,-10200,19500
10841,-2900,-4400,-900,-1000,0,-9200
10842,-2500,-800,1000,-2800,12000,6900
10843,-1100,9800,2800,-3800,0,7700
10844,-1700,0,-10200,9200,0,-2700
10845,3300,12400,0,-1000,0,14700
10846,-2600,-2200,0,-1000,0,-5800
10847,8300,-2000,10800,-1600,-1200,14300
10848,-3700,6700,-1200,2400,-1200,3000
10849,-3700,-2200,-1800,-1000,0,-8700
10850,6100,11500,4700,-6600,-950,14750
10851,-5200,-2100,0,-2000,-950,-10250
10852,9500,0,-11400,7500,2900,8500
10853,7800,12100,0,-3900,1950,17950
10854,-900,100,12000,-1000,0,10200
10855,-3200,-4200,-1200,200,0,-8400
10856,8400,-2200,-1800,10000,0,14400
10857,-1400,-5300,4700,-4400,-1200,-7600
10858,9800,-5200,0,-1000,0,3600
10859,-3100,7700,-1200,-1600,-2150,-350
10860,6100,-1300,0,1200,-1200,4800
10861,-1900,-1400,0,7100,1950,5750
10862,-6700,12200,0,-600,-4300,600
10863,9900,-5200,0,-4900,2900,2700
10864,-2700,9800,0,-3900,1950,5150
10865,6700,-2100,0,11000,-950,14650
10866,-1100,6600,0,-5900,1950,1550
10867,7400,-2100,0,-2900,1950,4350
10868,-7000,8400,-1200,-800,0,-600
10869,7500,-1200,-900,8100,1950,15450
10870,-400,7500,1000,-4800,0,3300
10871,8800,-800,2800,-4600,-1200,5000
10872,-2700,-2200,0,12200,-1200,6100
10873,10200,12100,0,-3000,0,19300
10874,-1900,-3000,0,200,-2150,-6850
10875,10900,-2200,-10200,18400,-2150,14750
10876,1900,5200,-2400,-2500,2900,5100
10877,11100,-700,11100,-3700,-200,17600
10878,11000,-2300,-200,-3600,0,4900
10879,500,-2200,1600,-9500,1950,-7650
10880,-2500,10500,-2100,-800,-950,4150
10881,-2700,-1300,1000,-8700,2900,-8800
10882,-1900,-2200,2800,8400,-1200,5900
10883,-900,11300,0,-1000,0,9400
10884,9200,-2100,-2400,11400,-950,15150
10885,-3300,100,-900,-4000,-950,-9050
10886,7600,200,1000,-5700,2900,6000
10887,-7700,12100,1600,4500,1950,12450
10888,-6800,-600,-1800,9000,0,-200
10889,7600,-1400,4700,-5600,0,5300
10890,-4300,-2200,-1200,11200,0,3500
10891,11000,-2300,0,-2000,0,6700
10892,-5000,-700,0,-2000,0,-7700
10893,9300,200,0,12200,-1200,20500
10894,-1000,9000,0,-2000,0,6000
10895,7800,100,0,12000,0,19900
10896,-5100,1000,0,5200,-10200,-9100
10897,8300,-2000,-4500,2800,-1200,3400
10898,-3300,100,1000,-4800,12000,5000
10899,9700,-5200,-1400,-2400,-950,-250
10900,-4200,0,4700,-6600,0,-6100
10901,7500,9300,-3000,-4700,1950,11050
10902,-6000,1000,4700,-7400,-2150,-9850
10903,12600,-5400,0,7100,2900,17200
10904,-2800,-2900,0,-1000,0,-6700
10905,9200,9900,-1200,10200,0,28100
10906,-3600,-2100,1000,-2800,0,-7500
10907,7800,100,-8300,2600,-1200,1000
10908,-1100,9800,0,11200,-1200,18700
10909,11000,-3000,600,8400,0,17000
10910,-900,0,-1200,1200,-950,-1850
10911,9400,12000,-1800,-2800,-2150,14650
10912,-1600,-800,12700,-4300,1700,7700
10913,7700,900,2800,-6700,1950,6650
10914,-2400,-4300,0,-3000,-950,-10650
10915,-3900,-5100,0,-2000,-950,-11950
10916,6100,100,-1200,7300,2900,15200
10917,-4200,100,-900,-4900,1950,-7950
10918,1100,5200,-10400,5600,0,1500
10919,-300,-5300,400,10600,0,5400
10920,10600,-4400,9000,-1800,0,13400
10921,14200,-5400,4700,-7600,0,5900
10922,800,3000,-1800,11000,0,13000
10923,-2800,-3700,4700,-7200,-2400,-11400
10924,-5900,12300,0,-1000,0,5400
10925,-5900,200,0,-2000,-950,-8650
10926,-3500,-3000,0,12200,-2150,3550
10927,11500,7500,0,-4700,1700,16000
10928,-3700,-3600,-1200,9500,-200,800
10929,10300,12100,0,0,0,22400
10930,-4800,-3500,0,-3900,1950,-10250
10931,7000,11300,0,12000,-1900,28400
10932,14800,-6800,0,-4900,2900,6000
10933,-1000,-2300,0,-3900,1950,-5250
10934,-2100,9300,0,0,-950,6250
10935,9500,-700,0,8100,2900,19800
10936,-5000,11300,0,9200,-10200,5300
10937,-1300,-3600,0,0,0,-4900
10938,300,-4400,0,0,12000,7900
10939,6600,9000,0,0,0,15600
10940,-5900,200,0,0,0,-5700
10941,8400,10000,0,0,0,18400
10942,-3600,-2100,0,-1000,0,-6700
10943,-2800,9200,0,1400,-2400,5400
10944,4900,-2100,-1200,200,0,1800
10945,-3200,0,-900,0,-950,-5050
10946,10000,6600,1000,-2800,0,14800
10947,1200,-5400,2800,-5700,1950,-5150
10948,8300,9800,0,-2000,-950,15150
10949,7000,100,0,-2700,1700,6100
10950,2100,-4600,0,12000,0,9500
10951,8300,9100,0,-2000,0,15400
10952,-3300,0,0,0,0,-3300
10953,8500,12200,0,10200,-1200,29700
10954,-2800,-2200,0,-3000,0,-8000
10955,-3600,-3000,-2400,1800,-2400,-9600
10956,14100,-6900,-2100,1200,-950,5350
10957,-3800,9900,1000,-2800,-950,3350
10958,-400,-5200,400,-5300,1950,-8550
10959,10100,-3000,-1800,-4900,1950,2350
10960,-2700,9800,4700,-5600,-950,5250
10961,-900,100,0,7100,2900,9200
10962,13300,6700,-1200,-1700,1950,19050
10963,-1100,-2100,-12000,8200,0,-7000
10964,-3500,11400,4700,5400,0,18000
10965,-3700,-2000,12000,0,0,6300
10966,-3600,-2200,0,-3000,0,-8800
10967,400,7400,-1200,-800,0,5800
10968,13400,-5400,0,11000,0,19000
10969,-2700,-2200,0,200,-1200,-5900
10970,-3800,9100,-1200,1200,0,5300
10971,-5300,-3000,-1800,-1000,0,-11100
10972,7600,-2900,4700,-6600,0,2800
10973,-6700,13000,0,-1000,0,5300
10974,-4300,-2200,0,-1000,0,-7500
10975,13500,-2300,0,0,0,11200
10976,-2700,11300,0,11000,0,19600
10977,9100,-2100,0,-1000,0,6000
10978,7600,-2300,-2400,12400,0,15300
10979,3700,4300,0,-1000,0,7000
10980,-5200,300,-3000,1200,0,-6700
10981,11800,-3000,4700,-5600,0,7900
10982,5900,400,0,-1000,0,5300
10983,-2700,9100,-1200,200,0,5400
10984,-7700,1000,-900,-1000,0,-8600
10985,-2700,9700,1900,-1600,-1200,6100
10986,6200,0,1900,-3800,0,4300
10987,-1600,-6600,0,-2000,-950,-11150
10988,7000,-800,0,0,0,6200
10989,-2700,-2300,-1200,-3300,-450,-9950
10990,12400,-6100,0,9100,1950,17350
10991,-7800,13100,0,-1000,0,4300
10992,11500,-4400,0,200,-2150,5150
10993,-3900,6900,0,9000,-950,11050
10994,8500,-2900,-3300,-3300,1700,700
10995,-7700,200,-900,-1500,-450,-10350
10996,8500,9900,3500,-6200,-2150,13550
10997,-1600,-6700,-900,-2000,0,-11200
10998,10200,9000,-200,4500,1950,25450
10999,9200,-2100,1600,-2600,-1900,4200
11000,-500,-5300,-1800,7300,1700,1400
11001,11700,7400,3500,-8300,1950,16250
11002,-4300,-600,0,10000,-1900,3200
11003,6700,9100,0,-2900,2900,15800
11004,-3700,-1900,0,6300,-8250,-7550
11005,9900,7600,0,11000,-950,27550
11006,-5100,0,0,-3900,2900,-6100
11007,-1300,6000,0,-1000,12000,15700
11008,1800,1300,0,-2800,-1200,-900
11009,10100,9800,-2400,-600,0,16900
11010,-4200,-700,-900,11400,-2400,3200
11011,7900,0,1000,-3800,0,5100
11012,700,9700,2800,-3400,-3350,6450
11013,7500,200,-1200,-4800,0,1700
11014,400,-4400,-200,-5100,-1400,-10700
11015,6600,-2100,-9500,16900,750,12650
11016,-4300,-2900,-900,-1000,-950,-10050
11017,9400,-2200,1000,1500,-8250,1450
11018,-2600,0,12400,-7100,750,3450
11019,12300,6800,0,-800,-2150,16150
11020,-8500,300,-4200,-2500,13950,-950
11021,6100,12200,2900,6400,-950,26650
11022,-5000,100,4700,-10500,1000,-9700
11023,-6300,-1800,0,8100,2900,2900
11024,9700,-5200,0,-3900,1950,2550
11025,-4400,-2100,0,-800,-2150,-9450
11026,6400,-5100,0,8100,2900,12300
11027,-5900,12200,0,-2900,1950,5350
11028,13300,-4600,-1200,8400,-1200,14700
11029,-5200,9000,0,200,-1200,2800
11030,11000,-2300,0,11000,0,19700
11031,-1200,-5400,0,-2000,-950,-9550
11032,11600,7500,0,-800,-2150,16150
11033,11700,-3100,-10200,18300,2900,19600
11034,-1100,9800,0,-4900,1950,5750
11035,6900,100,9900,-800,-950,15150
11036,-4600,9200,1000,-3800,-950,850
11037,9200,-2200,2800,-5700,2900,7000
11038,-5300,-2100,0,8300,750,1650
11039,-2800,7400,0,-2000,0,2600
11040,6600,-2900,0,-1000,0,2700
11041,-4400,-2300,0,10000,0,3300
11042,12500,-5300,0,-1000,0,6200
11043,-3600,9800,0,200,-1200,5200
11044,6900,-600,-1200,13200,0,18300
11045,300,7600,0,200,-2150,5950
11046,6800,-600,0,0,0,6200
11047,11700,7400,0,-2900,1950,18150
11048,-6800,200,0,-3900,1950,-8550
11049,-7600,100,0,0,0,-7500
11050,13800,5200,0,-1000,0,18000
11051,1200,-7600,0,-1000,0,-7400
11052,6800,-700,0,-800,-1200,4100
11053,-1000,9800,0,12000,0,20800
11054,9200,-2900,0,-1000,-950,4350
11055,-1900,-3100,0,-1000,0,-6000
11056,9200,10800,-1200,-2700,1950,18050
11057,-6900,200,0,-1000,-950,-8650
11058,-5500,9300,-3000,-5700,2900,-2000
11059,9300,-2200,3500,-4200,-1200,5200
11060,-7000,-2100,-900,200,-1200,-11000
11061,14000,5200,3800,4400,0,27400
11062,-3500,-3100,0,-1000,0,-7600
11063,14200,-5400,-1200,200,-950,6850
11064,-2900,9800,0,11000,-950,16950
11065,9300,-2900,-10200,4500,1700,2400
11066,2800,5200,0,-2900,1950,7050
11067,-1800,-800,12000,0,0,9400
11068,-4200,12100,0,-2000,0,5900
11069,10400,0,0,-1000,0,9400
11070,-3500,12100,0,10000,0,18600
11071,-4200,100,0,-800,-1200,-6100
11072,9600,0,-1200,-600,-1200,6600
11073,-2700,100,-900,0,-950,-4450
11074,-4400,200,3800,-8600,-950,-9950
11075,7000,100,0,-2700,1700,6100
11076,-4200,100,-1200,-3700,1950,-7050
11077,9300,-2300,-1200,10200,-950,15050
11078,-3300,-700,-1800,0,0,-5800
11079,10200,0,4700,-9500,1950,7350
11080,-2800,-2200,0,11000,-950,5050
11081,12400,6700,0,6300,-7300,18100
11082,-2800,-1300,0,0,0,-4100
11083,12400,-6200,0,-1000,12000,17200
11084,-4500,10800,-1200,12200,0,17300
11085,-4000,-800,0,-1000,0,-5800
11086,-400,-2100,-2400,1400,0,-3500
11087,-1900,9800,-1800,200,-1200,5100
11088,12400,-5300,4700,-6600,0,5200
11089,-3400,200,0,-800,-1200,-5200
11090,10200,-2200,0,-1000,0,7000
11091,-2600,12100,0,-1000,-950,7550
11092,-6900,-400,0,11000,-950,2750
11093,13400,-4600,0,-4700,1700,5800
11094,-2700,9700,-1200,-2700,1950,5050
11095,-900,100,0,-3000,0,-3800
11096,8400,-800,-1800,-1000,0,4800
11097,-4000,0,4700,6400,0,7100
11098,10800,9000,0,-5000,0,14800
11099,-5200,1100,-1200,200,0,-5100
11100,-1200,-5200,0,0,0,-6400
11101,-4100,900,0,10000,0,6800
11102,7600,-1400,0,-2000,0,4200
11103,-3500,-2100,0,13200,-1200,6400
11104,-2800,10700,0,-800,-1200,5900
11105,6200,200,0,-1000,-950,4450
11106,-200,-2300,0,0,-950,-3450
11107,11100,-700,0,-4900,2900,8400
11108,-1800,100,-1200,-2700,1950,-3650
11109,9200,10000,-900,-3000,0,15300
11110,-2800,-2000,1000,-3800,0,-7600
11111,13300,-4600,2800,9200,0,20700
11112,-6000,-500,0,-4000,0,-10500
11113,-4100,100,0,200,-1200,-5000
11114,7700,0,-1200,11200,0,17700
11115,-2800,9900,-1200,-1600,-2150,2150
11116,-1200,-4500,-2400,1400,-950,-7650
11117,7800,100,-2700,8100,2900,16200
11118,1500,-3100,2600,-4400,-950,-4350
11119,11100,12000,4700,-9500,2900,21200
11120,-4400,200,-11400,9400,0,-6200
11121,10000,-4400,0,-800,-1200,3600
11122,-6900,-600,10200,1200,-1200,2700
11123,-5800,0,4700,-5600,-950,-7650
11124,-3600,-2000,0,11000,0,5400
11125,4200,12200,0,-3900,1950,14450
11126,-6900,200,0,-2900,1950,-7650
11127,12300,-6700,0,-1000,0,4600
11128,-2800,-3800,0,12000,0,5400
11129,9900,-3600,0,-3000,0,3300
11130,-6800,-1400,-1200,-800,0,-10200
11131,5900,10900,0,-1000,0,15800
11132,-1100,-5400,0,-1000,0,-7500
11133,8600,12200,-1200,12200,0,31800
11134,10700,-4500,-900,-1000,0,4300
11135,-2000,9800,1000,-4600,-1200,3000
11136,-2600,-600,2800,-4600,-1200,-6200
11137,4300,-600,0,-1000,0,2700
11138,8700,12900,0,-800,-2150,18650
11139,-4300,-2300,0,-2700,750,-8550
11140,600,-2200,0,11000,0,9400
11141,7600,-500,0,-4900,1000,3200
11142,7500,-2200,-10200,8200,-950,2350
11143,-2700,9800,0,-2900,1950,6150
11144,10200,-3900,12000,-4900,2900,16300
11145,-6200,-1100,0,0,0,-7300
11146,12700,-3100,0,10000,0,19600
11147,-8000,10100,-1200,-1800,0,-900
11148,6900,100,0,9200,-10200,6000
11149,-1400,-4500,0,-1000,0,-6900
11150,7500,9000,0,-1800,10800,25500
11151,-8400,300,0,-800,-1200,-10100
11152,10800,-5400,-1200,200,0,4400
11153,-4400,10800,-1800,-2000,-950,1650
11154,8400,-3000,4700,-7400,-2150,550
11155,500,-4500,-1200,-4500,1700,-8000
11156,6000,11500,0,-2700,-200,14600
11157,8700,100,-1200,11200,0,18800
11158,-1400,-5200,-1800,-3900,1950,-10350
11159,-3000,7600,4700,4400,-1900,11800
11160,11300,-6700,0,-4900,2900,2600
11161,11000,8900,0,-4700,750,15950
11162,-3300,100,-1200,13200,-950,7850
11163,11100,11200,0,-3900,2900,21300
11164,-900,-1600,0,12000,0,9500
11165,8500,1800,0,0,0,10300
11166,-5400,10100,0,-1000,0,3700
11167,11700,-4500,0,11000,0,18200
11168,-4900,-800,0,-1000,0,-6700
11169,-2700,0,-1200,200,0,-3700
11170,-5100,200,-900,0,0,-5800
11171,4300,12300,1000,-6800,0,10800
11172,-3300,100,1600,-1000,-3600,-6200
11173,9200,-2100,0,-1000,0,6100
11174,-300,-5300,0,-2000,-950,-8550
11175,5300,1000,0,8200,-1200,13300
11176,600,-3100,0,-500,-450,-3450
11177,11100,100,0,10200,-3100,18300
11178,-7000,12400,0,-2700,1700,4400
11179,8300,-2100,0,-3900,1000,3300
11180,-3500,-2100,0,0,-950,-6550
11181,9800,-4500,0,6100,2900,14300
11182,2100,-7700,0,-3700,-200,-9500
11183,12300,6800,-10200,10200,-950,18150
11184,700,-2300,0,-3900,1950,-3550
11185,10300,-800,12000,-4900,1950,18550
11186,300,7600,0,10200,-11150,6950
11187,-1900,-3000,-1200,-2700,2900,-5900
11188,-3100,6900,-900,-4900,13950,11950
11189,-3300,-700,1000,-5600,-2150,-10750
11190,-2800,10800,2800,-7700,2900,6000
11191,-4400,-2200,-1200,12400,-1200,3400
11192,-2700,9000,-1200,-800,0,4300
11193,9800,-5300,-4200,11400,-950,10750
11194,9300,-2200,4700,-7600,0,4200
11195,-4000,7700,100,-6700,1950,-950
11196,7500,-2100,2800,4500,750,13450
11197,100,-7400,0,0,0,-7300
11198,5300,12300,0,10000,0,27600
11199,-2600,-3100,0,-1000,0,-6700
11200,-3500,9800,-1200,12200,0,17300
11201,-6000,200,-1200,-800,0,-7800
11202,9500,-700,-11400,8400,0,5800
11203,-400,7500,100,-3800,0,3400
11204,10200,100,13600,-2600,0,21300
11205,-1000,9700,0,-800,-1200,6700
11206,11100,-1500,-3000,200,0,6800
11207,-3100,-3500,4700,-7600,0,-9500
11208,6900,100,-1200,10200,-950,15050
11209,-300,7500,-2100,1400,-2150,4350
11210,5000,-600,1000,-8700,2900,-400
11211,-1100,-5400,400,-4300,1950,-8450
11212,9700,-3500,1000,-3800,0,3400
11213,-2200,6600,1900,9400,-1200,14500
11214,-4900,-1600,0,-2800,-1200,-10500
11215,6900,-5500,0,13200,-2150,12450
11216,-5100,11400,0,-800,-1200,4300
11217,8400,-2300,-1200,9300,1950,16150
11218,-1700,9700,-2100,200,-950,5150
11219,7600,-3000,1000,-6700,1950,850
11220,-1800,-2200,2800,-6700,1950,-5950
11221,7600,12000,0,-3000,-950,15650
11222,-2600,100,-1200,-1700,2900,-2500
11223,9400,-2300,-900,20200,-10200,16200
11224,0,11200,2600,-6400,0,7400
11225,8400,200,0,-1000,12000,19600
11226,-3400,200,0,13400,-2400,7800
11227,9400,9800,-2400,-600,0,16200
11228,-2000,-2200,-2100,200,-950,-7050
11229,-2800,-2100,100,-5800,0,-10600
11230,9300,-3100,3800,-10500,1950,1450
11231,-400,-4400,1600,-3600,-950,-7750
11232,12300,-4300,0,-3900,2900,7000
11233,1400,5800,0,11000,0,18200
11234,-4700,-1100,0,-3000,0,-8800
11235,-2100,6800,0,13200,-1200,16700
11236,9000,-5100,0,-2000,0,1900
11237,400,-4500,0,11200,-2150,4950
11238,-1200,6800,0,-3900,1950,3650
11239,-4700,-5900,0,0,-950,-11550
11240,-1900,10700,0,8100,2900,19800
11241,4300,-1200,0,-800,-1200,1100
11242,-3600,10000,0,200,-1200,5400
11243,7400,-1100,0,-2800,-1200,2300
11244,-3400,-2200,-1200,-600,-2150,-9550
11245,10800,6600,0,0,-950,16450
11246,-300,-2100,-900,7100,1950,5750
11247,13300,6600,1400,-8100,1950,15150
11248,-1800,200,-3300,-2300,750,-6450
11249,9600,-1600,1000,5400,-10200,4200
11250,-3500,13100,1000,-7700,1000,3900
11251,-5300,9800,4700,-5400,-1200,2600
11252,9800,-5100,0,-3700,12750,13750
11253,-4500,10700,0,11000,-950,16250
11254,-2000,-6200,-1200,-4700,2900,-11200
11255,7800,900,0,-800,-2150,5750
11256,3800,5800,0,10200,-2150,17650
11257,8600,-700,0,-3700,1700,5900
11258,-6100,14000,-1200,8300,1000,16000
11259,11900,-2300,-1200,12200,0,20600
11260,-2800,-2900,-1800,-2700,750,-9450
11261,-2100,-4500,4700,-6600,-950,-9450
11262,-2500,0,0,9100,1950,8550
11263,9000,9200,0,-3000,0,15200
11264,-300,-4600,0,-4900,1950,-7850
11265,10900,9900,0,22200,-11150,31850
11266,-5300,-2900,0,-2900,2900,-8200
11267,-8500,400,0,0,12000,3900
11268,500,-4600,0,-2000,0,-6100
11269,4800,9400,0,0,0,14200
11270,-1000,-2300,0,11000,0,7700
11271,6000,11300,-1200,200,0,16300
11272,-1100,-4500,-1800,-2000,0,-9400
11273,7000,12100,3500,-4400,0,18200
11274,-500,-5300,0,-800,-1200,-7800
11275,9300,-2200,-1200,-800,0,5100
11276,0,0,-900,0,0,-900
11277,11100,0,1000,-2800,0,9300
11278,-1700,12000,1600,9400,0,21300
11279,7400,-1900,0,0,0,5500
11280,-5000,-700,-1200,-800,0,-7700
11281,500,-5400,-900,0,0,-5800
11282,-1800,12900,1000,9200,0,21300
11283,11000,-2200,2800,-2800,0,8800
11284,-7900,300,0,0,0,-7600
11285,8300,-2900,0,0,0,5400
11286,-1900,-2200,0,0,0,-4100
11287,-1900,9800,0,0,0,7900
11288,10800,-4400,0,0,0,6400
11289,-6600,-700,0,0,0,-7300
11290,-1900,-2100,-1200,200,0,-5000
11291,9400,9700,0,0,0,19100
11292,1400,-3000,0,-800,-1200,-3600
11293,8400,200,0,200,-1200,7600
11294,-5300,10100,0,0,-950,3850
11295,10700,-4300,0,0,0,6400
11296,-1900,-3100,0,-2900,1950,-5950
11297,-2600,-3100,0,0,0,-5700
11298,11700,9800,0,-4900,1950,18550
11299,-4500,-3000,-1200,1200,0,-7500
11300,6700,-1200,1000,-5600,-1200,-300
11301,-3000,6000,700,13000,-3600,13100
11302,-6100,-1200,-1200,200,0,-8300
11303,10100,-3000,0,9200,-11150,5150
11304,-2700,9900,-2700,-1000,-950,2550
11305,5100,400,5600,-7300,750,4550
11306,-3300,11200,0,-2900,13950,18950
11307,8300,-2100,0,-1000,-1900,3300
11308,-5900,11500,0,-2900,2900,5600
11309,5700,-1300,0,9100,1950,15450
11310,-1000,-2300,-1200,-800,-950,-6250
11311,-4800,-4900,-1200,-4700,2900,-12700
11312,12500,-4600,-900,-2900,1950,6050
11313,-2700,9100,3800,-5600,0,4600
11314,8400,-2200,0,11000,0,17200
11315,-2800,9900,0,-1000,0,6100
11316,6900,-600,0,-1000,0,5300
11317,-1400,-4500,-1200,10200,0,3100
11318,7700,-2100,-1200,1200,0,5600
11319,-1700,8900,-3000,-600,-1200,2400
11320,10200,100,4700,-5600,0,9400
11321,-900,12000,-1200,12400,-1200,21100
11322,9700,-4400,-900,0,0,4400
11323,-3600,-2000,1000,-2800,0,-7400
11324,7500,-2900,2800,-2800,-950,3650
11325,-1300,-4400,0,-2000,-950,-8650
11326,1700,-300,0,-3900,2900,400
11327,-2800,9100,0,12000,-950,17350
11328,100,-6600,0,-4900,2900,-8500
11329,11100,9700,0,-1000,0,19800
11330,-2700,-3000,0,-1000,0,-6700
11331,10200,9800,0,10000,0,30000
11332,-2600,-2300,0,0,0,-4900
11333,5900,11500,0,-2000,0,15400
11334,-1600,-7600,0,-3000,0,-12200
11335,8700,100,-2400,-600,0,5800
11336,6100,12100,-1800,-2000,0,14400
11337,-900,-2300,4700,-6400,-1200,-6100
11338,-3700,9900,0,13400,-2400,17200
11339,9200,-2900,0,-2000,0,4300
11340,-2700,-2300,-10200,9200,-950,-6950
11341,9300,12300,0,-1000,0,20600
11342,-6700,200,0,-3900,1950,-8450
11343,11600,-4500,12000,-2900,1950,18150
11344,-3700,-3600,-10200,8400,-1200,-10300
11345,8100,-3400,0,-2000,0,2700
11346,-3600,-2800,10800,1200,-950,4650
11347,9000,7600,0,0,0,16600
11348,1300,-4500,-1200,9300,1950,6850
11349,8400,8200,-1200,-800,0,14600
11350,-8500,300,-900,-2900,1950,-10050
11351,6200,11300,1000,-2800,0,15700
11352,-5800,900,2800,-2800,0,-4900
11353,12000,12000,0,-3000,0,21000
11354,4900,400,0,1200,-1200,5300
11355,-3600,-2000,0,12000,0,6400
11356,9300,-2200,0,-1000,0,6100
11357,-5900,-600,0,-1000,0,-7500
11358,-2900,-4500,0,-1000,0,-8400
11359,12300,7500,0,-3000,0,16800
11360,-5300,-3000,-1200,-600,-1200,-11300
11361,6200,200,-3300,-400,-1200,1500
11362,-600,7500,100,-3800,-950,2250
11363,7600,-3100,3800,-6600,0,1700
11364,-1300,-4300,2800,5300,1950,4450
11365,12400,6600,0,-1000,-950,17050
11366,-4700,-1900,0,-5700,1700,-10600
11367,6200,11300,0,10000,0,27500
11368,300,-6900,-1200,-800,-950,-9550
11369,10400,-800,-1200,-1800,0,6600
11370,-5300,11500,-1800,9100,1950,15450
11371,9000,-3500,4700,-6600,-950,2650
11372,10200,8900,-1200,8300,2900,29100
11373,-1900,-2200,-1200,-800,0,-6100
11374,-2500,0,-900,-1000,0,-4400
11375,5100,12400,1000,8400,-1200,25700
11376,-4900,100,1600,-1600,0,-4800
11377,8300,-2900,0,12200,-1200,16400
11378,11500,-4300,0,-1000,0,6200
11379,-500,-5300,0,0,-950,-6750
11380,6700,-2800,-1200,10200,0,12900
11381,-5100,10600,-3300,-300,750,2650
11382,3800,-4600,100,-2800,-950,-4450
11383,5800,11700,3800,-8500,2900,15700
11384,-3000,-4400,2800,-3800,0,-8400
11385,9900,6700,0,0,0,16600
11386,-4500,-2100,-1200,-800,0,-8600
11387,-1000,-3800,0,12200,-1200,6200
11388,7600,10700,0,0,0,18300
11389,-5000,-700,0,12000,-950,5350
11390,6600,-1900,0,0,0,4700
11391,-2600,9700,0,-2900,1950,6150
11392,7900,7900,-1200,-800,0,13800
11393,-7500,-600,-2100,-1700,1950,-9950
11394,9800,-4500,3800,-5600,0,3500
11395,-2600,-2200,0,-800,-1200,-6800
11396,11500,6000,-11400,10400,0,16500
11397,-1100,-2900,-1800,-1000,0,-6800
11398,9800,8400,16700,-4400,-1200,29300
11399,-2500,100,0,0,0,-2400
11400,8300,9200,-1200,-800,-950,14550
11401,-3300,0,0,-1000,0,-4300
11402,12400,-5400,-1200,10300,1950,18050
11403,-1100,10700,-900,-2900,1950,7750
11404,10100,-3000,3800,-5600,0,5300
11405,-1600,-800,0,0,0,-2400
11406,-7700,12900,0,-1000,0,4200
11407,-5100,200,0,-2000,0,-6900
11408,7600,-2200,-1200,400,-1200,3400
11409,-800,0,0,11200,-1200,9200
11410,10900,-3000,0,400,-2400,5900
11411,-900,100,0,200,-1200,-1800
11412,10000,9800,0,-1000,-950,17850
11413,-3600,-2000,0,-800,-1200,-7600
11414,-4300,200,0,-4900,1950,-7050
11415,12600,-5400,0,1200,-3100,5300
11416,-2000,-2200,0,-5900,2900,-7200
11417,-1700,10400,0,-1700,-200,6800
11418,7800,1000,0,12000,-950,19850
11419,2100,-4600,0,-3900,1950,-4450
11420,0,12000,-1200,-3700,1950,9050
11421,-3500,-500,-1200,10200,-950,4050
11422,5300,1000,-1800,-2900,2900,4500
11423,1300,-4500,4700,-12500,1950,-9050
11424,-4200,-800,0,1200,-1200,-5000
11425,-3600,300,0,-3900,1950,-5250
11426,7800,12100,-1200,11200,0,29900
11427,8500,-2200,-900,-1800,-1200,2400
11428,-2700,-3100,-200,-2600,0,-8600
11429,-6800,1100,2800,9200,-950,5350
11430,8700,-5100,0,-2000,-950,650
11431,-5000,200,0,8100,2900,6200
11432,8900,7600,-1200,-1700,1950,15550
11433,-3600,-2800,-900,12000,0,4700
11434,9200,-2900,-6400,3600,0,3500
11435,-2700,-1300,-1200,-600,-1200,-7000
11436,6000,11300,-1200,200,0,16300
11437,-3600,-2100,9000,200,0,3500
11438,7700,9800,3500,-5400,0,15600
11439,-5900,100,-900,200,-1200,-7700
11440,10100,-3000,1000,-3800,0,4300
11441,-6600,100,2800,-2800,0,-6500
11442,8700,100,0,11000,-950,18850
11443,-2700,11400,0,-2700,750,6750
11444,11700,-3700,0,200,-1200,7000
11445,2000,-4500,0,9100,1950,8550
11446,9400,-800,0,-1000,0,7600
11447,-3900,-4400,0,1400,-3350,-10250
11448,8900,6900,0,0,-950,14850
11449,-3400,-2200,0,-2900,1950,-6550
11450,9500,11300,0,-4900,1950,17850
11451,-2800,-2300,0,-1000,-950,-7050
11452,10900,9000,0,-2900,2900,19900
11453,400,-3600,0,8100,1950,6850
11454,7700,-700,0,-1000,0,6000
11455,2500,-9100,0,-1800,-1200,-9600
11456,-4200,-1500,-1200,200,0,-6700
11457,-2800,10000,0,10000,0,17200
11458,10100,-3000,-1200,2600,-2400,6100
11459,-5400,9900,-1800,-1000,0,1700
11460,12800,-10500,4700,-5600,-950,450
11461,-1200,9200,0,200,-1200,7000
11462,-1600,-7200,0,-5700,750,-13750
11463,-5400,-3600,-1200,200,-950,-10950
11464,4400,13100,0,7100,1950,26550
11465,-2100,-5400,-1200,400,-2150,-10450
11466,-2800,9900,0,-4900,2900,5100
11467,7700,-3100,-1800,-2900,1000,900
11468,-2100,6800,4700,4400,0,13800
11469,4800,-2000,-1200,-2700,1950,850
11470,-3500,-2900,-1200,11200,-950,2650
11471,3600,12100,-900,-4900,2900,12800
11472,-3800,-4300,-200,9600,-1200,100
11473,11000,9700,2800,-4800,0,18700
11474,-4200,100,0,11200,-1200,5900
11475,11800,9000,0,0,0,20800
11476,-3500,100,0,-1000,-950,-5350
11477,8700,12100,0,12000,0,32800
11478,10200,100,-1200,-3700,1950,7350
11479,-2600,12200,0,-3900,1950,7650
11480,2000,-6900,-1800,0,0,-6700
11481,9300,-600,4700,-7400,-1200,4800
11482,-5400,-2000,-1200,600,-2400,-10400
11483,12400,-4500,-10200,9200,0,6900
11484,6800,8200,0,0,-950,14050
11485,-1400,-3400,0,-800,-1200,-6800
11486,-4200,10400,12000,-2900,1950,17250
11487,-600,-5900,0,12200,-2150,3550
11488,10100,-3800,0,-2900,1950,5350
11489,-400,7600,0,0,-950,6250
11490,7000,200,0,-2900,2900,7200
11491,-1800,12100,-1200,-3700,1950,7350
11492,-5100,100,-1800,-1000,0,-7800
11493,8500,-2300,1900,-2800,0,5300
11494,1500,9700,2800,8200,0,22200
11495,9300,-700,0,-1800,-1200,5600
11496,-100,-3100,0,0,0,-3200
11497,10700,10900,0,10000,-950,30650
11498,-4100,100,0,-3000,0,-7000
11499,-1300,-4500,0,-2500,-450,-8750
11500,-7200,-2800,-1200,1200,-950,-10950
11501,-4400,-2100,0,-6900,2900,-10500
11502,7600,9900,-3300,400,-950,13650
11503,-1700,-7400,1000,6300,1950,150
11504,9300,-2300,2800,-3800,0,6000
11505,-2800,8400,0,-5900,1950,1650
11506,6900,300,0,200,-1200,6200
11507,-2700,9800,0,20200,-10200,17100
11508,500,-4500,-1200,-800,0,-6000
11509,9800,-4400,-900,-1800,10800,13500
11510,-4900,10500,1000,-2600,-1200,2800
11511,6500,-4400,1600,10600,-1200,13100
11512,-400,-4500,0,-1000,-950,-6850
11513,11800,9700,-1200,-2800,-950,16550
11514,-900,-800,-2100,-500,750,-3550
11515,10200,12100,3800,-8500,1950,19550
11516,-2400,0,0,-2000,-950,-5350
11517,11100,12100,0,-3900,2900,22200
11518,-3600,-1400,0,6300,750,2050
11519,-2700,-500,-1200,1200,0,-3200
11520,10600,-4400,-1800,-2000,0,2400
11521,-5000,-800,4700,5400,-950,3350
11522,-2600,-2200,-1200,-800,-950,-7750
11523,1200,5900,0,8100,2900,18100
11524,-4500,-1200,0,-4900,1950,-8650
11525,7000,100,0,-2000,0,5100
11526,-300,-2100,0,11000,0,8600
11527,10800,6700,-1200,1200,0,17500
11528,-800,-800,-900,11000,0,8500
11529,9300,13000,1000,-3600,-1200,18500
11530,-2700,-3000,2800,-2600,-1200,-6700
11531,11800,-2200,0,-800,-1200,7600
11532,0,0,0,-1000,-950,-1950
11533,-4500,300,0,10000,0,5800
11534,-4200,12200,-1200,-1700,1950,7050
11535,-2200,-5000,0,-400,-4550,-12150
11536,-2100,-3600,0,-4900,2900,-7700
11537,-3600,-2800,0,0,-950,-7350
11538,9900,-5200,0,10000,0,14700
11539,7800,200,0,-4900,1000,4100
11540,-1200,7500,0,400,-2400,4300
11541,-1100,-2900,0,-3900,1950,-5950
11542,10300,9700,0,-4900,1950,17050
11543,-2700,-600,0,10000,-1900,4800
11544,-3500,300,0,-4700,1700,-6200
11545,9200,9900,-10200,4300,1950,15150
11546,9300,-3000,0,200,-1200,5300
11547,-5300,10900,12000,-3900,1950,15650
11548,-5000,100,0,-2000,-950,-7850
11549,-4100,-800,0,11200,-2150,4150
11550,5000,12300,0,-3900,2900,16300
11551,-2800,-2100,0,-3700,750,-7850
11552,13300,-4600,0,12000,0,20700
11553,-5800,-600,0,-2800,-1200,-10400
11554,6900,-700,-1200,1200,-950,5250
11555,-7200,-1900,-1800,0,-950,-11850
11556,5800,10900,4700,3700,1700,26800
11557,-4400,-2200,0,-3900,1950,-8550
11558,10100,-3000,0,-1000,0,6100
11559,300,-6800,0,-1000,-950,-8450
11560,6700,10000,0,11000,-950,26750
11561,-3300,-800,0,-2900,2900,-4100
11562,-1200,-2100,-1200,8300,1950,5750
11563,10800,6700,0,-1000,0,16500
11564,11200,0,0,-4000,0,7200
11565,-1800,12100,0,400,-2400,8300
11566,10100,-2100,0,10400,-11400,7000
11567,-4300,-600,0,200,-2150,-6850
11568,7800,100,0,-2000,12000,17900
11569,-2700,-3000,-1200,-3700,1000,-9600
11570,9200,10600,-3000,1400,-2150,16050
11571,400,-4600,4700,-10500,2900,-7100
11572,7700,100,0,-3900,1950,5850
11573,-2400,-800,-11400,9400,-950,-6150
11574,13500,-2300,-1800,9100,2900,21400
11575,-1800,12100,16700,-6600,0,20400
11576,-2600,100,0,-1000,0,-3500
11577,7700,200,0,0,0,7900
11578,-400,-4500,0,11000,0,6100
11579,-3700,-2000,0,-3000,0,-8700
11580,7700,-3000,0,0,0,4700
11581,-5900,-600,-1200,-1800,0,-9500
11582,-400,6700,0,200,-1200,5300
11583,-2500,900,0,9200,-1200,6400
11584,6700,12300,0,-1000,0,18000
11585,-3600,-2100,0,0,-950,-6650
11586,5100,300,0,-3000,-950,1450
11587,1300,-5300,0,-3900,2900,-5000
11588,8500,-3000,0,-3900,1950,3550
11589,-5900,13000,0,0,0,7100
11590,6200,-1500,0,10000,0,14700
11591,10900,-1400,0,-1000,0,8500
11592,-2600,12200,0,-1000,0,8600
11593,9500,0,0,10000,0,19500
11594,-1100,-3000,0,0,0,-4100
11595,11500,-3700,0,-1000,0,6800
11596,-2000,-2900,0,-1000,0,-5900
11597,9300,-2200,0,-1000,0,6100
11598,-4200,100,0,-2000,0,-6100
11599,700,8900,0,-2000,0,7600
11600,-1800,100,0,0,0,-1700
11601,-2800,-2200,0,-1000,0,-6000
11602,7000,12100,0,11200,-1200,29100
11603,-1100,-2200,0,-2000,0,-5300
11604,-100,-2300,0,-1000,-950,-4350
11605,11100,-800,0,-800,-1200,8300
11606,-900,100,0,-3900,1950,-2750
11607,9500,12100,-1200,13400,-2150,31650
11608,-2600,100,0,-2900,2900,-2500
11609,-200,-2300,-1800,-1000,-950,-6250
11610,-1700,100,4700,4600,-10200,-2500
11611,8500,200,-1200,-2700,1950,6750
11612,-1800,-2200,0,-3900,13950,6050
11613,-1700,-1600,0,9200,-10200,-4300
11614,-6900,1100,0,0,0,-5800
11615,-1800,9700,-1200,-800,0,5900
11616,-2000,-2200,-2100,200,12000,5900
11617,10600,-4200,-1400,-3400,0,1600
11618,-1000,-2200,1000,-3800,0,-6000
11619,9300,-2900,4700,-6600,0,4500
11620,-5000,0,0,0,0,-5000
11621,-800,11200,0,11000,0,21400
11622,9300,200,0,10200,-10200,9500
11623,-4200,12100,0,-1000,0,6900
11624,7800,200,0,-2000,12000,18000
11625,-3100,-4500,-2400,1400,0,-8600
11626,9800,-4400,1000,-3800,0,2600
11627,-5300,-2700,1900,-3800,0,-9900
11628,7800,200,0,-1000,0,7000
11629,-2000,-4500,0,-3000,0,-9500
11630,2100,6700,0,200,-1200,7800
11631,10100,-2200,0,-2000,0,5900
11632,-5300,11400,-2400,13400,0,17100
11633,12200,-6700,-2700,-1000,0,1800
11634,-1300,6900,5600,-8600,0,2600
11635,-2700,-2200,-11400,11600,-1200,-5900
11636,-3900,-5300,0,-1000,0,-10200
11637,-1800,9800,10200,0,-950,17250
11638,8300,-2900,4700,-6600,0,3500
11639,-5400,-2100,-1200,10300,1950,3550
11640,5200,11400,0,0,-950,15650
11641,300,-8300,0,-3900,2900,-9000
11642,11300,6900,0,0,0,18200
11643,1700,-9800,0,-2000,0,-10100
11644,8300,9200,-2400,12400,0,27500
11645,-3600,-2200,-1800,1200,-1200,-7600
11646,-4100,-700,4700,-5600,0,-5700
11647,8300,9200,0,-1000,0,16500
11648,-3000,-4300,0,200,-1200,-8300
11649,5700,10000,0,-1000,0,14700
11650,-500,-5100,0,1200,-2150,-6550
11651,-2700,9700,0,12000,0,19000
11652,8400,-2800,0,-2900,1950,4650
11653,6200,12100,0,0,-950,17350
11654,-3500,-2200,0,-3900,2900,-6700
11655,1600,2200,0,200,-1200,2800
11656,5800,-2000,0,0,0,3800
11657,-2900,-5300,0,0,0,-8200
11658,-3500,9800,0,-2000,-950,3350
11659,5900,-700,0,-3000,-950,1250
11660,7500,10000,0,-2700,1700,16500
11661,-1900,-2200,-1200,-3700,1950,-7050
11662,9400,8900,-900,-1000,0,16400
11663,-2500,0,-200,8400,0,5700
11664,8600,-700,-7400,5400,0,5900
11665,-5100,13000,10800,200,0,18900
11666,9900,-2800,-10200,7200,0,4100
11667,-8000,10200,-1800,0,0,400
11668,6900,200,16700,-5600,0,18200
11669,500,-4600,0,-1000,0,-5100
11670,7800,11300,0,-1000,0,18100
11671,-5300,-2100,0,-2000,0,-9400
11672,7000,-1600,-2400,10600,-1200,12400
11673,-7700,13100,0,-1000,0,4400
11674,8400,-1400,-1800,-1000,0,4200
11675,-5300,-2100,4700,-4200,-3350,-10250
11676,6100,100,0,-3000,-950,2250
11677,-4900,-1500,-2400,-2500,2900,-8400
11678,3400,1000,0,-2900,1000,2500
11679,8600,9800,-1800,10000,-950,25650
11680,-5000,-1500,4700,1700,-7300,-7400
11681,7600,1900,0,-4900,1950,6550
11682,-7800,300,-10200,8200,12000,2500
11683,9000,-4500,-1200,-800,0,2500
11684,-2100,-5200,10800,1200,0,4700
11685,10700,-4400,-900,11000,0,16400
11686,-2600,-3000,1000,-3800,0,-8400
11687,11600,7500,2800,-2800,0,19100
11688,-2500,-700,0,-1000,0,-4200
11689,11700,9700,-1200,-800,0,19400
11690,-6900,100,0,-1000,0,-7800
11691,7600,-2300,0,11000,0,16300
11692,11100,9700,0,-1000,0,19800
11693,-3600,-1300,-1200,-2400,-2400,-10900
11694,8700,-5600,-1800,-2000,0,-700
11695,-5300,9200,3500,-7400,0,0
11696,6700,-2100,-1200,-1800,-950,650
11697,-2800,-3800,-1800,-800,-2150,-11350
11698,5600,10900,4700,-9500,2900,14600
11699,-4300,-2300,0,6100,1950,1450
11700,11600,6700,0,200,-1200,17300
11701,-4400,-2100,0,-2000,0,-8500
11702,11600,-4400,0,12000,-950,18250
11703,-2700,9000,0,-3000,0,3300
11704,11900,-3900,0,7100,1950,17050
11705,7700,200,0,-1000,-950,5950
11706,400,8400,0,-4900,2900,6800
11707,9900,-2900,-1200,10200,0,16000
11708,-4400,9100,-2400,600,-1200,1700
11709,9800,-3600,-1800,11200,-1200,14400
11710,-2700,9000,1100,-7000,0,400
11711,11500,-4600,-2100,-800,-950,3050
11712,-5000,-700,100,-2800,0,-8400
11713,10700,7500,3800,1500,1950,25450
11714,-6700,200,2800,-3800,-950,-8450
11715,11000,8900,0,-3900,2900,18900
11716,-1700,0,0,10000,0,8300
11717,10200,12100,0,-2000,0,20300
11718,-1900,-2300,0,10000,0,5800
11719,12000,0,-1200,-800,0,10000
11720,9400,100,-900,-1600,-2400,4600
11721,-1000,-2300,-200,9400,0,5900
11722,1200,-5400,2800,-5800,0,-7200
11723,-5100,200,0,-1800,-2150,-8850
11724,-4400,400,0,-2000,-950,-6950
11725,6700,10100,0,9100,2900,28800
11726,-3000,-4500,0,-4900,1950,-10450
11727,-4700,-5100,-1200,-1800,0,-12800
11728,9300,-3100,-900,11200,-1200,15300
11729,-2600,9000,1000,-4800,0,2600
11730,8300,-2000,2800,8200,0,17300
11731,-1400,7800,0,-1000,-950,4450
11732,10200,-2300,-1200,-2600,-2150,1950
11733,-4900,-700,-10200,19300,2900,6400
11734,13100,7600,0,-2900,1950,19750
11735,-5000,11200,0,0,0,6200
11736,9500,-800,10800,-1800,0,17700
11737,-4600,10900,-1200,-800,0,4300
11738,-2800,-2100,-1800,-1000,0,-7700
11739,8500,-2300,4700,4400,0,15300
11740,-2600,-600,-1200,1200,0,-3200
11741,-2800,-2100,-13200,9400,0,-8700
11742,7800,12100,4700,-7400,-1200,16000
11743,-4000,-4200,0,0,0,-8200
11744,11900,-2300,12000,-1000,-950,19650
11745,9400,-3000,0,-1000,0,5400
11746,-900,0,0,-4900,1950,-3850
11747,9300,12200,-1200,12200,-950,31550
11748,-3700,-2000,-900,-3900,2900,-7600
11749,9300,-2100,1000,-4800,0,3400
11750,-1000,-3100,2800,-2800,0,-4100
11751,-2800,-2200,0,-3000,0,-8000
11752,-4700,7000,0,22400,-11400,13300
11753,-6600,200,0,-1000,0,-7400
11754,9100,10000,0,-2800,10800,27100
11755,-4200,200,-1200,2400,-1200,-4000
11756,6200,-1600,0,-2000,-950,1650
11757,-2000,-1300,-2400,400,0,-5300
11758,4500,12100,-1800,-4700,750,10850
11759,-200,-2200,4700,-7600,-950,-6250
11760,11100,0,-1200,-5700,2900,7100
11761,-2600,100,0,-2000,-950,-5450
11762,10000,-2300,-1800,-2000,-950,2950
11763,-2700,-3000,4700,3500,2900,5400
11764,14100,-4500,0,-6900,1950,4650
11765,-4400,12200,0,13200,-1200,19800
11766,8700,-700,0,-3000,0,5000
11767,1100,-6900,0,11000,0,5200
11768,-2600,12100,0,-4000,0,5500
11769,13200,-6200,0,-800,-1200,5000
11770,-5100,1000,0,11000,0,6900
11771,-1800,9800,0,-1800,-1200,5000
11772,-1100,-2200,0,11000,-950,6750
11773,-2400,-1600,0,-1000,-950,-5950
11774,7500,1200,0,-4900,2900,6700
11775,-1200,7600,0,9100,1950,17450
11776,13000,-6700,0,8200,-10200,4300
11777,-100,-3100,0,-2000,0,-5200
11778,-3600,-600,-1200,1200,12000,7800
11779,-5900,12300,-1200,-1800,0,3400
11780,6700,-2000,-900,0,0,3800
11781,-1900,9800,1000,9200,0,18100
11782,-300,-4600,2800,-2600,-1200,-5900
11783,8500,-1500,0,0,0,7000
11784,-3600,-2000,0,0,0,-5600
11785,8400,10700,0,-1000,-950,17150
11786,-3700,-2800,-1200,200,-950,-8450
11787,9700,-4400,0,-3900,2900,4300
11788,-3000,6700,-1200,-3700,1950,750
11789,11100,-2300,-900,-800,-1200,5900
11790,2000,4400,1000,-4800,0,2600
11791,-2000,-2900,1600,8400,0,5100
11792,-500,7700,0,-2000,0,5200
11793,13300,-4500,0,-2000,0,6800
11794,-1300,-5200,-1200,13400,-1200,4500
11795,-3100,6000,-900,0,0,2000
11796,-6300,-1300,3800,-7600,-950,-12350
11797,-6300,9300,0,400,-2400,1000
11798,-100,-3100,-10200,5300,1950,-6150
11799,5300,-600,0,-1000,-950,2750
11800,-4500,10800,12000,-3900,1950,16350
11801,10200,-2300,0,-2000,-950,4950
11802,1300,6600,0,8100,2900,18900
11803,8900,-4300,-1200,-4500,750,-350
11804,3600,4300,-1200,8400,-10200,4900
11805,7100,100,-900,200,-1200,5300
11806,-2700,9000,1000,-4600,-1200,1500
11807,-2800,-2100,2800,-3800,11050,5150
11808,8400,-2200,0,12000,0,18200
11809,-200,9000,0,-4700,750,4850
11810,6300,-4400,-1200,1200,-950,950
11811,-1200,7500,0,9100,1950,17350
11812,10100,-2900,0,-1000,0,6200
11813,-4500,9200,0,-3900,1950,2750
11814,-5900,100,0,-1000,0,-6800
11815,3400,-500,-1200,9300,1950,12950
11816,-1800,10600,-1800,0,0,7000
11817,14800,-7700,4700,-6400,-1200,4200
11818,-1900,9800,0,-1000,0,6900
11819,8600,-700,0,-3000,0,4900
11820,600,9000,-1200,200,0,8600
11821,6900,900,0,12000,0,19800
11822,-1900,-2900,-1200,200,0,-5800
11823,10100,10700,0,11000,0,31800
11824,-3300,-1500,100,-2800,0,-7500
11825,-4400,1000,2800,-3800,0,-4400
11826,14000,5200,0,400,-2400,17200
11827,-5200,-600,0,-800,-1200,-7800
11828,10600,-4400,0,200,-2150,4250
11829,-1900,-3800,0,200,-2150,-7650
11830,-7100,10800,-1200,-4700,1950,-250
11831,-2700,-2200,0,-4900,1950,-7850
11832,8500,-3800,-1200,8300,1950,13750
11833,-4400,10600,-1800,-800,-3100,500
11834,-3300,100,4700,-7100,500,-5100
11835,10100,9800,0,8100,1950,29950
11836,10200,100,0,-1000,-1900,7400
11837,-3300,-700,0,-4900,1950,-6950
11838,9300,200,0,8100,2900,20500
11839,-2800,-2300,-1200,-4700,1950,-9050
11840,3500,12400,0,11000,0,26900
11841,-400,-4600,0,0,0,-5000
11842,-5000,100,-1200,-1800,0,-7900
11843,8300,-3100,-1800,11000,0,14400
11844,6200,-800,4700,-5600,0,4500
11845,-1300,-3500,0,-800,-1200,-6800
11846,9200,9100,-10200,8200,0,16300
11847,-4100,100,-1200,1600,-2400,-6000
11848,11700,-2200,0,-1000,-950,7550
11849,-900,11300,10800,-600,-2150,18450
11850,10100,-1400,0,-1500,-450,6750
11851,-1800,-700,-900,-4900,1950,-6350
11852,7500,-2100,1000,-3800,-1900,700
11853,-3700,-1900,2800,-8700,2900,-8600
11854,3700,5100,0,8300,750,17850
11855,-4400,-2900,0,0,-950,-8250
11856,10900,-3000,0,8100,1950,17950
11857,-3000,7700,0,-3900,1950,2750
11858,-5100,200,0,-2000,-950,-7850
11859,11900,8900,-1200,9300,1950,30850
11860,-3500,-800,0,-3900,2900,-5300
11861,-4400,9900,0,0,0,5500
11862,10100,-1300,0,11000,0,19800
11863,-5400,-2900,0,-1000,0,-9300
11864,-500,-4300,0,11200,-1200,5200
11865,3600,11200,0,0,0,14800
11866,-1200,-4500,0,-3000,0,-8700
11867,6100,200,-1200,-1800,0,3300
11868,-5100,12200,-900,1400,-2400,5200
11869,9200,-2100,1000,-3800,0,4300
11870,-1200,-4500,2800,-3800,-950,-7650
11871,-4700,-2700,0,-2800,-1200,-11400
11872,12500,-5300,0,-2900,1950,6250
11873,9300,9800,0,11000,-1900,28200
11874,-2800,-2000,-1200,-5500,1700,-9800
11875,-5000,-700,0,-3900,1950,-7650
11876,14100,7500,0,10000,-950,30650
11877,-2700,200,0,-5900,2900,-5500
11878,11900,8900,-2400,400,0,18800
11879,9300,100,-2100,11200,0,18500
11880,-3600,9800,1000,-2800,0,4400
11881,-300,-4500,1000,8200,0,4400
11882,400,-6200,4700,-5600,0,-6700
11883,-5200,1000,-1200,-1800,0,-7200
11884,9200,9000,0,-2000,0,16200
11885,-7600,-600,0,9000,0,800
11886,-5100,1000,0,0,0,-4100
11887,7000,12100,0,12000,0,31100
11888,-3000,-4400,0,-1800,-1200,-10400
11889,10100,-2300,0,-1000,0,6800
11890,-300,-5400,0,0,0,-5700
11891,6800,200,0,-2000,-950,4050
11892,-4200,11300,0,0,-950,6150
11893,9300,-3000,-10200,4300,2900,3300
11894,-3400,1000,0,-3900,1950,-4350
11895,8500,11300,12000,0,0,31800
11896,-8500,400,-1200,-600,-1200,-11100
11897,8100,-3400,-900,8200,-10200,1800
11898,-2800,-2100,1000,-2600,-1200,-7700
11899,5600,-2800,2800,-2800,12000,14800
11900,-6100,-2200,0,-3000,-950,-12250
11901,10900,6700,-1200,200,0,16600
11902,-7300,-2000,0,8100,1950,750
11903,-7600,-600,-1200,200,-950,-10150
11904,6200,12100,-10200,6300,2900,17300
11905,-2600,-3100,-1800,-1000,0,-8500
11906,11600,8300,4700,-6600,0,18000
11907,-1200,-4400,12000,200,-1200,5400
11908,7600,-3700,0,-2000,0,1900
11909,8400,-2100,0,-1000,0,5300
11910,700,-2300,-1200,200,0,-2600
11911,11100,11200,0,12200,-1200,33300
11912,-2600,12900,0,0,0,10300
11913,13200,-5400,0,0,-950,6850
11914,-5100,100,0,0,0,-5000
11915,9300,-2200,0,-2900,1950,6150
11916,700,-2300,0,0,-950,-2550
11917,9300,11400,0,-5900,2900,17700
11918,-6900,200,-2400,2600,-1200,-7700
11919,10100,-2200,-900,10000,0,17000
11920,-3100,7700,700,-1600,0,3700
11921,7100,100,1000,-2800,0,5400
11922,8500,-2900,1000,-3800,0,2800
11923,-400,-5300,1600,-4600,0,-8700
11924,-2000,9900,0,0,0,7900
11925,11200,0,0,10000,0,21200
11926,-2700,200,0,-1000,0,-3500
11927,8400,9900,-1200,1200,0,18300
11928,-2800,-2100,-2100,12200,0,5200
11929,3600,-1400,1900,-4800,0,-700
11930,-2200,-3600,-200,-1600,0,-7600
11931,-6100,-2100,1900,-2800,0,-9100
11932,13100,4300,-9500,6600,0,14500
11933,-2000,-2000,0,-1000,0,-5000
11934,6100,-1400,12000,-1000,0,15700
11935,-5900,12200,-1200,400,-1200,4300
11936,2700,1200,-1200,200,0,2900
11937,-100,9700,-900,0,-950,7750
11938,11700,-3000,1000,-5800,0,3900
11939,-3700,-2000,400,-6300,1950,-9650
11940,6200,100,-900,-3900,1950,3450
11941,-1200,9900,1000,-4800,0,4900
11942,11000,-3000,1600,8600,-1200,17000
11943,-4600,-1900,-1800,-3000,0,-11300
11944,11100,-2300,3500,-4400,0,7900
11945,-4300,12200,-1200,10200,0,16900
11946,11000,-2200,-11100,10200,0,7900
11947,8400,-1600,-200,-2600,0,4000
11948,-3300,900,14800,9200,0,21600
11949,-6900,12300,0,-2000,0,3400
11950,9300,-2200,0,0,0,7100
11951,1100,-6700,0,11000,0,5400
11952,6000,-500,0,0,0,5500
11953,-5000,-600,-1200,-800,0,-7600
11954,-5500,8500,0,-800,-1200,1000
11955,11800,-2200,-1800,0,0,7800
11956,-4300,-600,3500,-6400,-950,-8750
11957,8700,-700,0,0,0,8000
11958,-4500,10700,0,-5900,1950,2250
11959,7300,-2000,-1200,200,0,4300
11960,-5800,-800,-1800,7100,1950,650
11961,12400,-5200,4700,-4400,-1200,6300
11962,-2900,8400,0,-1000,0,4500
11963,8300,-2900,0,10000,0,15400
11964,-7100,-1900,0,-1000,0,-10000
11965,6700,-3100,-1200,11200,0,13600
11966,-4400,9900,0,0,0,5500
11967,10600,-4400,0,-1000,0,5200
11968,-6100,9100,0,400,-2400,1000
11969,-3800,-4400,0,-2000,0,-10200
11970,7500,-3100,0,-1000,-950,2450
11971,-4600,7600,0,-2000,0,1000
11972,9800,-5000,0,5300,-8250,1850
11973,-1300,6700,-1200,-800,-950,2450
11974,4400,400,-1800,-3900,2900,2000
11975,1600,3100,4700,-6600,12000,14800
11976,9400,-3100,0,8200,-10200,4300
11977,8400,9700,0,-3000,0,15100
11978,-4100,-800,-1200,200,0,-5900
11979,11200,12000,0,11000,12000,46200
11980,-3600,200,0,0,0,-3400
11981,8700,100,0,-1000,0,7800
11982,-2000,9800,-1200,10400,-10200,6800
11983,7800,0,-900,-1000,0,5900
11984,-7200,-2700,-200,-1600,12000,300
11985,6200,200,2800,-2800,0,6400
11986,-5800,12100,0,0,0,6300
11987,13200,-4500,0,0,0,8700
11988,-1900,-3100,0,-1000,0,-6000
11989,11000,-2200,0,200,-1200,7800
11990,-1800,0,0,1200,-1200,-1800
11991,11000,9700,0,200,-2150,18750
11992,-900,100,0,400,-2400,-2800
11993,6900,-800,0,-4900,1000,2200
11994,-2400,0,-2400,2400,-950,-3350
11995,10200,12200,-900,-3900,2900,20500
11996,-1000,-2300,1000,-5700,1000,-7000
11997,5000,300,2800,-5700,1950,4350
11998,2100,-6900,0,11000,0,6200
11999,10300,-700,0,-2900,1950,8650
12000,-2700,100,0,-2000,-950,-5550
12001,-1100,-2100,0,9300,1700,7800
12002,8500,9900,0,-1000,0,17400
12003,-6200,-2200,0,13400,-2400,2600
12004,-1100,-3000,0,-2000,0,-6100
12005,-1200,-5300,0,200,-2150,-8450
12006,8600,12200,0,-1000,0,19800
12007,10100,-2100,-1200,-3500,-200,3100
12008,-4300,200,-1800,-2000,-950,-8850
12009,8700,11300,-7900,3300,1700,17100
12010,-8800,1400,0,-2900,1950,-8350
12011,-7700,200,10200,-1000,-1900,-200
12012,6100,200,4700,-8500,2900,5400
12013,1400,-4600,0,8500,-450,4850
12014,10100,-3000,-1200,200,-950,5150
12015,-200,-4600,0,-3900,2900,-5800
12016,10000,-2300,-10200,22200,-950,18750
12017,-4200,11300,0,-2900,1950,6150
12018,8600,-700,12000,0,-950,18950
12019,-5200,13100,0,-4900,2900,5900
12020,-2700,-2100,-1200,1400,-1200,-5800
12021,8000,-4400,0,-1000,0,2600
12022,-3300,-700,-3000,-800,0,-7800
12023,7900,100,4700,6400,0,19100
12024,-1100,9800,0,-1800,-1200,5700
12025,10400,-800,0,-2000,0,7600
12026,-7000,-500,0,-1000,0,-8500
12027,6100,1000,-1200,12400,-2150,16150
12028,-2200,7600,-900,-1000,-950,2550
12029,11000,-2300,1000,-4500,750,5950
12030,-3300,100,2800,-6700,2900,-4200
12031,9500,-2300,0,-2000,-950,4250
12032,-4600,-1200,0,200,-2150,-7750
12033,10400,6400,-1200,6300,2900,24800
12034,-2700,-3100,-1200,-3700,1950,-8750
12035,8500,-2300,0,11000,0,17200
12036,700,8900,-1800,-1000,0,6800
12037,8500,100,4700,-5600,0,7700
12038,700,-2300,0,11000,0,9400
12039,10200,12200,0,-1000,0,21400
12040,-4400,-2200,0,200,-1200,-7600
12041,9500,-700,0,-2000,0,6800
12042,700,-3100,0,-2000,-950,-5350
12043,-4500,1200,0,200,-1200,-4300
12044,8600,11400,0,12000,-950,31050
12045,-4500,-1100,0,-4900,2900,-7600
12046,-1800,-2300,0,-2900,1950,-5050
12047,-1200,-5300,0,-2000,0,-8500
12048,-3300,100,0,-2800,-1200,-7200
12049,10100,-2300,0,-1000,0,6800
12050,-2100,9200,0,-4000,-950,2150
12051,7900,0,0,11400,-3350,15950
12052,-4400,12200,0,-4700,1700,4800
12053,7000,0,0,9100,1950,18050
12054,-2800,-2200,0,-1000,-950,-6950
12055,6900,-600,0,-6900,1950,1350
12056,-1200,-3600,0,-800,-2150,-7750
12057,5900,-600,0,-4900,2900,3300
12058,-2700,-2100,0,10000,0,5200
12059,8400,-3000,0,0,-950,4450
12060,-2300,8700,0,10000,-950,15450
12061,6200,-700,0,-3900,2900,4500
12062,-1200,-4500,0,-3900,1950,-7650
12063,-2200,7800,0,11000,0,16600
12064,5200,-600,0,0,0,4600
12065,-2100,-5100,0,-1000,0,-8200
12066,8500,9800,0,12000,0,30300
12067,-5100,-800,0,-1000,0,-6900
12068,7700,-700,0,-2000,0,5000
12069,-6000,13100,0,0,0,7100
12070,6700,-2100,-1200,-800,0,2600
12071,-500,7600,-1200,-600,-1200,4100
12072,8400,-2200,0,12000,0,18200
12073,-4600,-3500,-1800,0,0,-9900
12074,7500,-1200,4700,-6600,0,4400
12075,-5900,11400,0,-2000,0,3500
12076,9200,-3000,-2400,-600,0,3200
12077,-3600,-1200,0,-1000,0,-5800
12078,2500,12300,-13200,9400,0,11000
12079,-2400,0,4700,-6600,0,-4300
12080,5000,-2000,0,0,0,3000
12081,-5700,100,12000,-2000,0,4400
12082,15400,-9900,0,-1000,0,4500
12083,-2800,-2200,0,12000,0,7000
12084,6600,9300,-1200,200,0,14900
12085,-3900,-5000,-900,-1000,0,-10800
12086,10000,7500,-3000,1200,0,15700
12087,-700,-7500,5600,-5600,0,-8200
12088,6800,9800,0,-1000,0,15600
12089,-200,-3100,-10200,9400,-1200,-5300
12090,7500,9100,0,0,0,16600
12091,-3500,-2200,12000,0,-950,5350
12092,12600,-2200,0,0,0,10400
12093,-2000,9000,0,-4900,1950,4050
12094,4300,300,0,-2800,-2150,-350
12095,600,7400,-1200,-1700,2900,8000
12096,12600,-2300,-900,-1000,0,8400
12097,-2700,11400,-200,-4600,0,3900
12098,8700,100,2800,-3600,-1200,6800
12099,-3600,9800,0,12000,0,18200
12100,9500,-800,0,-3000,-950,4750
12101,-3400,900,0,0,-950,-3450
12102,8500,200,0,8100,2900,19700
12103,8700,-700,0,-3700,750,5050
12104,400,-3700,-10200,7400,-1200,-7300
12105,5800,-2700,-1200,-800,0,1100
12106,-3400,100,-1800,0,0,-5100
12107,7900,0,16700,-8600,-950,15050
12108,2900,7400,-2400,1400,-950,8350
12109,-2700,-600,-900,-6900,2900,-8200
12110,8400,-2000,1000,7500,750,15650
12111,6100,200,2800,-2800,0,6300
12112,-4400,9800,0,10000,0,15400
12113,-8500,-500,0,-2000,0,-11000
12114,12500,-4600,0,10200,-1200,16900
12115,-2500,12100,0,1200,-1200,9600
12116,9100,-2300,0,-1800,-2150,2850
12117,-2800,-2000,-1200,-800,-950,-7750
12118,-6000,-600,0,-3900,2900,-7600
12119,7000,100,0,8100,1000,16200
12120,-7600,12300,0,0,-950,3750
12121,7800,100,0,-6700,1700,2900
12122,1300,-4600,-1200,-1700,1950,-4250
12123,11200,-800,-1800,11000,0,19600
12124,-1800,100,4700,-7600,0,-4600
12125,11900,-2300,0,0,0,9600
12126,-900,12000,0,10000,0,21100
12127,8500,300,0,200,-1200,7800
12128,-1900,-2200,0,-1800,-1200,-7100
12129,9500,100,0,-1000,-950,7650
12130,-4600,-2100,-1200,12200,0,4300
12131,-2700,-2300,0,-3900,1950,-6950
12132,10800,-5300,0,-3900,1950,3550
12133,-2200,-4500,0,-800,-1200,-8700
12134,-5900,11400,0,0,0,5500
12135,7000,100,0,12000,-950,18150
12136,-2600,11200,0,-1000,0,7600
12137,6600,-1300,0,-1000,-950,3350
12138,-2600,-3100,0,-3900,1950,-7650
12139,11800,-2300,0,-3900,2900,8500
12140,-2600,12100,0,-1000,0,8500
12141,8300,-2100,0,-1000,0,5200
12142,-2500,-700,-1200,12200,0,7800
12143,-1900,-2300,-1800,-2000,0,-8000
12144,7600,300,4700,-6600,0,6000
12145,-900,9700,-1200,-600,-1200,5800
12146,12400,-4600,0,-2000,0,5800
12147,-1100,-2900,0,-2000,0,-6000
12148,14100,-4600,0,11000,0,20500
12149,-1800,11300,-1200,1400,-1200,8500
12150,-1100,-2100,-900,11000,0,6900
12151,-4200,-600,1000,-4800,0,-8600
12152,-2700,10700,1600,-2600,-950,6050
12153,100,-8500,0,-3000,-950,-12350
12154,-3600,-1200,-11400,6700,1700,-7800
12155,11900,8900,-5400,-3300,1950,14050
12156,-2600,0,13000,-4800,0,5600
12157,-100,-2300,1900,-4800,0,-5300
12158,10200,11300,-5500,15600,0,31600
12159,-4400,-2100,0,-1000,0,-7500
12160,-300,-2100,0,-800,-1200,-4400
12161,10100,9900,12000,0,0,32000
12162,-1900,-3000,0,11200,-1200,5100
12163,-6100,400,0,-1000,-950,-7650
12164,-400,-5200,0,0,-950,-6550
12165,8400,10000,0,6300,-7300,17400
12166,-3700,-2200,0,-3900,1950,-7850
