Months,CHN,SEA,EAS,USA,EUR,Total
0,100,200,-3900,-600,-1200,-5400
1,-900,-5200,200,-1000,0,-6900
2,200,-2800,-800,-2000,0,-5400
3,1100,-5200,800,-3600,0,-6900
4,-2600,9500,-3600,-12000,0,-8700
5,200,-5400,2000,-7800,0,-11000
6,-5800,-5300,2100,15200,-1200,5000
7,-3700,3600,-9000,1000,0,-8100
8,9200,-3600,3900,-3800,-950,4750
9,-6300,10000,16800,-13600,-2150,4750
10,8400,3700,-2000,-2700,2900,10300
11,100,-2600,-2600,-2700,750,-7050
12,1100,-9000,4500,15600,-10200,2000
13,-3600,7200,2000,-12000,-950,-7350
14,11200,3700,-100,-800,-950,13050
15,-2000,-9200,4700,-2700,13700,4500
16,-2700,4600,3900,-2000,-950,2850
17,-2800,-9100,1200,11100,2900,3300
18,-3800,7200,1900,-7800,-1200,-3700
19,12000,9300,-10900,10000,0,20400
20,-3000,6600,-1700,-7000,-950,-6050
21,-2700,-8400,2900,14000,0,5800
22,11200,-6600,12100,-1900,1950,16750
23,0,7300,-9000,9000,-950,6350
24,0,600,2600,-9700,2900,-3600
25,-3000,-600,9300,12000,0,17700
26,0,4500,-8000,-1000,0,-4500
27,-9400,100,2900,15000,0,8600
28,9100,-600,8300,-1000,0,15800
29,-6400,-2800,4800,12200,-1200,6600
30,9200,12200,100,0,0,21500
31,-8500,100,2000,-800,-1200,-8400
32,11300,0,-3400,-600,0,7300
33,-3800,-2500,-1700,15000,-950,6050
34,11100,-5200,-2500,-2000,0,1400
35,-4600,-3600,4800,-4700,750,-7350
36,-3800,-1100,4600,-6600,-2150,-9050
37,12100,-11900,1100,-2900,2900,1300
38,-900,-2700,-2000,11400,-1200,4600
39,-4800,-9100,5800,1200,-2150,-9050
40,0,5800,2000,-3000,-950,3850
41,-4600,4600,200,100,1950,2250
42,7200,18700,-1100,-11700,1950,15050
43,-2700,6400,1000,0,-950,3750
44,8400,-2600,1100,9100,2900,18900
45,-3000,6600,-13500,-2900,1950,-10850
46,-3600,3600,8500,7400,-10200,5700
47,8200,-2700,12900,-800,-1200,16400
48,-2000,3800,-2200,5600,10800,16000
49,0,-2500,200,-4600,-1200,-8100
50,-6600,6900,-4300,5200,-2150,-950
51,9200,-5400,4800,7400,0,16000
52,100,-3500,2000,-8700,1950,-8150
53,0,-4100,4600,-7800,-1900,-9200
54,-7500,1000,3700,1300,2900,1400
55,13100,-5200,-1600,4100,1950,12350
56,0,-1700,300,400,-12350,-13350
57,0,-6300,900,5500,2900,3000
58,0,4500,1100,-10000,12000,7600
59,-2700,700,2900,1000,0,1900
60,0,-6000,3000,-3800,0,-6800
61,0,4400,2000,2000,0,8400
62,-3000,3800,-9800,-1000,0,-10000
63,11300,-5900,-700,10200,-1200,13700
64,-3000,4400,2000,4000,0,7400
65,-2900,1000,16800,-14800,-950,-850
66,-2800,-600,-1300,12000,-2400,4900
67,11200,4200,-800,-10900,1950,5650
68,-5500,6800,-100,200,-1900,-500
69,-4500,-3500,-2700,-1900,2900,-9700
70,12200,1900,4000,-6700,1950,13350
71,200,-6300,3800,-5800,-950,-9050
72,-1900,-6400,2900,9100,2900,6600
73,-900,4300,-8000,-1800,0,-6400
74,100,15800,800,9400,-10200,15900
75,-1700,-3600,13000,-2000,0,5700
76,-5800,7400,-10100,13200,12000,16700
77,10300,-6300,800,-600,-1200,3000
78,1100,-8300,13700,11200,0,17700
79,-2700,5600,3800,9200,-1200,14700
80,0,6400,-11100,-600,-1200,-6500
81,-3800,-2800,2800,14000,0,10200
82,9000,11200,12000,2000,-950,33250
83,100,9300,-1900,1000,0,8500
84,-5700,9200,2900,-1900,1950,6450
85,-4700,-600,-1800,11100,1950,5950
86,13100,10300,-5400,-14000,0,4000
87,0,-11400,6700,10200,0,5500
88,-900,-6400,2900,-800,0,-5200
89,200,10100,-3700,1000,0,7600
90,-5700,900,6700,1000,0,2900
91,12200,200,-5100,-600,0,6700
92,-3900,-3600,2900,12200,0,7600
93,-4700,-2700,900,1000,0,-5500
94,11200,6800,-1600,9200,-1200,24400
95,-3000,-5200,-2800,1400,-1200,-10800
96,0,800,3000,2200,0,6000
97,-3700,-3600,3000,-4800,-950,-10050
98,-2600,1700,7600,1200,-2150,5750
99,9100,3800,-10100,-2500,1700,2000
100,0,-9300,2000,11100,1950,5750
101,0,10200,-2700,-12000,-950,-5450
102,-800,-8700,12300,11000,-950,12850
103,1100,-6200,-1800,6100,2900,2100
104,-2800,13800,1100,-2700,-8250,1150
105,-3700,900,-100,5200,0,2300
106,6300,-2500,1100,-800,12000,16100
107,0,800,-5200,10000,0,5600
108,-2800,-3400,-10000,8200,0,-8000
109,10400,-1400,15800,0,0,24800
110,1100,1100,2400,800,-1200,4200
111,-3000,-3600,12100,1000,0,6500
112,-6400,-2800,2600,12200,-950,4650
113,-3700,15600,2000,-10000,-950,2950
114,7300,3900,1100,-10700,1700,3300
115,5400,-3400,800,9300,1950,14050
116,-900,-2800,2000,-4800,0,-6500
117,-2800,18500,1900,4200,-1200,20600
118,12000,-800,-1800,-800,-1200,7400
119,200,4500,3800,-1000,0,7500
120,-3900,-700,-900,23200,-11150,6550
121,1000,7300,-900,-11800,-2150,-6550
122,-3900,-5600,2900,11300,1700,6400
123,-1900,-3500,0,-1900,13950,6650
124,11200,-2700,-800,11000,-950,17750
125,200,6300,1900,-1000,-950,6450
126,0,6400,-4500,-12900,2900,-8100
127,100,-9100,7600,-6500,750,-7150
128,-2900,10000,-1200,8400,-10200,4100
129,-2800,-3200,-700,-1000,0,-7700
130,-2700,-2500,200,9000,11050,15050
131,-3700,6700,-800,-700,750,2250
132,8300,-2400,-1600,7000,-950,10350
133,-8400,9400,-1900,-10300,500,-10700
134,5400,-2800,4500,400,0,7500
135,12100,-5200,-2600,10000,-950,13350
136,100,-9000,3000,-4000,0,-9900
137,-3000,-9200,3600,11500,750,3650
138,-3000,5600,2700,-1600,-950,2750
139,-600,-1200,4700,-14900,1950,-10050
140,12100,13000,2000,-9800,-2150,15150
141,-5700,-3500,-9200,20700,500,2800
142,100,4700,-1600,-14900,1950,-9750
143,200,3700,14800,-1400,-2400,14900
144,100,3600,-9000,-2000,-950,-8250
145,100,-8600,1900,9100,1950,4450
146,100,4100,-13700,9400,-950,-1050
147,0,-9000,14100,-4900,1950,2150
148,-3700,10200,200,-5300,750,2150
149,9100,900,5700,-11600,-2150,1950
150,-3000,-2400,7600,10100,2900,15200
151,300,3700,2900,-16800,-950,-10850
152,-900,-9100,2100,10200,-950,1350
153,-5600,-5400,-1400,-500,2900,-10000
154,200,12800,3600,-3700,1950,14850
155,5400,-6400,800,15400,-1200,14000
156,9400,1700,2100,-10000,0,3200
157,-800,800,5700,0,0,5700
158,200,-9100,2900,-1000,-950,-7950
159,1000,4300,-800,2000,-950,5550
160,-900,800,5700,-13900,2900,-5400
161,200,-500,-4500,6100,1950,3250
162,-1700,4600,2900,-13000,0,-7200
163,-2800,6800,-1600,1400,-2400,1400
164,7300,-2800,2000,-800,0,5700
165,-2900,-8800,1100,13000,0,2400
166,-2600,3800,2100,-800,-2150,350
167,12300,100,5800,-4000,-950,13250
168,-5800,200,-800,12300,1700,7600
169,-7300,-3500,2900,-2900,1950,-8850
170,13100,11200,-2700,8000,-950,28650
171,-2900,7200,5600,-11800,0,-1900
172,-2900,21200,-2200,300,1950,18350
173,11300,-3600,0,-2800,-2150,2750
174,-900,-2800,-2300,9700,1700,5400
175,1000,6400,4700,-3800,0,8300
176,0,12200,-1800,-3000,0,7400
177,-3000,-5500,800,15200,-950,6550
178,-2900,-5400,100,2000,-950,-7150
179,-2700,6800,-2600,-1900,2900,2500
180,5500,-3500,-3200,-1500,1950,-750
181,-800,1600,6400,-3400,-1200,2600
182,1100,-12000,2100,11200,-1200,1200
183,-5800,7300,-7200,-1600,0,-7300
184,-800,-3600,4700,7400,-1200,6500
185,12000,7200,9300,-8000,-950,19550
186,-5800,6600,-8000,14000,0,6800
187,11300,-6100,11300,-4900,1950,13550
188,-2900,4600,200,1100,1950,4950
189,0,3600,5700,-15600,-1200,-7500
190,-2700,-700,1000,11000,0,8600
191,0,7400,-14700,12200,-950,3950
192,0,-7800,-600,-2000,0,-10400
193,-2800,-9200,14100,12100,1950,16150
194,8200,4500,200,-9000,-950,2950
195,-2700,-1800,6700,-3900,2900,1200
196,-6600,-700,200,400,-1200,-7900
197,12100,-1400,6600,1000,0,18300
198,0,9500,-12700,-2000,0,-5200
199,-2900,-3500,-900,14000,0,6700
200,0,1700,3000,0,0,4700
201,-900,6600,14000,-13600,-1200,4900
202,-5600,-3500,1000,15200,-1200,5900
203,9000,7500,-2600,-8800,-2150,2950
204,-3500,6600,2000,-2800,0,2300
205,-4400,-2700,1000,-4700,750,-10050
206,11200,-11300,3900,12200,-3100,12900
207,-5700,9500,-8900,6300,2900,4100
208,11200,-6300,2000,-3700,-200,3000
209,200,7200,7400,2000,0,16800
210,-800,-12000,2900,-900,1950,-8850
211,-4600,-2500,0,10200,-950,2150
212,-6500,18800,-2600,-12900,2900,-300
213,6200,3800,-6100,9100,1950,14950
214,-4400,-5300,-700,12200,-1200,600
215,13000,-2100,6700,-12800,0,4800
216,-5800,-3600,14000,14000,-950,17650
217,11200,1700,3900,-12000,0,4800
218,-2800,3700,200,1100,1950,4150
219,-3600,-6400,4800,-1000,-950,-7150
220,12000,10200,-1800,-1900,2900,21400
221,-2800,-6300,1000,12000,0,3900
222,-3800,-2500,-3600,2000,0,-7900
223,1000,12900,3900,0,0,17800
224,200,3400,-9100,-800,0,-6300
225,-2900,-2800,2800,11400,-1200,7300
226,5900,-800,900,-3000,0,3000
227,-4700,200,9300,16400,-2400,18800
228,10100,-5500,-900,12200,-1200,14700
229,-2600,8500,1800,-4600,-950,2150
230,-3800,1700,4800,4200,-1200,5700
231,8500,-3500,1900,-7900,1000,0
232,1100,7400,-3000,1200,-950,5750
233,-2900,3800,1100,-12700,1950,-8750
234,-3000,-5200,-700,9100,2900,3100
235,7600,3700,900,-14700,1950,-550
236,-1700,-6200,2900,9200,0,4200
237,-3000,4400,2900,-11000,0,-6700
238,-3400,3800,1800,200,0,2400
239,9200,-5100,-2600,-1800,0,-300
240,0,-8800,300,10000,0,1500
241,100,900,3000,-800,-1200,2000
242,-3900,3700,5500,-600,0,4700
243,6400,6500,800,3200,-950,15950
244,-1800,900,1800,-10600,-1200,-10900
245,-1700,-5500,0,10100,1950,4850
246,8100,3800,1100,-9000,-950,3050
247,-1800,3900,2100,-3900,2900,3200
248,-3000,-5500,-100,3200,0,-5400
249,8400,3600,4800,-1000,0,15800
250,-9400,9600,-1900,-7600,-1200,-10500
251,3400,3600,-3300,12000,0,15700
252,-1600,100,-900,-800,-1200,-4400
253,7200,-700,100,12000,-950,17650
254,7400,-2400,7300,13200,-950,24550
255,-2700,6500,2700,-2700,2900,6700
256,-1600,3900,-9900,5100,1950,-550
257,8600,-2700,100,-3000,0,3000
258,-2700,-9100,3800,11000,0,3000
259,-5600,4600,13100,2400,-2400,12100
260,-800,6700,-10700,-3800,0,-8600
261,12000,-11800,3700,12200,0,16100
262,-3000,1800,12900,-10800,-950,-50
263,-9200,9200,-6400,10400,-2150,1850
264,9300,1000,-10000,300,1950,2550
265,-700,-5600,12800,6300,2900,15700
266,12000,1100,-9700,0,-950,2450
267,-6700,-3300,2100,10400,-2150,350
268,1000,1800,16600,-6500,2900,15800
269,7300,-3200,-700,-2700,1950,2650
270,-1900,-6300,14000,9200,0,15000
271,-2800,13800,4000,-12000,0,3000
272,-3600,3400,2600,4400,-1200,5600
273,9000,-700,-12000,12200,0,8500
274,200,10200,-2700,-4800,0,2900
275,200,3700,2700,-2600,-950,3050
276,-9500,-2700,6700,12600,-3350,3750
277,12200,700,4000,-4900,2900,14900
278,-2800,100,-2000,10500,750,6550
279,-3900,9200,1000,1200,-950,6550
280,12200,-5400,13700,-4600,-2150,13750
281,-3000,-2700,-1100,13500,1700,8400
282,-2900,1200,300,-12900,1950,-12350
283,100,-6300,-1000,12200,-950,4050
284,-3700,-11300,7600,-2700,750,-9350
285,-6300,-700,2000,10000,0,5000
286,9200,22000,0,-11900,1950,21250
287,9200,-800,0,11000,-950,18450
288,-1800,200,-2700,9000,-950,3750
289,-600,6800,-1900,-4700,2900,2500
290,-3000,-2800,2000,6300,1950,4450
291,-800,-6300,4800,-3800,0,-6100
292,11200,-9400,3800,12000,0,17600
293,-2000,22600,-6300,-8800,-1200,4300
294,0,4100,-2500,2200,-1200,2600
295,-3000,-5300,2100,-800,0,-7000
296,4500,-6200,2100,12400,-2400,10400
297,1000,1900,1200,-10800,-2150,-8850
298,100,-11800,4800,12000,-950,4150
299,-5800,-600,-2000,-2700,1950,-9150
300,7600,14000,2100,-1900,1950,23750
301,-2000,9300,-3900,-7800,-950,-5350
302,-3600,800,4000,-3700,2900,400
303,8500,-5500,1500,7500,1950,13950
304,-1800,600,2700,-8800,0,-7300
305,100,-6300,1700,6400,0,1900
306,-6400,4500,1000,-7000,0,-7900
307,5400,3600,3900,1000,0,13900
308,6300,-3400,1100,1200,-1200,4000
309,100,1600,4700,0,0,6400
310,-3700,3700,1000,6200,-2150,5050
311,9100,-3500,100,0,0,5700
312,0,7200,2900,-4700,1950,7350
313,0,-6500,1900,2000,0,-2600
314,0,-500,-4500,6100,1950,3050
315,-2800,1700,3800,-11000,0,-8300
316,-2800,6200,2900,13000,0,19300
317,-800,6800,-1700,-11000,0,-6700
318,9100,9400,-13600,13000,0,17900
319,-5700,-5200,1100,14000,0,4200
320,11200,-5500,14000,-3000,0,16700
321,-3000,3900,1200,2200,0,4300
322,0,-8500,2000,2000,0,-4500
323,0,-6200,1100,10000,0,4900
324,-3900,-9000,3000,3000,0,-6900
325,-5600,19500,-700,2000,0,15200
326,10200,3800,1800,-13400,-1200,1200
327,-1800,-6300,0,13400,-2400,2900
328,-4800,-5400,900,1200,-950,-9050
329,11200,900,600,1400,0,14100
330,-2800,15600,-6200,10200,-950,15850
331,0,-5400,1100,-4900,1950,-7250
332,-3600,3800,-8200,6500,1950,450
333,9300,-6200,8900,1200,-950,12250
334,100,1800,-100,-2700,1950,1050
335,-9200,6600,-1100,-9700,2900,-10500
336,12000,-9300,14700,9400,0,26800
337,0,-8100,900,200,0,-7000
338,-5800,21400,-8900,9200,0,15900
339,-6600,6400,2900,4200,-1200,5700
340,9300,-5400,11700,-3600,0,12000
341,8400,3700,-13300,16600,-1200,14200
342,-5800,-6100,1200,1000,0,-9700
343,11200,7400,11300,-1800,0,28100
344,-2900,-9100,5700,12200,-950,4950
345,-5800,-6300,3900,1400,-3350,-10150
346,-1600,16400,2000,-3900,2900,15800
347,13000,-2100,4800,-10700,750,5750
348,0,-14800,3700,12200,-950,150
349,0,7400,-2600,-10800,-2150,-8150
350,0,-2100,7600,-1700,2900,6700
351,-3800,-6100,1100,-5700,1000,-13500
352,1000,7500,-11900,10200,-950,5850
353,-6600,3600,2700,-12700,2900,-10100
354,-5600,-3400,12200,9100,1950,14250
355,9300,4700,1800,-10800,0,5000
356,-1700,-8900,-2500,12000,0,-1100
357,9600,-3600,-1600,-1200,-1200,2000
358,300,19200,200,-4600,-1200,13900
359,-1700,-9000,2900,-400,-2400,-10600
360,-5800,3700,-6100,12000,0,3800
361,7500,9200,-100,9200,-950,24850
362,-5600,6500,3900,-10800,-950,-6950
363,3400,3700,17800,100,1950,26950
364,11200,-2600,200,-6700,1950,4050
365,-2900,-3500,2800,10200,-950,5650
366,0,18600,-11700,4300,-7300,3900
367,-2800,-2600,3900,3500,750,2750
368,-3700,-3500,11100,12000,0,15900
369,9000,200,-2900,-1400,10800,15700
370,0,13000,3700,-1400,-1200,14100
371,-4600,-8300,2900,2200,-1200,-9000
372,10300,-9400,4800,12200,-2150,15750
373,-2600,-500,-2700,-2800,-2150,-10750
374,-3800,16700,200,1100,1950,16150
375,9300,6500,-3700,-12900,1950,1150
376,0,-6300,4800,8400,-3100,3800
377,-5700,-5600,4800,10100,2900,6500
378,-3500,-3500,900,-6700,1950,-10850
379,12100,19300,-100,-5500,1950,27750
380,-6600,-2700,2900,2200,-2150,-6350
381,6200,9500,-1700,-700,1700,15000
382,-2800,-2500,200,-1000,-950,-7050
383,-1600,-2500,-3500,9000,0,1400
384,10000,-3400,200,-5700,1950,3050
385,-2800,4600,6700,-4800,0,3700
386,0,-11200,0,700,-450,-10950
387,-3000,900,4800,2200,-1200,3700
388,11200,3600,-6400,8400,-950,15850
389,-2900,-2500,-800,1000,-950,-6150
390,-3900,6400,100,2300,1700,6600
391,1000,-3500,11100,-6900,1000,2700
392,-3600,3600,1700,6200,-950,6950
393,8300,7400,1100,-14900,2900,4800
394,-1700,-3600,2900,5300,750,3650
395,-3800,-5400,-100,3600,-2400,-8100
396,11100,8700,-6300,14000,-950,26550
397,1000,1700,-3300,-6800,0,-7400
398,-2900,-5500,100,11100,1000,3800
399,-6700,6500,14700,-10600,-950,2950
400,200,-6100,-700,6100,2900,2400
401,8400,900,4800,-13900,1950,2150
402,1100,4600,-1900,-1600,-2150,50
403,-2700,-8500,3600,8700,-8500,-7400
404,-5800,3800,-7000,13000,0,4000
405,8500,9300,-1800,1000,11050,28050
406,-4700,-700,14600,-4400,0,4800
407,13100,4700,-10700,9000,-950,15150
408,-900,-8200,1200,-5900,2900,-10900
409,-4800,6400,17600,-2300,-450,16450
410,200,-2900,-900,10200,-10200,-3600
411,0,-3400,-1700,11000,0,5900
412,-3700,-5500,2000,1000,-950,-7150
413,9000,18500,1900,100,13950,43450
414,-3600,6700,200,-12000,-950,-9650
415,-2800,-2700,2000,6300,2900,5700
416,9100,-2800,100,12000,0,18400
417,0,-3600,2800,-2000,0,-2800
418,-600,10100,-1900,-1000,0,6600
419,100,-2900,-1800,0,0,-4600
420,-2000,-5300,-2000,14200,0,4900
421,-2800,-500,200,-3600,-1200,-7900
422,-6500,4700,1100,3000,0,2300
423,12000,-5400,200,-1000,0,5800
424,-7300,-3600,4800,11200,-1200,3900
425,9300,-2700,-100,-1800,0,4700
426,-4700,18500,3800,-1800,0,15800
427,10600,-2600,-1900,6400,-11150,1350
428,-7500,200,-700,11000,-950,2050
429,8200,900,4800,300,13700,27900
430,-900,-11000,2800,-4700,1950,-11850
431,-2800,5800,-11700,13000,0,4300
432,9100,2000,-7900,-800,0,2400
433,0,-8000,11400,8000,0,11400
434,-1700,3800,-100,-9800,0,-7800
435,-1000,-11800,5800,10000,0,3000
436,-6400,10100,11900,-11800,0,3800
437,9300,6700,-1900,2400,-1200,15300
438,-6600,800,-2400,13000,0,4800
439,12200,-8300,-100,-2800,-950,50
440,0,700,6800,11200,0,18700
441,-900,-6400,-2000,300,1950,-7050
442,1000,7500,13100,-2800,-950,17850
443,-4800,1000,2100,-12700,1700,-12700
444,-1000,-6300,-100,13200,0,5800
445,-1500,4500,3800,-15800,0,-9000
446,7200,-6200,3000,14000,0,18000
447,0,15800,-9100,10200,0,16900
448,-3800,-2500,-2600,2000,0,-6900
449,9000,900,16800,4000,0,30700
450,-700,-3400,-1700,-3000,0,-8800
451,1000,4500,2900,-800,-1200,6400
452,-3900,4100,-11600,2000,0,-9400
453,-2800,-3300,-3600,14200,-1200,3300
454,-700,4500,14000,-13800,-950,3050
455,8200,-2000,6700,2000,-950,13950
456,2100,-9000,2000,6300,1700,3100
457,0,4200,-200,-10500,750,-5750
458,-3000,-3200,1200,6400,-950,450
459,-2700,-6400,3800,-1800,-1200,-8300
460,-3700,19300,1000,-700,750,16650
461,12100,6300,-14200,3400,-950,6650
462,-2900,3600,-8000,10100,1950,4750
463,100,-5300,13000,-3900,1950,5850
464,-2800,3400,2000,4000,-950,5650
465,8200,6500,-800,-12700,1700,2900
466,0,-6200,16800,9600,-2400,17800
467,0,7200,-3600,-7800,-1200,-5400
468,0,-9000,3900,10000,-950,3950
469,-3000,-6300,-100,12300,1950,4850
470,-700,16700,2000,-14800,-1900,1300
471,1300,6400,-3800,-4700,1700,900
472,0,-12200,5700,-700,750,-6450
473,-2900,4600,-1100,4200,-950,3850
474,11200,4100,-12800,-5700,1950,-1250
475,0,-9000,900,11200,-950,2150
476,-2900,1700,15900,-13900,2900,3700
477,-3700,-3500,800,6300,1950,1850
478,-6300,7300,500,3400,0,4900
479,12100,3700,200,-13000,0,3000
480,-1900,-9000,3600,8400,0,1100
481,0,-2700,-2900,200,0,-5400
482,-3800,900,5800,1200,0,4100
483,12100,5500,100,-1000,0,16700
484,-2700,4600,2700,-1600,0,3000
485,-2900,9600,-1700,-10800,0,-5800
486,-3000,6500,-10700,9200,0,2000
487,11200,-11200,9200,-2600,0,6600
488,-2900,3700,10900,4200,0,15900
489,-900,-6300,-800,2000,0,-6000
490,-5500,7300,3900,-3000,0,2700
491,12400,700,0,-7800,-1200,4100
492,-3700,-8700,-1600,12000,0,-2000
493,-1800,-2700,1100,9000,-950,4650
494,0,3000,3000,-1000,0,5000
495,-3900,-6300,1100,10100,1950,2950
496,12200,-1200,7600,-12000,-950,5650
497,0,5400,1900,9100,2900,19300
498,0,-600,-1800,9200,-10200,-3400
499,-5800,22200,-1700,4000,0,18700
500,0,9400,100,-13800,12000,7700
501,-8600,-400,1200,10400,-1200,1400
502,-700,4500,-100,-13800,0,-10100
503,9200,-5500,2700,13200,0,19600
504,8400,6500,2000,-1000,0,15900
505,-3800,-5400,1000,0,0,-8200
506,1100,9400,-4600,0,0,5900
507,-3700,-2600,2100,-4800,0,-9000
508,6600,-9000,-200,13400,0,10800
509,-2800,-2800,3600,-4600,0,-6600
510,11200,12800,4800,0,0,28800
511,-2900,-5400,-1100,2400,-1200,-8200
512,0,6500,4800,-5600,0,5700
513,100,3800,-4700,-7800,-950,-9550
514,-3000,-5600,4800,9200,-950,4450
515,0,3600,2900,-13900,2900,-4500
516,0,-9300,2900,15000,-950,7650
517,100,200,-1800,5100,2900,6500
518,100,9300,-4000,-11800,0,-6400
519,200,3700,-2700,15000,0,16200
520,-3600,-9300,3900,1000,0,-8000
521,9200,-8300,5800,11000,0,17700
522,-5700,-6400,2600,3200,0,-6300
523,-7500,11500,-1700,11200,-1200,12300
524,6600,10300,200,-10800,-1200,5100
525,12000,3900,200,0,0,16100
526,-3800,3800,-100,2200,-950,1150
527,-2300,3800,2000,-3000,0,500
528,5400,-700,-800,-3500,750,1150
529,-2500,4600,-8000,11200,-2150,3150
530,12100,-14000,4900,-2700,1700,2000
531,200,3800,-1700,1000,-950,2350
532,-2800,-6100,15700,-5600,-950,250
533,100,4500,100,-1900,2900,5700
534,-9300,9200,5700,-13700,1950,-6150
535,9000,-5600,-7300,20200,0,16300
536,8500,9200,-900,-12000,0,4800
537,-3400,6500,-13000,12400,0,2500
538,200,-11200,16000,8200,0,13200
539,1000,-3300,-700,-5800,0,-8800
540,-5500,4300,19600,1200,0,19600
541,10300,-700,-2700,-2000,0,4900
542,1200,6600,-8100,15400,-10200,4900
543,-3900,9400,-5000,3400,0,3900
544,-2000,-8000,12300,12200,10800,25300
545,0,-6300,3900,8200,0,5800
546,-3700,4500,2000,-9000,-950,-7150
547,12000,-9100,-7500,20400,0,15800
548,0,1000,-7000,-4900,1950,-8950
549,-2900,3700,2600,16200,-950,18650
550,0,3500,12100,-11900,2900,6600
551,0,-3600,1000,12000,0,9400
552,0,4600,14000,-13000,0,5600
553,0,6600,-800,1200,-1200,5800
554,-3800,-6300,1000,15000,0,5900
555,-2000,6500,100,-9000,0,-4400
556,8300,7400,100,200,0,16000
557,-2700,3700,2900,-10800,-1200,-8100
558,-3500,-8600,3800,15000,0,6700
559,8200,-500,-3700,200,-1200,3000
560,-2400,-3400,-2800,9000,-950,-550
561,-2700,13700,1000,-7800,-2150,2050
562,11100,-5400,2100,4300,2900,15000
563,1000,-6400,2000,-4900,1000,-7300
564,-8600,-3500,6700,11200,-950,4850
565,8300,16600,2000,-13700,1700,14900
566,200,6400,-11000,7100,1950,4650
567,-2800,-5200,-1700,12000,0,2300
568,-2900,6500,-1400,-2200,-10200,-10200
569,5800,0,13900,7200,0,26900
570,-3700,6300,2000,-9600,-1200,-6200
571,8500,-5600,2900,10000,12000,27800
572,-1800,-3500,3900,-5800,-950,-8150
573,-6600,7300,2900,5000,0,8600
574,12000,-2600,-5700,10300,1950,15950
575,100,-2800,1000,-5800,-950,-8450
576,-9200,6400,-7400,9300,2900,2000
577,8200,-5400,800,10600,-10200,4000
578,-6300,-2600,13100,10000,0,14200
579,10000,1000,3000,-9000,12000,17000
580,200,700,-9900,11000,0,2000
581,-3000,-2600,1100,-600,-1200,-6300
582,-4500,6600,-6100,9400,-1200,4200
583,9200,-3400,9300,1200,-1200,15100
584,-4500,7300,1900,-800,0,3900
585,-800,-9100,15900,9000,-950,14050
586,9000,4500,2900,-8000,-950,7450
587,0,-3700,-2700,11100,2900,7600
588,0,-5600,3500,-3700,1950,-3850
589,-6600,21300,100,4200,-1200,17800
590,5400,100,-1200,2200,0,6500
591,200,-5400,1100,9000,-950,3950
592,8100,-5500,-100,2400,-1200,3700
593,-4800,-3500,2000,10300,750,4750
594,-800,-3500,2900,-3800,-950,-6150
595,9000,19600,-2600,100,2900,29000
596,-6500,-5700,-6300,11200,-950,-8250
597,12200,-3600,1700,7400,-950,16750
598,-3000,4500,12800,-10700,2900,6500
599,-3900,3700,800,300,1950,2850
600,-5500,200,-1300,-2600,0,-9200
601,9400,6800,-12800,10200,0,13600
602,-6600,-5300,-9000,11200,0,-9700
603,12100,-9100,14900,11200,-1200,27900
604,-3000,-2600,-1700,1000,0,-6300
605,0,-2000,16000,1200,0,15200
606,0,3600,7600,7200,0,18400
607,-3600,6500,-2000,-6600,-1200,-6900
608,9100,6500,-800,3000,0,17800
609,-2800,-6100,2100,-3000,-950,-10750
610,-10300,7200,6700,3400,-2150,4850
611,13000,-800,0,-5900,2900,9200
612,100,10100,-1900,1000,-950,8350
613,-3000,-2500,-2600,-1900,2900,-7100
614,8400,-5300,3000,11200,-1200,16100
615,-900,9400,-4500,-11000,0,-7000
616,-4600,-2700,2900,8200,-950,2850
617,11200,-6100,3000,-4800,0,3300
618,-3800,-5500,-2000,13200,-950,950
619,-1800,-6600,2900,20500,-8500,6500
620,100,19300,2900,-17700,1950,6550
621,8200,6600,2000,2200,12000,31000
622,0,-5600,3800,-4000,0,-5800
623,100,-3600,-2800,14000,0,7700
624,100,7200,1000,-12800,0,-4500
625,-2800,-5500,2900,11000,0,5600
626,0,800,1100,3200,-1200,3900
627,-900,-2800,100,-1000,0,-4600
628,-2000,6500,1900,3200,-2150,7450
629,100,-800,-1900,-1000,-950,-4550
630,-6500,7300,2900,100,2900,6700
631,9200,0,0,-6700,750,3250
632,-900,0,0,12200,-1200,10100
633,1000,0,0,-1000,0,0
634,100,0,-1000,9000,-950,7150
635,-4700,-5600,-7300,11200,-950,-7350
636,13100,-3600,-2800,12300,1700,20700
637,-5700,7500,1300,9100,1950,14150
638,-7300,-2700,3900,-1000,-950,-8050
639,10000,-3500,12100,12000,0,30600
640,-3000,-5500,2900,300,750,-4550
641,11400,-700,-1900,10000,0,18800
642,-3900,16500,2000,-13700,750,1650
643,1200,-5500,-12500,21600,0,4800
644,-2800,-3600,2900,11000,-950,6550
645,-4600,-3400,13000,200,0,5200
646,13200,3700,-3700,9100,1950,24250
647,-2800,-2500,-700,-2000,-950,-8950
648,-5800,15800,3000,2100,2900,18000
649,8200,-6300,1100,0,0,3000
650,-900,4600,3000,-400,-2400,3900
651,-2000,3800,3000,-10600,-1200,-7000
652,-2900,-2700,1000,8200,-950,2650
653,-800,3700,2000,-11000,0,-6100
654,6200,-800,2900,8300,1950,18550
655,-3000,7500,-800,-8000,-950,-5250
656,5700,-2500,2100,6100,2900,14300
657,-3700,-5500,2000,400,-1200,-8000
658,9100,3700,2900,1000,0,16700
659,0,-3500,-1100,-800,-950,-6350
660,-3000,7200,-8100,15200,-1200,10100
661,-2900,-400,7200,9300,1950,15150
662,11300,4600,-11700,-1000,-950,2250
663,-2800,-5400,3900,9100,2900,7700
664,-2800,-6400,10100,-800,0,100
665,200,4600,2000,-2800,0,4000
666,-6400,900,1800,-8800,0,-12500
667,8300,-9000,2900,12000,0,14200
668,-2500,1600,6700,-15000,0,-9200
669,9100,-3400,-5400,17600,0,17900
670,-6700,3700,-6100,0,0,-9100
671,11400,-5400,1100,6400,-1200,12300
672,-7600,18600,-100,4400,-1200,14100
673,8200,-8200,12600,2600,-1200,14000
674,-2800,6500,3900,-2800,-950,3850
675,8400,-6100,-2700,2200,-2150,-350
676,-2800,-6400,3600,5500,750,650
677,-3000,9200,-8500,6900,750,5350
678,-2700,6500,-1700,2000,-950,3150
679,10400,2900,6600,-9700,1950,12150
680,1100,4500,11800,-2700,1950,16650
681,-3000,-6100,200,12000,-950,2150
682,-900,-9200,3600,-4500,1700,-9300
683,-8500,22100,100,1100,1950,16750
684,11400,-600,-4100,-6400,-950,-650
685,-2900,-2800,4400,7800,-2150,4350
686,-5400,9300,-1900,-700,1700,3000
687,12000,-8200,1200,8100,1950,15050
688,-3000,900,4800,2000,-950,3750
689,-6400,-3600,5700,-1000,-950,-6250
690,11100,10400,-3600,-3900,2900,16900
691,100,9400,-5400,-15900,1950,-9850
692,-4800,-2700,6400,6600,0,5500
693,-800,-5600,2900,-800,-1200,-5500
694,8200,-6400,2800,14000,0,18600
695,-2000,7300,100,-9000,0,-3600
696,200,9200,-100,-1800,0,7500
697,-3700,200,-3600,1000,0,-6100
698,12000,-5600,7600,5400,0,19400
699,-900,400,-5400,-2000,0,-7900
700,-4800,3700,3600,4200,0,6700
701,-3700,-2700,-900,10200,0,2900
702,12200,-2800,2000,-5800,0,5600
703,0,600,3800,15400,-11400,8400
704,100,-3500,-3000,-1600,0,-8000
705,100,-5600,700,12200,-950,6450
706,-3000,-6200,1100,2000,12000,5900
707,0,3800,1800,7300,1950,14850
708,200,6500,-800,-13800,-950,-8850
709,-4700,3000,2900,9100,2900,13200
710,-1500,7300,700,-2600,0,3900
711,3400,3800,4000,-9800,-1200,200
712,-4700,3700,-10400,15400,0,4000
713,9100,-5400,200,-1000,0,2900
714,1000,3700,3900,-2800,0,5800
715,-3700,-2700,14900,-1000,0,7500
716,9500,6800,-1700,-2000,0,12600
717,100,-9000,-1000,400,-1200,-10700
718,-3000,-5400,200,14200,-1200,4800
719,-3500,-9100,3800,-2000,0,-10800
720,-2800,6400,2000,14000,-950,18650
721,6300,3700,5700,2000,-950,16750
722,11200,11500,-2700,-5900,2900,17000
723,-3000,-5900,-2500,11100,1950,1650
724,-3000,19300,-1000,-9400,-1200,4700
725,200,-8300,1900,19200,-10200,2800
726,-6300,6500,-7000,-3000,-950,-10750
727,9200,-3300,3900,9400,-2150,17050
728,-4500,4500,-900,-10700,13700,2100
729,10200,-6300,13200,4300,1950,23350
730,0,4400,800,-9800,0,-4600
731,-700,-1900,1000,2000,-950,-550
732,-1700,-6500,3000,7600,-12350,-9950
733,-3600,-600,200,4300,2900,3200
734,12000,11100,-5100,8100,13950,40050
735,0,6400,-8000,5400,-10200,-6400
736,-2800,100,13800,9400,0,20500
737,-6600,6500,800,-9800,12000,2900
738,12000,400,7600,8200,0,28200
739,-3000,-5100,-600,-800,0,-9500
740,-900,-9100,6700,7400,-1200,2900
741,-1800,4600,3000,10200,-10200,5800
742,-6600,6700,1200,-12800,-950,-12450
743,11400,-12200,2600,12400,10800,25000
744,-1900,-2800,100,-2700,750,-6550
745,0,4000,1100,-1900,1950,5150
746,-3000,18900,-14400,0,-950,550
747,8500,-5400,-100,11200,0,14200
748,0,-6400,-1000,400,-950,-7950
749,-3000,-8400,16800,10100,2900,18400
750,-2800,15900,4000,-4700,1950,14350
751,5400,3900,1200,-7000,0,3500
752,-3900,-2700,3900,6400,0,3700
753,11300,1100,800,-11800,0,1400
754,-4800,-3300,-700,13000,0,4200
755,0,3700,-5900,-8400,-1200,-11800
756,-3600,4400,-1500,3400,0,2700
757,9400,600,16800,-9000,0,17800
758,-3500,-2500,-2600,8000,0,-600
759,-6500,6400,4800,-12600,-1200,-9100
760,10000,-3500,2900,8400,-1200,16600
761,300,7200,-1500,-1200,-1200,3600
762,-3800,-8400,2700,3200,-950,-7250
763,9000,6500,1900,1100,1950,20450
764,-3000,100,-1800,1000,-950,-4650
765,0,3600,3800,-3900,1950,5450
766,0,-800,-11400,7500,1950,-2750
767,-800,10100,-12800,10000,-950,5550
768,1100,-5400,12200,-7900,2900,2900
769,0,-8200,3000,0,0,-5200
770,-3900,-3500,1000,12000,0,5600
771,-1400,3800,2800,9200,0,14400
772,11100,-2700,-2100,1200,0,7500
773,-2700,-8600,16800,12000,0,17500
774,0,5600,2900,-3000,0,5500
775,0,-3500,-1100,12200,0,7600
776,-3800,22100,-2100,-11600,0,4600
777,11400,-6300,-2400,12400,0,15100
778,1100,-5500,-200,-1800,0,-6400
779,-5700,9300,-2000,12200,0,13800
780,-5600,-6300,5800,-1000,0,-7100
781,4600,9300,-7000,9400,0,16300
782,8500,9100,4700,-6600,0,15700
783,1000,-5600,800,-1800,0,-5600
784,-900,-6500,4700,9400,0,6700
785,1000,10200,-3700,-12000,0,-4500
786,0,-1900,5800,-11000,0,-7100
787,-800,200,8000,11200,0,18600
788,200,6600,-1800,-13000,0,-8000
789,-800,-8200,3000,10000,0,4000
790,-4500,6400,-9000,13000,0,5900
791,8200,-5500,-200,1200,0,3700
792,1000,800,3000,1000,0,5800
793,-6700,-6300,17700,1000,0,5700
794,300,10000,-3100,200,0,7400
795,12000,6700,-1000,-14600,0,3100
796,-2800,-2900,1100,11200,0,6600
797,0,-12100,4800,-1000,0,-8300
798,100,10200,-2100,-600,0,7600
799,100,9200,-1800,-800,0,6700
800,-2700,-5800,4700,-2800,0,-6600
801,0,-5500,2900,12000,0,9400
802,-6400,9200,1000,-12000,0,-8200
803,12000,-2800,1900,8000,0,19100
804,100,-700,-1900,1200,-1200,-2500
805,100,4200,-900,4000,0,7400
806,100,200,-2100,-3600,0,-5400
807,-2900,-5400,2000,11200,0,4900
808,100,-11300,1800,13200,0,3800
809,-6400,6500,-6100,8400,-11400,-9000
810,12000,-3400,100,11000,0,19700
811,200,1500,13000,-9000,11050,16750
812,-5500,9300,2000,0,0,5800
813,-6500,6700,-11700,-900,1950,-10450
814,12000,-5500,1100,11200,-2150,16650
815,-3600,-3500,3800,-3900,2900,-4300
816,9000,7400,1000,200,0,17600
817,-8600,400,-2800,2200,0,-8800
818,8400,6700,1100,1000,0,17200
819,-3800,-5600,14000,1000,0,5600
820,11100,-2700,500,9600,0,18500
821,1100,6600,-2600,-14000,0,-8900
822,-5800,-5300,4900,-800,0,-7000
823,-2800,-9400,3900,14000,0,5700
824,-3600,-2600,200,-1000,0,-7000
825,9000,1100,3900,4000,0,18000
826,0,2800,2100,-1800,0,3100
827,-900,-2800,1900,11200,-1200,8200
828,-3700,-800,0,1000,0,-3500
829,10100,21600,-6400,-10000,0,15300
830,-2800,4500,2700,-10800,-950,-7350
831,0,-11400,4800,13000,-950,5450
832,-3000,4100,-13400,12300,1700,1700
833,8400,-11000,4000,-2900,1950,450
834,100,6600,100,-15400,-2400,-11000
835,100,3800,1700,-2200,-1200,2200
836,0,-8200,1200,11000,-950,3050
837,0,-2000,3000,4000,-950,4050
838,-2700,-9300,17700,-4300,-450,950
839,-2800,4600,3000,2000,-950,5850
840,8200,3800,1100,-12900,1950,2150
841,0,-6300,2000,6100,1950,3750
842,-2700,100,-5000,300,1950,-5350
843,-800,3800,200,200,-2150,1250
844,1100,5700,0,8100,2900,17800
845,-3500,-8400,6700,-5900,1950,-9150
846,9200,18400,3800,-1000,0,30400
847,100,-3700,-4000,4200,0,-3400
848,-2900,7300,1000,200,0,5600
849,-800,3800,100,-10800,-1200,-8900
850,1000,-9000,-12100,23400,0,3300
851,-6400,4300,-7000,11000,-950,950
852,12100,3700,-7100,-2600,-1200,4900
853,0,-6600,14000,9300,1950,18650
854,-3900,7400,2900,-11800,-950,-6350
855,1000,9300,100,-7700,2900,5600
856,0,-700,2800,6400,0,8500
857,200,-5400,-900,9200,-1200,1900
858,-2800,12200,10300,0,0,19700
859,11300,-9100,3800,10000,-950,15050
860,-2700,-2700,12100,9000,0,15700
861,-6700,21300,-1000,-12500,1950,3050
862,-2700,-8300,3800,10300,750,3850
863,9000,3800,2000,-9000,0,5800
864,-4400,-800,0,11000,0,5800
865,10200,7500,2100,-13800,0,6000
866,-5700,-2800,1000,13000,0,5500
867,-600,-3500,1900,7000,0,4800
868,5500,10200,1100,-10800,-1200,4800
869,-2000,200,-4800,200,0,-6400
870,-700,-2500,3000,4400,-950,3250
871,9200,-5400,1800,-800,0,4800
872,-900,-2600,-1700,7100,1950,3850
873,-1800,9500,1200,-9500,1950,1350
874,-9400,-2700,600,2400,0,-9100
875,12100,-11900,800,14400,-1200,14200
876,0,1800,2100,-10800,-1200,-8100
877,-3900,3700,-100,2200,0,1900
878,12200,-3300,-3100,-3000,-2400,400
879,-2800,4400,3600,2200,-950,6450
880,-2800,700,2700,-8800,0,-8200
881,100,-9000,1100,8100,1000,1300
882,-4700,4500,2000,-10000,-950,-9150
883,10200,-6300,3600,7300,2900,17700
884,-2700,-6400,2600,10300,1950,5750
885,-4300,19300,-8200,-4800,-950,1050
886,13100,3800,-11100,-4700,2900,4000
887,-900,1000,4100,9000,0,13200
888,-2000,-8100,-9300,12400,0,-7000
889,-3000,-9100,13800,14200,0,15900
890,-3600,-3500,2900,11000,0,6800
891,9000,6700,10100,2200,0,28000
892,0,6900,-2500,-1800,0,2600
893,-3000,-8100,13200,1200,-1200,2100
894,-9400,5800,4900,14000,0,15300
895,-800,-9100,3900,-1000,0,-7000
896,10000,6700,-700,0,0,16000
897,11300,3700,6700,-17600,0,4100
898,100,8500,-900,-4000,0,3700
899,-3900,-5300,-1000,15800,-3600,2000
900,-4500,15700,-1200,-7800,0,2200
901,-1700,3700,-8900,11000,-950,3150
902,9400,-8600,3800,1000,-950,4650
903,-5400,-300,-3000,3700,1950,-3050
904,300,-6400,13900,-4900,1950,4850
905,8100,16500,-10000,1200,-950,14850
906,1200,1300,-11800,-4900,2900,-11300
907,-2900,-2600,11900,6500,1950,14850
908,-2800,6700,-4300,-11200,-1200,-12800
909,10300,-6200,1800,8600,-1200,13300
910,-4800,7700,7300,-5600,-1200,3400
911,-800,-12100,5700,10200,-950,2050
912,1000,1100,-8800,9000,-950,1350
913,-3700,6400,1000,-900,2900,5700
914,12000,1000,2100,-1900,1950,15150
915,100,-3500,15800,-7600,0,4800
916,-12100,10000,800,5200,0,3900
917,12000,-4900,5800,-9800,-1200,1900
918,200,3800,-9900,7200,0,1300
919,-6500,-5600,3800,4200,-2150,-6250
920,12000,600,14000,3200,-2150,27650
921,200,-8900,100,10300,1700,3400
922,-5600,7200,4800,-12900,1000,-5500
923,-4500,-3400,-700,-1000,0,-9600
924,13000,-6100,2100,4300,1950,15250
925,100,16500,3900,-1800,-950,17750
926,0,3900,-1600,-13900,2900,-8700
927,0,-11800,-1600,18400,0,5000
928,-900,1700,3000,-11000,0,-7200
929,-1800,-2000,15900,4000,0,16100
930,-900,-3400,-800,-2000,0,-7100
931,-1700,-5200,-1700,11000,0,2400
932,-900,3700,3900,-13800,0,-7100
933,1000,15700,-800,1000,0,16900
934,-6600,-6000,4900,11200,0,3500
935,12000,7200,-2000,-10800,0,6400
936,0,3900,2100,-1800,0,4200
937,-2700,-2600,1100,-2800,-1200,-8200
938,-900,6500,2000,-600,-1200,5800
939,1100,-6400,7600,-7600,0,-5300
940,-3800,-600,-2700,11000,-950,2950
941,9100,16500,1900,-9000,-950,17550
942,0,6400,1000,-2500,500,5400
943,0,-3300,-800,-3700,750,-7050
944,100,7400,-1800,-1000,-950,3750
945,-3000,3700,1800,1600,-1200,2900
946,100,-6400,800,-1600,-2150,-9250
947,-3800,4600,800,500,750,2850
948,9300,3600,-100,-10700,1950,4050
949,-2800,-2500,2100,8200,-1900,3100
950,-2700,3600,-800,-10900,1950,-8850
951,-6600,-6400,4800,9100,2900,3800
952,12000,4600,800,-10800,-950,5650
953,-6600,6700,-700,1100,2900,3400
954,8100,-6300,2000,10100,1950,15850
955,1000,-5400,-800,-1000,0,-6200
956,-6600,6600,4900,-13600,0,-8700
957,12100,5600,1900,10000,0,29600
958,0,7200,2600,-1600,0,8200
959,-2900,9400,-4000,-7600,-1200,-6300
960,-2900,-2400,-4500,14200,-1200,3200
961,-700,-5300,-3800,-800,0,-10600
962,7400,-6200,3900,11000,-950,15150
963,-800,4600,-100,-10800,-950,-8050
964,-9100,9400,2100,-1900,2900,3400
965,8400,-2600,-1000,-4700,1950,2050
966,11200,-8300,-8200,20200,0,14900
967,-2000,6700,-1900,-11600,0,-8800
968,0,-9100,9500,5400,0,5800
969,-8600,7400,15000,-7800,-1200,4800
970,5600,6400,-6100,10000,0,15900
971,8500,-9100,900,3000,-950,2350
972,0,2000,12300,0,0,14300
973,0,3800,1100,-700,750,4950
974,-5800,-6400,6700,-1800,-950,-8250
975,11200,7300,-7100,6500,1700,19600
976,-2800,6800,-2500,-14000,0,-12500
977,200,-2600,9900,7400,0,14900
978,-2800,1100,-8400,3800,-3350,-9650
979,-6300,-6400,4800,11000,-950,2150
980,9000,-2700,10000,11300,2900,30500
981,0,-9000,4600,-6500,1000,-9900
982,-4500,18500,-3700,3000,-950,12350
983,13000,2000,4000,-17700,2900,4200
984,100,-12000,6700,8300,750,3850
985,-2700,7300,1000,-10000,0,-4400
986,-900,3600,2900,0,0,5600
987,100,-700,-4900,200,0,-5300
988,-1700,3700,5700,-2800,0,4900
989,-3800,7500,-1700,3000,0,5000
990,5300,-2600,200,2000,0,4900
991,-1700,-6300,3800,-3000,0,-7200
992,-800,-8500,1100,15000,0,6800
993,12000,6000,200,-1000,0,17200
994,100,-3500,-1700,10000,0,4900
995,0,13600,6600,1000,0,21200
996,0,9300,-10900,-800,-1200,-3600
997,0,-800,-900,9000,0,7300
998,-5700,7200,13400,-6600,-950,7350
999,-1600,-2800,-4700,14000,0,4900
1000,2000,-5500,800,-6700,1950,-7450
1001,-3700,700,2100,2000,-950,150
1002,9200,-9100,4800,-2500,500,2900
1003,100,4700,-12200,12400,0,5000
1004,100,700,1000,-8800,-1200,-8200
1005,-2700,-6100,15100,6200,-950,11550
1006,-3600,7700,-2500,-10000,-950,-9350
1007,8300,1000,2000,-1900,2900,12300
1008,1000,-9100,3000,-4900,1950,-8050
1009,-800,1800,2700,200,0,3900
1010,-1800,3800,100,-11000,0,-8900
1011,0,-6400,1100,20200,-10200,4700
1012,-3800,1900,-6100,15000,0,7000
1013,6200,6500,-8900,0,12000,15800
1014,0,-5600,15800,11000,0,21200
1015,5500,9600,-4500,-6800,-1200,2600
1016,-5700,3700,14600,3200,0,15800
1017,8400,9200,-8900,-3800,0,4900
1018,200,-8300,-900,14000,-950,4050
1019,-900,900,900,-10800,-950,-10850
1020,-4800,-6300,14700,9500,2900,16000
1021,11400,1700,2800,-2700,750,13950
1022,-4500,6500,-11300,-2600,0,-11900
1023,-900,-6200,2900,9200,0,5000
1024,-800,1400,14700,-12600,0,2700
1025,1000,6600,-200,-1600,0,5800
1026,100,3800,-9900,0,0,-6000
1027,-3400,-2800,0,9200,-1200,1800
1028,11100,-6200,-700,11000,0,15200
1029,-2000,-9200,18600,-1800,-950,4650
1030,-2800,9200,1800,-600,-1200,6400
1031,0,9300,-2700,-2900,1950,5650
1032,8200,-5600,7600,8400,-950,17650
1033,-3900,11400,-1800,-900,2900,7700
1034,1100,-2300,-6300,5000,0,-2500
1035,-3800,6500,1400,2600,0,6700
1036,-5400,-6300,0,14000,0,2300
1037,12200,-5600,900,-1800,-1200,4500
1038,-3000,12800,3900,5000,0,18700
1039,-2600,-6600,2800,-800,-950,-8150
1040,-700,-5500,200,10000,0,4000
1041,9000,18500,6600,-17500,1950,18550
1042,0,0,-9900,9100,1950,1150
1043,0,1700,4600,-13600,0,-7300
1044,-2700,-3300,1100,8200,0,3300
1045,-5600,10000,4800,-13800,0,-4600
1046,11300,3700,100,0,0,15100
1047,-3600,-5600,3600,-1800,0,-7400
1048,1000,-9400,5700,10200,0,7500
1049,-700,100,-1900,-3000,0,-5500
1050,-4600,-600,-1000,8200,0,2000
1051,-700,6600,200,200,-1200,5100
1052,6200,-3400,3900,11200,0,17900
1053,-800,17000,-2500,-1800,-1200,10700
1054,6300,-2600,-700,3400,-2400,4000
1055,-2800,-6600,4800,11400,-2150,4650
1056,10400,4600,1000,-12000,0,4000
1057,-1900,-8900,1200,10100,1950,2450
1058,-2900,-2500,-800,-800,-1900,-8900
1059,-3400,-3400,-1700,4100,2900,-1500
1060,3800,11400,3900,-6700,1950,14350
1061,-6500,4600,4800,200,-950,2150
1062,12000,6500,200,6100,2900,27700
1063,0,-2100,4800,-9000,0,-6300
1064,-2900,-3400,-2900,14200,0,5000
1065,-600,-5300,3000,-6800,0,-9700
1066,12100,13000,3000,200,-1200,27100
1067,0,-6100,200,-2000,0,-7900
1068,-800,-11100,2100,12000,0,2200
1069,1000,800,-9800,13200,-2150,3050
1070,-2800,15800,3000,-9800,-2150,4050
1071,-3000,-2800,16800,6500,2900,20400
1072,-3900,9400,-1800,-13900,1000,-9200
1073,8500,9300,100,200,-2150,15950
1074,1000,-3400,-1700,-3900,2900,-5100
1075,-2800,7300,4800,-5700,1950,5550
1076,100,-2600,-10100,7200,0,-5400
1077,-3800,-6400,2900,14000,0,6700
1078,9000,10000,12000,2000,0,33000
1079,0,0,0,-2000,0,-2000
1080,200,0,-1000,10000,0,9200
1081,0,-2600,-800,-2800,-1200,-7400
1082,-3000,-2600,-2000,15400,-1200,6600
1083,-6300,9200,1000,-10400,-4550,-11050
1084,8100,-11100,6700,13000,0,16700
1085,100,-600,-1800,-3900,1950,-4250
1086,-2000,7600,-4400,3000,-950,3250
1087,11200,-8400,5700,-7900,1950,2550
1088,-2900,3700,-100,3200,-1900,2000
1089,-2900,-6400,2500,13700,500,7400
1090,200,7500,-2700,-16900,1950,-9950
1091,-7500,6400,2900,2100,1000,4900
1092,10000,200,-800,-2800,-950,5650
1093,-3000,900,-7000,10300,1700,2900
1094,-1700,-5600,5700,-6700,1950,-6350
1095,10000,9400,-1800,13200,-10200,20600
1096,-5800,-2700,14000,-2900,1950,4550
1097,-800,200,-1800,13200,-1200,9600
1098,6300,6900,-23700,11200,12000,12700
1099,100,-5500,100,10000,-950,3750
1100,0,-5400,16900,-5600,-950,4950
1101,-6600,3700,2700,1300,2900,4000
1102,8200,-5400,13100,8300,750,24950
1103,1000,3700,1100,-1800,-10200,-6200
1104,-6600,-800,2600,12400,0,7600
1105,8100,7300,-200,-8800,12000,18400
1106,100,-600,-2700,9000,0,5800
1107,1200,-5700,-1900,-800,0,-7200
1108,-800,-11100,4600,9200,0,1900
1109,-5600,21500,-1600,-11800,0,2500
1110,12000,-11900,3000,14200,-1200,16100
1111,100,1600,2900,-13000,0,-8400
1112,-5800,900,6700,6200,-2150,5850
1113,6400,-800,0,2000,0,7600
1114,2200,10100,-11900,4100,1950,6450
1115,-900,-9100,-1000,2200,0,-8800
1116,-2700,-2800,14000,5100,1950,15550
1117,-5600,6500,800,5200,0,6900
1118,12000,5900,1100,-3800,-1200,14000
1119,-3700,100,-2000,11200,0,5600
1120,-5500,-5200,-2200,3400,0,-9500
1121,5400,8600,-2900,13200,-950,23350
1122,12200,-11100,6700,-3000,-950,3850
1123,-2800,3700,-9400,10500,2900,4900
1124,-6700,6500,5800,-7700,1950,-150
1125,-5500,9400,6200,4400,-1200,13300
1126,12100,-9100,3900,7200,0,14100
1127,-7300,7200,5700,-800,-10200,-5400
1128,10200,-6300,3900,9000,0,16800
1129,-3800,18700,200,-13800,12000,13300
1130,12100,-5400,-3200,13400,0,16900
1131,0,-3300,-700,4400,-10200,-9800
1132,-5800,4800,2800,2400,0,4200
1133,-3000,-8100,3100,-1800,0,-9800
1134,8200,3700,2700,1400,12000,28000
1135,200,-6300,-800,10200,-1200,2100
1136,-2800,-8500,3600,2200,0,-5500
1137,-6600,6600,200,-9000,-950,-9750
1138,12200,5900,200,8000,0,26300
1139,-2800,7100,2700,-2100,750,5650
1140,0,700,1100,-7800,-2150,-8150
1141,0,1000,-5200,6100,2900,4800
1142,-3900,-5500,1100,2200,-1200,-7300
1143,6700,9300,-19700,18600,-950,13950
1144,-3800,-6300,13100,2000,-950,4050
1145,9100,4500,2900,-900,2900,18500
1146,-900,9400,-2200,-3500,1950,4750
1147,-1700,-3600,-3900,13200,0,4000
1148,100,4500,2700,-15600,0,-8300
1149,-3600,-2700,15000,7200,0,15900
1150,9000,-6400,1700,13400,-1200,16500
1151,-8600,-2600,15000,3200,-1200,5800
1152,8400,8500,2000,11000,-950,28950
1153,-7500,-2700,2900,2000,0,-5300
1154,10000,12000,0,8100,1950,32050
1155,0,9300,-900,-9800,-2150,-3550
1156,0,-2800,-2300,7700,1700,4300
1157,0,-2700,-200,9400,-11150,-4650
1158,0,-5600,3900,7200,0,5500
1159,-4700,-700,-10400,5700,13950,3850
1160,10200,4300,1000,2000,-950,16550
1161,100,-5400,13000,-3700,1700,5700
1162,200,6500,-3100,1200,0,4800
1163,0,-8500,200,2000,-950,-7250
1164,-2800,-9200,6400,11200,0,5600
1165,-3800,7400,100,-10900,1950,-5250
1166,9000,6900,-5300,4400,-3350,11650
1167,-2800,-3400,2700,-7500,2900,-8100
1168,0,-5500,3900,9200,-950,6650
1169,100,3700,2000,-14800,0,-9000
1170,-900,5900,-1000,9300,1950,15250
1171,-2000,-8400,3900,13000,-950,5550
1172,11300,12900,2900,-13900,2900,16100
1173,-5700,6400,-7200,14200,-1200,6500
1174,-800,-2500,-1700,-3000,0,-8000
1175,-1700,6400,1900,0,0,6600
1176,-800,-3300,7900,400,0,4200
1177,6200,7400,1100,3000,0,17700
1178,-900,-5400,1800,-2600,0,-7100
1179,200,-5600,1000,9000,0,4600
1180,-2800,3600,1900,-6800,-1200,-5300
1181,9200,3600,-4300,10200,0,18700
1182,0,100,-2100,10200,-950,7250
1183,-2800,9300,-11300,-600,0,-5400
1184,-10200,-2600,13100,11100,1950,13350
1185,11200,-5400,200,-3000,-950,2050
1186,2000,-8900,15000,7100,2900,18100
1187,-3600,1500,3900,-10000,0,-8200
1188,8100,6400,-200,3400,-1200,16500
1189,1000,-3500,1000,10200,-1200,7500
1190,-2700,7100,-800,-10000,0,-6400
1191,-3000,6500,-8100,13000,0,8400
1192,-700,-5600,2900,-1000,-950,-5350
1193,12200,200,-2800,9000,-950,17650
1194,-2900,6400,13000,-11700,1700,6500
1195,0,0,1900,6300,1950,10150
1196,-2900,200,-2800,2000,0,-3500
1197,-3000,-5500,1100,12000,0,4600
1198,-1500,-6200,100,-1000,0,-8600
1199,13000,4600,100,1000,0,18700
1200,0,3700,200,-13000,0,-9100
1201,-3000,1200,-7200,12400,0,3400
1202,0,-2500,200,8200,0,5900
1203,-2800,-3400,12200,-3000,0,3000
1204,-3800,-10900,4000,14000,0,3300
1205,9200,15600,1100,-7000,0,18900
1206,-3000,-9200,3900,13000,0,4700
1207,100,-2600,-1100,-1800,0,-5400
1208,-3900,2900,3900,13200,-1200,14900
1209,11300,-3400,-800,400,-2400,5100
1210,-2000,16700,200,-8000,-950,5950
1211,-2800,-6400,4800,12000,0,7600
1212,100,-3400,100,-4900,1950,-6150
1213,0,16500,2000,-11000,-1900,5600
1214,0,6200,0,-10900,2900,-1800
1215,100,-2800,-3700,9100,1950,4650
1216,0,3700,1100,-11000,0,-6200
1217,100,-9200,700,12500,750,4850
1218,-900,4600,200,1000,0,4900
1219,-2800,9200,100,-11600,-1200,-6300
1220,12000,-6300,4800,9200,0,19700
1221,-2700,-2700,2900,-1000,-950,-4450
1222,0,11200,0,11000,0,22200
1223,0,10300,-3600,-14900,1950,-6250
1224,-3000,-5500,1100,13000,-950,4650
1225,100,-5600,2800,-4700,1700,-5700
1226,-6600,-3500,2900,24200,-10200,6800
1227,11100,10300,-3600,-11000,12000,18800
1228,1100,-8400,200,12000,0,4900
1229,100,4400,-2400,-14800,0,-12700
1230,-5500,0,1100,11000,0,6600
1231,11300,600,6600,-14600,0,3900
1232,0,-2700,2000,7200,0,6500
1233,-3700,-3000,-1500,-4400,-1200,-13800
1234,1000,4400,5700,-3600,-1200,6300
1235,100,900,-1700,5000,-950,3350
1236,-2900,-9000,3000,-3000,-950,-12850
1237,100,-5600,1900,8300,1700,6400
1238,-3700,3600,2800,-11900,1950,-7250
1239,12100,12800,-9900,14200,-2150,27050
1240,-800,-5400,-800,-1000,-950,-8950
1241,-1800,6500,2000,-2900,2900,6700
1242,-3000,-3400,13100,-5500,750,1950
1243,-1700,1800,-1300,1400,0,200
1244,7400,-700,1100,-4800,-950,2050
1245,0,-3600,-6900,15000,0,4500
1246,100,9400,-1100,-9500,1950,850
1247,-2800,-2900,9100,16400,-2150,17650
1248,0,-9100,5800,2700,1700,1100
1249,100,9200,800,-4600,0,5500
1250,-6500,3600,-4300,13000,-950,4850
1251,12100,21300,-11900,-3000,0,18500
1252,100,-5500,1000,7100,1950,4650
1253,100,-5800,11100,3000,-950,7450
1254,-5700,9300,1000,-15700,2900,-8200
1255,10300,-8200,15900,10000,0,28000
1256,1000,9700,-5400,-10800,-1200,-6700
1257,-5800,-2700,-1000,12200,0,2700
1258,0,900,-4200,8200,0,4900
1259,200,-14100,6700,1000,0,-6200
1260,0,9400,-1800,0,0,7600
1261,-4700,-300,7600,-1800,0,800
1262,10100,4600,2000,200,0,16900
1263,-2800,-6000,300,-2000,0,-10500
1264,8300,4600,-800,4000,0,16100
1265,-5700,900,4800,3000,0,3000
1266,100,1000,-8300,-1600,-1200,-10000
1267,0,-2800,100,11000,0,8300
1268,-6500,6400,-200,-6800,0,-7100
1269,9300,-6300,16800,7200,-950,26050
1270,-3700,1700,2900,-6800,-2150,-8050
1271,9000,900,3900,100,1950,15850
1272,0,6800,-14700,-6700,2900,-11700
1273,-3000,-5300,1100,15000,0,7800
1274,-3000,900,5800,-11800,0,-8100
1275,-1600,-9200,13700,10400,-1200,12100
1276,10400,10100,-2900,3200,-1200,19600
1277,-2800,-6400,200,0,-950,-9950
1278,100,-11900,-6600,21400,0,3000
1279,-6500,16800,-700,-9900,1950,1650
1280,12100,-9300,13100,13000,-950,27950
1281,-1700,-9000,1100,-3900,2900,-10600
1282,2100,-4000,5800,1000,0,4900
1283,100,12900,-9200,-800,0,3000
1284,-2600,-3400,2000,7200,0,3200
1285,-2700,7300,-200,-10800,0,-6400
1286,11300,700,4000,12000,0,28000
1287,200,-6200,100,-3800,0,-9700
1288,-3000,-2600,12200,11200,0,17800
1289,-2800,13100,2000,-11800,0,500
1290,0,6700,-9800,7200,0,4100
1291,-6400,-2600,2100,-600,-2400,-9900
1292,3500,6500,-7100,13000,0,15900
1293,7500,-6300,14700,-800,0,15100
1294,1000,1500,-100,4200,-950,5650
1295,100,3800,3100,-4000,-950,2050
1296,0,-3300,1100,5300,1950,5050
1297,100,7600,8500,-14700,1700,3200
1298,100,-6000,2100,-1400,-1200,-6400
1299,-3800,-5500,-100,4600,-2400,-7200
1300,11100,7100,3400,3400,-950,24050
1301,-1800,-3500,200,8000,-950,1950
1302,-1700,-1200,4800,-13700,1950,-9850
1303,-4200,600,-6200,8100,1950,250
1304,9200,-3500,2900,-1000,-950,6650
1305,100,1700,14900,-3900,1950,14750
1306,-3000,3900,-9800,-2900,2900,-8900
1307,100,-3500,-900,12200,-1200,6700
1308,-6400,7300,-6300,-1600,-1200,-8200
1309,12000,9500,9400,-4800,-950,25150
1310,0,-6200,600,-2400,-950,-8950
1311,-6500,7200,13900,100,2900,17600
1312,3400,9500,2100,-14700,1950,2250
1313,-700,-3600,-900,11000,0,5800
1314,9000,4500,2900,1200,-10200,7400
1315,0,900,200,3000,0,4100
1316,-900,-6300,-100,-800,12000,3900
1317,1000,-2800,1900,8200,0,8300
1318,-2900,-3500,2800,10200,0,6600
1319,-800,8700,-3500,-4800,-1200,-1600
1320,-2600,1600,2600,4200,0,5800
1321,9000,12800,5700,-9000,0,18500
1322,0,-3500,1000,10000,-950,6550
1323,-3000,200,-2700,3200,-2150,-4450
1324,-900,3600,3800,-2900,2900,6500
1325,-2800,11200,0,11100,1950,21450
1326,11100,7400,-14500,1000,0,5000
1327,1000,-5500,2000,8000,0,5500
1328,-2800,-8400,15000,3200,-1200,5800
1329,-2800,-6500,1100,14000,0,5800
1330,-900,-600,1000,-4800,0,-5300
1331,-4600,22200,-1000,1200,-950,16850
1332,8300,-5500,1000,1000,-950,3850
1333,-3500,3700,-7100,6300,750,150
1334,9300,0,1900,-8700,2900,5400
1335,-3000,6600,-800,3000,0,5800
1336,-6600,-2600,11000,-600,-1200,0
1337,12000,-8100,3000,11000,0,17900
1338,-3700,-9100,3000,13200,-2150,1250
1339,-2000,-5500,500,-600,0,-7600
1340,8400,8600,-100,9300,1950,28150
1341,0,-3500,100,0,-950,-4350
1342,100,10700,2900,100,2900,16700
1343,-900,3800,1100,-12000,0,-8000
1344,-2000,-2500,-3500,14000,0,6000
1345,-900,800,5700,-12000,0,-6400
1346,1100,-6300,700,11200,0,6700
1347,-4600,10100,-3700,-10000,0,-8200
1348,13100,3800,100,0,0,17000
1349,0,-6400,4800,9200,0,7600
1350,-3600,7500,100,-12000,0,-8000
1351,-2000,6700,-2600,2000,0,4100
1352,-600,-3400,-2800,-3800,0,-10600
1353,-2800,4500,6700,-4600,0,3800
1354,12000,-5400,0,-2400,-1200,3000
1355,-3000,-1900,4600,4200,0,3900
1356,-2900,-6200,100,1000,-950,-8950
1357,-3500,7400,-2000,1200,-950,2150
1358,9000,-9100,2700,12300,2900,17800
1359,0,4600,-1000,-11800,-950,-9150
1360,-3700,6600,3000,-5700,2900,3100
1361,-8400,-3300,4900,-800,0,-7600
1362,12100,1400,3800,200,0,17500
1363,0,-6400,2000,-3000,0,-7400
1364,-6500,-3600,2800,15000,0,7700
1365,12000,19200,-2700,-8000,0,20500
1366,-2800,-500,-1000,6400,0,2100
1367,-900,1500,-100,5200,0,5700
1368,-8400,-3400,3900,-1000,0,-8900
1369,12000,4500,1100,10600,-12600,15600
1370,-800,3900,-11700,-2000,0,-10600
1371,1200,-8200,2900,7000,12000,14900
1372,-3600,6600,11300,-11000,-950,2350
1373,6300,-6400,8500,10200,-950,17650
1374,0,300,-3600,6100,2900,5700
1375,-3600,18600,-8900,-2900,1950,5150
1376,6200,-2800,2900,14000,0,20300
1377,-6500,-3500,13000,-1000,0,2000
1378,12100,4500,2900,9200,-10200,18500
1379,-6600,100,-1100,2200,0,-5400
1380,-6500,9400,-9900,13000,12000,18000
1381,13100,-2800,-2100,-3800,0,4400
1382,-4700,-2600,12800,13400,0,18900
1383,13000,-10900,-600,13000,0,14500
1384,-700,800,3900,-15000,0,-11000
1385,-1900,-6100,100,14000,0,6100
1386,-3700,7400,200,-14000,0,-10100
1387,100,-6300,-1300,11000,-2400,1100
1388,-2600,1600,5800,-12600,0,-7800
1389,12200,-3400,-900,6200,-950,13150
1390,-6600,-6200,2000,2000,0,-8800
1391,1000,19300,-800,-3900,1950,17550
1392,-6600,3800,-5100,-800,0,-8700
1393,5300,-6200,3000,11300,750,14150
1394,300,4400,13900,-2000,0,16600
1395,10200,3900,-1000,-9800,0,3300
1396,-900,4000,-9800,9200,0,2500
1397,200,-5600,0,-1000,0,-6400
1398,200,600,13000,12200,-10200,15800
1399,-2900,-6100,-700,1000,0,-8700
1400,-6500,7500,6800,-6600,0,1200
1401,9300,3700,-9900,-800,10800,13100
1402,100,-9000,3900,11200,-1200,5000
1403,-3500,4500,13800,-11800,-950,2050
1404,9100,-3600,3800,10200,0,19500
1405,-3000,9300,-12100,-700,1950,-4550
1406,-900,9400,-1700,7100,1950,15850
1407,-5400,-2800,700,13200,0,5700
1408,12000,-6100,15000,-5800,0,15100
1409,-800,-5200,-1700,11000,0,3300
1410,1000,15500,-2600,-8000,0,5900
1411,-3800,-5500,6600,6400,0,3700
1412,1000,3700,3900,-15600,-1200,-8200
1413,-3600,3900,-11700,14000,0,2600
1414,12000,-8200,2100,-2800,-1200,1900
1415,100,3700,2000,-1000,-950,3850
1416,-2800,-3500,13000,9100,1950,17750
1417,-2900,3700,1700,-9800,0,-7300
1418,0,7500,-1700,-1700,750,4850
1419,-3700,3700,-9900,1000,0,-8900
1420,5400,-5500,2900,15200,-1200,16800
1421,1000,-12000,13100,1000,-950,2150
1422,0,-8200,600,11400,-950,2850
1423,100,12800,-800,100,2900,15100
1424,-900,1000,3000,-12700,750,-8850
1425,-2800,-9100,3900,12000,0,4000
1426,12200,4400,900,-12000,-950,4550
1427,0,-6100,-100,12400,-1200,5000
1428,0,1600,200,-10900,1950,-7150
1429,-3000,6600,200,400,-2150,2050
1430,-2800,-6200,-8100,18900,-700,1100
1431,-6600,7400,4800,-12600,-1200,-8200
1432,9100,-6300,1100,15400,-3350,15950
1433,-7100,-400,11200,-3000,-950,-250
1434,6500,16700,-800,1100,1000,24500
1435,9000,3600,1700,-10700,2900,6500
1436,0,3600,1100,-1900,1000,3800
1437,-900,-5900,1200,-4600,-1200,-11400
1438,-4800,7300,1800,-5300,-200,-1200
1439,-800,3800,-20000,7500,750,-8750
1440,11100,-6200,1100,10000,-950,15050
1441,-7600,4800,16000,-11900,1950,3250
1442,10300,900,3900,7500,-9450,13150
1443,-7400,100,-900,-1000,-950,-10150
1444,8300,3600,10600,1500,14900,38900
1445,-900,-9100,3900,-2000,-1900,-10000
1446,-4700,-5500,4800,4300,1950,850
1447,7500,21300,-200,-12500,1700,17800
1448,200,9300,-2800,-2000,-950,3750
1449,-2000,-5400,200,9100,2900,4800
1450,-3600,3700,-5200,-4900,1950,-8050
1451,12000,-2800,1900,11000,0,22100
1452,0,6400,-11800,1200,-1200,-5400
1453,0,-5800,11800,14200,0,20200
1454,100,-5300,-800,-3000,-950,-9950
1455,-800,3900,-2900,2400,-2150,450
1456,-5600,-6300,15000,-2900,2900,3100
1457,1000,1700,5800,-5500,750,3750
1458,-6600,6700,1100,3200,-1200,3200
1459,4400,-3600,2900,2000,0,5700
1460,10400,7500,200,0,-950,17150
1461,-6600,9300,-2900,-9800,-950,-10950
1462,-2800,-5400,2000,9300,1700,4800
1463,12100,-5700,-3700,-5500,1950,-850
1464,-2800,1600,-8300,13200,-950,2750
1465,-900,-11900,1200,1000,0,-10600
1466,1100,4700,-2700,-2900,1950,2150
1467,100,-1900,14700,-9600,-2150,1150
1468,-3000,-9200,7600,7300,2900,5600
1469,-700,7500,-4700,-1600,-1200,-700
1470,5400,6400,3600,-11400,-1200,2800
1471,-5300,-6400,3900,10200,0,2400
1472,12000,-5600,3600,-2600,-950,6450
1473,-5800,3700,-7000,9100,1950,1950
1474,11400,0,-9500,11600,-2150,11350
1475,0,7500,-11700,7100,2900,5800
1476,0,3800,1000,400,-2150,3050
1477,-2700,-9400,4800,12200,-1200,3700
1478,200,1700,14900,-5700,-8250,2850
1479,-2500,3900,-11800,11000,-1900,-1300
1480,3100,-500,9000,-1300,14900,25200
1481,200,4400,1000,-18300,-450,-13150
1482,-2900,-2000,-4800,5800,-3350,-7250
1483,-4300,-3300,10400,4100,1950,8850
1484,10300,1400,3900,13400,-11400,17600
1485,-3000,-3400,13100,-5700,1950,2950
1486,-3900,7300,3900,-2600,11050,15750
1487,-3400,6500,-5300,-7700,1950,-7950
1488,7200,-700,12100,10000,-950,27650
1489,-4700,4400,1700,-13700,2900,-9400
1490,10200,9400,1200,9300,750,30850
1491,-3500,-3700,1700,-3600,0,-9100
1492,3500,-600,13100,12200,-2150,26050
1493,-3500,10100,-10900,11000,-950,5750
1494,12000,9300,-1700,-3700,1700,17600
1495,0,-8100,15000,5100,1950,13950
1496,-900,-2100,-7300,4400,-1200,-7100
1497,1200,-8400,-1900,12000,-950,1950
1498,-900,-9200,3600,-4500,750,-10250
1499,1100,-9300,13100,13200,-2150,15950
1500,-3000,6900,-700,300,1700,5200
1501,-800,6500,200,-3800,-950,1150
1502,-2600,2700,4800,0,-950,3950
1503,6200,7300,2000,100,2900,18500
1504,-2700,6500,-7100,7100,1000,4800
1505,8200,-700,-900,2200,-2150,6650
1506,200,7300,9900,-2700,2900,17600
1507,-3000,3800,-700,-11900,1950,-9850
1508,0,-12000,3900,10000,0,1900
1509,-7200,10000,1700,2400,-1200,5700
1510,10100,3600,400,-8600,0,5500
1511,-3000,-700,-2700,14000,-950,6650
1512,-3600,10100,-8000,-3600,-1200,-6300
1513,12000,-5400,14900,7300,750,29550
1514,0,-5700,-800,1000,-950,-6450
1515,-2700,6400,3800,-3900,1950,5550
1516,100,3600,-10900,14200,-1200,5800
1517,-800,-2700,-1100,-3700,1950,-6350
1518,-2600,-5200,300,6300,750,-450
1519,12000,700,14000,-10000,0,16700
1520,-5700,-6200,3000,12400,-1200,2300
1521,0,4500,2900,-10800,-2150,-5550
1522,-3800,9400,-2900,-600,-950,1150
1523,9000,-3400,200,-2500,1700,5000
1524,0,-5500,2900,9100,1000,7500
1525,-3000,-3200,-700,9200,-950,1350
1526,0,3700,3900,-3900,2900,6600
1527,-2700,-3400,2000,7100,1950,4950
1528,-3700,22100,-3600,200,-10200,4800
1529,9000,-8200,6700,10200,0,17700
1530,100,-800,-900,400,-2400,-3600
1531,-3800,7300,2900,-800,12000,17600
1532,12000,-600,-2700,-1000,-950,6750
1533,-3800,7200,0,4000,0,7400
1534,-1700,-5600,2000,5500,750,950
1535,-2700,-2500,-800,-2000,-950,-8950
1536,11400,800,100,-900,1950,13350
1537,-2700,-6100,200,-1600,-3350,-13550
1538,-2800,4700,0,-700,2900,4100
1539,-2800,900,4900,-12700,-200,-9900
1540,-3600,-5400,-700,20200,-10200,300
1541,9300,3600,2600,-13700,1950,3750
1542,-2800,6600,200,2000,11050,17050
1543,11200,-6400,6400,-11300,2900,2800
1544,100,-5300,-1900,9200,0,2100
1545,-2900,13000,-9200,1200,0,2100
1546,-5800,-5400,900,14400,-1200,2900
1547,10300,900,3900,-12000,0,3100
1548,-2900,-3600,14000,11200,-950,17750
1549,1000,-5300,2000,10200,-1200,6700
1550,-5700,6500,1100,-11000,-950,-10050
1551,-3600,18700,-9900,8300,2900,16400
1552,11100,-5300,-700,-3700,750,2150
1553,-2800,3900,9300,4000,0,14400
1554,1100,-12200,5700,9200,-10200,-6400
1555,-3000,4500,200,4000,-950,4750
1556,0,0,0,0,0,0
1557,11300,3600,6600,-15800,-950,4750
1558,-3000,-700,-1800,11100,14900,20500
1559,-5600,10000,-6200,-3900,1950,-3750
1560,8200,9200,0,4000,0,21400
1561,0,0,12000,8000,0,20000
1562,0,300,-2700,-2800,-1200,-6400
1563,-2800,100,-3500,12800,-1200,5400
1564,-2900,-7900,-1600,2000,0,-10400
1565,-700,-11100,4800,11000,0,4000
1566,2500,9200,2000,-7000,-950,5750
1567,-5600,-3500,1100,11200,-1200,2000
1568,11100,-5600,4800,-8700,1950,3550
1569,1000,-5600,1000,12000,-950,7450
1570,-3000,18400,1000,-10900,2900,8400
1571,11400,6500,0,-1000,0,16900
1572,-3000,100,-1800,2000,0,-2700
1573,200,-2400,-2700,6200,0,1300
1574,200,-9100,2900,10000,0,4000
1575,-3900,10000,100,-11800,0,-5600
1576,1300,700,2900,-1800,0,3100
1577,-2800,-2500,2100,-5800,0,-9000
1578,-3700,3800,800,13600,-10200,4300
1579,12000,-8400,200,0,0,3800
1580,200,-3600,2900,6200,12000,17700
1581,-2900,-8900,2000,3000,0,-6800
1582,-2900,12000,-3300,20600,-10200,16200
1583,11300,6500,100,-11600,-1200,5100
1584,-8600,9500,3000,14000,12000,29900
1585,8300,-9000,2100,12000,-950,12450
1586,-4600,-2600,1100,-1000,-950,-8050
1587,-1700,13000,2000,-2900,2900,13300
1588,6200,-5500,3000,2200,-2150,3750
1589,100,-3600,0,9300,1700,7500
1590,-700,3700,-9900,-2800,0,-9700
1591,-1800,6600,1100,9000,-950,13950
1592,-3500,3700,3000,-11800,-2150,-10750
1593,9100,-6300,11800,12300,2900,29800
1594,-3400,7100,-1800,-900,1950,2950
1595,9300,3800,-7300,-2600,0,3200
1596,-2800,-2700,-3700,14000,0,4800
1597,-3000,3600,8500,-14600,0,-5500
1598,11500,-5500,11900,10000,0,27900
1599,-2900,9400,-4800,-7800,0,-6100
1600,0,-11400,6700,9200,0,4500
1601,0,-6400,2900,11000,0,7500
1602,-6500,7300,1900,-7000,0,-4300
1603,9200,3600,1100,3200,-1200,15900
1604,200,9200,-11900,-2000,0,-4500
1605,-2800,200,1100,9200,-950,6750
1606,-2900,-5400,100,-1000,0,-9200
1607,10300,-6200,13100,10500,-450,27250
1608,-2000,4700,2100,-11800,-950,-7950
1609,0,-6400,1700,7300,2900,5500
1610,-2800,-3500,-1800,2000,-950,-7050
1611,-800,-5800,4500,6600,-950,3550
1612,-800,9200,1900,-5900,1950,6350
1613,-1800,9400,-4600,100,2900,6000
1614,9000,6500,4800,-1800,0,18500
1615,0,6600,-800,-1000,0,4800
1616,-7400,0,0,3000,0,-4400
1617,10000,-5500,3600,10600,-1200,17500
1618,-2700,0,0,-3000,0,-5700
1619,-3700,6500,0,5000,0,7800
1620,6300,-2600,-100,1200,0,4800
1621,-2700,-800,-800,9000,0,4700
1622,11200,4500,5700,-12800,0,8600
1623,-2900,300,-3700,13200,-1200,5700
1624,0,-2800,-2900,10200,0,4500
1625,-3000,-9000,6700,400,-1200,-6100
1626,-6400,10100,2000,-11000,-950,-6250
1627,12000,-3400,100,-4000,-950,3750
1628,-3000,-2600,-3800,11500,1700,3800
1629,-5800,6600,3000,-900,1950,4850
1630,9400,6600,1100,-4600,-1200,11300
1631,2000,-2700,-900,-3800,-950,-6350
1632,-4600,-9200,5500,11400,-950,2150
1633,2000,4500,1100,-17900,2900,-7400
1634,-4600,3600,2800,1100,1950,4850
1635,13100,-6300,100,-1800,-1200,3900
1636,0,4500,2900,-3000,0,4400
1637,-2700,9800,-4400,-9800,-2150,-9250
1638,-2900,-8400,4800,13200,-2150,4550
1639,-3600,-700,-800,-4900,2900,-7100
1640,12000,4800,2100,-6700,1950,14150
1641,100,-3600,-4600,11000,-950,1950
1642,0,4800,300,-14600,-2150,-11650
1643,-3000,-9200,6700,8500,1700,4700
1644,-3900,1800,2100,-10900,1950,-8950
1645,-2700,6600,-6100,6200,-950,3050
1646,-5200,-300,-3600,-3000,0,-12100
1647,12000,7200,12100,-1700,750,30350
1648,-7500,800,-3300,9500,-9450,-9950
1649,13000,-8600,2800,14000,0,21200
1650,-3900,9200,0,-10000,11050,6350
1651,1100,-800,12000,10200,-2150,20350
1652,0,10300,-3600,-13900,2900,-4300
1653,-3000,-8300,2700,11200,-950,1650
1654,-800,-8200,3000,-3900,2900,-7000
1655,9000,9300,-13000,14200,0,19500
1656,-4600,-8500,1800,12200,0,900
1657,2000,9200,-1100,-15600,0,-5500
1658,-3800,-3600,17600,-1800,0,8400
1659,12000,7100,-2100,14400,-10200,21200
1660,0,-5400,-100,11200,0,5700
1661,100,-6400,-200,-800,12000,4700
1662,-2800,1700,-7100,13000,0,4800
1663,-2600,6500,0,-11000,0,-7100
1664,-2900,-6100,10300,13000,0,14300
1665,8400,4700,1200,-10800,-1200,2300
1666,0,4000,300,-3800,0,500
1667,0,-11900,2100,2000,-950,-8750
1668,-5700,4600,3000,3000,0,4900
1669,8500,6700,-10700,-5900,1950,550
1670,-2900,-5500,2900,11200,-950,4750
1671,-3000,6500,14000,-14500,1700,4700
1672,-800,-9200,5700,10200,-1200,4700
1673,9000,-3400,-12200,24600,-1200,16800
1674,-5800,19600,-700,-7800,-2150,3150
1675,7600,1200,-10000,10600,-2400,7000
1676,-1900,-6000,11300,-2900,1950,2450
1677,-6200,10300,-1700,-1800,-1900,-1300
1678,8100,3700,3100,-1900,2900,15900
1679,-5400,200,-1700,6300,1000,400
1680,9200,-5300,16000,-4800,0,15100
1681,-3800,900,-3300,7300,1950,3050
1682,6300,-8200,1800,-1700,1950,150
1683,3000,900,11600,-200,-3350,11950
1684,-3000,-3400,3000,4500,2900,4000
1685,100,1800,2100,-11800,-2150,-9950
1686,-2700,3900,-7900,7200,0,500
1687,11200,-6300,2000,-5900,1950,2950
1688,-8500,7200,15500,5400,-2150,17450
1689,10300,3600,4800,-17700,2900,3900
1690,1000,-3500,1000,10000,0,8500
1691,-2900,10100,-1800,-10000,-950,-5550
1692,0,900,3900,1000,-950,4850
1693,-3800,300,-2700,8300,2900,5000
1694,1100,1000,2000,-14900,1950,-8850
1695,-2700,-6300,2000,10000,0,3000
1696,10300,1400,1400,-10600,0,2500
1697,-2000,3900,200,2200,-1200,3100
1698,100,-6100,-1900,200,0,-7700
1699,-6500,10100,200,-800,0,3000
1700,3400,3600,8500,-9000,0,6500
1701,11300,200,-2700,10000,0,18800
1702,-2700,6400,100,-11800,0,-8000
1703,-3000,-8300,3900,13000,0,5600
1704,0,-3600,-200,10200,0,6400
1705,-3700,4400,2800,-8000,0,-4500
1706,9100,-800,0,12200,-1200,19300
1707,-800,100,-2100,-1800,0,-4600
1708,1000,300,-5700,9200,0,4800
1709,100,700,3800,2000,-950,5650
1710,0,-3500,200,6200,-950,1950
1711,-6500,7600,-1900,-11500,2900,-9400
1712,11200,3700,4800,-8700,1950,12950
1713,-4600,-5500,4600,-800,0,-6300
1714,-2700,3400,-8100,14200,-1200,5600
1715,8200,-6200,13100,13000,0,28100
1716,-5600,7200,3600,-9800,0,-4600
1717,-700,-3700,-900,12000,0,6700
1718,12000,-2700,100,-800,-1200,7400
1719,-3000,9400,100,14000,0,20500
1720,0,6200,-1100,-9600,-950,-5450
1721,-900,-2600,2000,7200,0,5700
1722,-1700,-5700,100,-700,750,-7250
1723,100,3800,100,-1000,-950,2050
1724,0,-6300,2000,-4900,2900,-6300
1725,0,1500,4800,-1800,0,4500
1726,-4500,6400,-3400,-5400,-1200,-8100
1727,10100,6700,-11700,9200,0,14300
1728,-2500,-5400,2000,-2000,-950,-8850
1729,-3600,-9000,1200,13200,-1200,600
1730,9300,4800,11300,-14900,1950,12450
1731,-6600,6500,3900,200,-950,3050
1732,2500,-700,800,21500,-7300,16800
1733,6600,-2800,3900,-3000,0,4700
1734,-3800,-10800,1900,15200,0,2500
1735,9200,8500,-900,1000,12000,29800
1736,-6300,10100,200,-1000,0,3000
1737,12200,6500,-7100,-7600,0,4000
1738,-3900,-5500,2000,13000,0,5600
1739,100,-6200,14000,-4000,0,3900
1740,-1900,-5600,1600,15400,-1200,8300
1741,200,9900,-8200,-13000,0,-11100
1742,-6200,12000,2000,8000,-950,14850
1743,4700,-5500,1900,1000,0,2100
1744,7500,-2700,1100,6500,750,13150
1745,-6400,3700,5800,-12000,-950,-9850
1746,9100,3800,-9900,12100,2900,18000
1747,-6500,-2700,3900,-1800,0,-7100
1748,12000,1000,-6100,8000,0,14900
1749,-2900,-5600,13900,3000,0,8400
1750,-800,6300,-15800,13200,0,2900
1751,1000,-3500,17700,3600,-1200,17600
1752,-7400,7500,-800,-7800,-1200,-9700
1753,10000,-3300,9200,10600,-2150,24350
1754,0,1800,3000,-9800,-1200,-6200
1755,-6600,-6300,2700,9300,1950,1050
1756,9500,4500,-7100,-2000,-1900,3000
1757,8200,-9000,1800,12300,2900,16200
1758,-3000,4600,13100,-12900,1950,3750
1759,-1800,3700,200,1000,-950,2150
1760,2000,900,2900,-13700,2900,-5000
1761,-900,-6100,-700,9000,0,1300
1762,-2700,4800,-10900,-1800,0,-10600
1763,-5500,3600,-7100,15200,-1200,5000
1764,9100,-6300,12100,13000,0,27900
1765,0,1700,4800,-12000,-950,-6450
1766,-3000,4000,13200,2200,-950,15450
1767,7300,1100,2100,-12900,2900,500
1768,1100,-6200,-1900,8300,1950,3250
1769,-800,-1300,-4400,-3600,0,-10100
1770,-1900,9300,-200,-600,0,6600
1771,0,-6400,3800,-2000,0,-4600
1772,-4700,100,9900,13600,-2400,16500
1773,10000,18500,-900,3000,0,30600
1774,300,-3300,-4500,-2000,0,-9500
1775,100,-1300,6700,-800,-950,3750
1776,0,-6300,-100,-800,-950,-8150
1777,-2800,-6200,1000,8300,2900,3200
1778,-7500,19200,3900,-12500,750,3850
1779,12400,-3200,-3900,1400,0,6700
1780,-1900,-6300,2700,6800,-10200,-8900
1781,100,3800,4000,7200,0,15100
1782,-3500,-3600,2800,-3000,12000,4700
1783,9000,4700,1100,4200,-1200,17800
1784,-3000,18500,-2000,-6800,0,6700
1785,100,-2500,-2700,10000,-950,3950
1786,8200,6500,5800,-17400,-950,2150
1787,0,-11000,0,12300,2900,4200
1788,100,-9000,2100,13300,-8250,-1750
1789,-5700,-2800,3800,1400,-1200,-4500
1790,-5800,6700,-700,3000,0,3200
1791,11300,8700,-800,-3000,12000,28200
1792,-2800,7400,2100,-800,0,5900
1793,-3500,900,2100,-10000,0,-10500
1794,12000,-6000,-700,9000,0,14300
1795,-4800,1700,3900,-8000,0,-7200
1796,2100,600,-8000,9000,0,3700
1797,0,-7900,1200,200,-1200,-7700
1798,-3000,6800,-14400,15000,0,4400
1799,100,-3500,13100,-6800,-950,1950
1800,-900,1900,5600,-3200,-1200,2200
1801,1100,3900,10300,-2900,1950,14350
1802,-2900,-6000,-700,7300,-8250,-10550
1803,-3600,-5400,4000,7200,0,2200
1804,8300,8200,1100,-800,12000,28800
1805,-5700,-5600,7300,10400,0,6400
1806,12200,6400,2900,-15600,-1200,4700
1807,-3000,5700,-8500,24400,0,18600
1808,-900,7300,-4500,-9000,-950,-8050
1809,1100,-9100,13500,7400,0,12900
1810,100,6400,-6200,3500,1950,5750
1811,-3800,-5500,-100,1200,-950,-9150
1812,11100,15900,13100,-2900,2900,40100
1813,-2000,-3300,200,-2800,0,-7900
1814,-9400,0,2900,13000,0,6500
1815,9200,-800,3800,-4800,0,7400
1816,-4500,12100,-2900,14000,0,18700
1817,13000,200,-3600,-2800,-1200,5600
1818,-2700,-5200,2100,7200,0,1400
1819,-12200,12100,4900,200,0,5000
1820,8200,-5500,1100,14000,0,17800
1821,12000,-9400,4700,200,-1200,6300
1822,100,10200,-2700,0,0,7600
1823,0,3400,3800,-600,-1200,5400
1824,-2800,200,-3200,-600,-950,-7350
1825,-6600,6600,3000,1200,-950,3250
1826,9000,-2600,-800,-900,2900,7600
1827,-2800,-2800,2000,7100,1950,5450
1828,-5500,0,1800,-2800,0,-6500
1829,8300,-700,100,12200,-1200,18700
1830,-700,-2800,-1300,-1800,0,-6600
1831,-1800,6400,-1000,13200,-950,15850
1832,11300,-6200,-1000,11200,0,15300
1833,-6500,1600,5600,-12900,1950,-10250
1834,-2000,-3200,-6900,14400,-950,1350
1835,8400,7400,3000,-18700,2900,3000
1836,-2800,-3300,900,9400,0,4200
1837,-3000,-8200,2100,1000,0,-8100
1838,-800,5700,1100,11000,0,17000
1839,9300,7100,2000,-13600,0,4800
1840,-2800,-9100,3000,14000,0,5100
1841,-4400,-5600,3900,9000,0,2900
1842,4500,18700,3000,-11800,0,14400
1843,-6600,-6200,3000,13000,0,3200
1844,12000,7300,-2000,-10800,0,6500
1845,-4700,-9200,5700,14200,-1200,4800
1846,10100,-700,-4700,3000,0,7700
1847,-3000,3600,5700,14200,-1200,19300
1848,0,6400,-8100,-2000,0,-3700
1849,-3700,11300,-1900,15000,0,20700
1850,9400,7500,8100,1200,-950,25250
1851,-5500,0,2900,-2000,-950,-5550
1852,11200,-8500,800,11300,2900,17700
1853,-3900,-8400,4800,-2900,1950,-8450
1854,1000,6500,-11100,-2800,0,-6400
1855,-6600,6500,-7100,3200,-1200,-5200
1856,9300,0,10100,13000,0,32400
1857,0,3400,3800,-12800,0,-5600
1858,-900,300,8100,-800,0,6700
1859,-1600,-5400,-3600,14000,0,3400
1860,-5800,-6400,3900,0,0,-8300
1861,8600,-5400,1900,-1000,0,4100
1862,-3800,3800,-9800,1000,0,-8800
1863,0,2700,2000,2000,0,6700
1864,12000,4600,200,-11000,0,5800
1865,-3000,-11800,16600,2200,0,4000
1866,-3000,-3500,-1700,13000,0,4800
1867,200,1700,1600,-9800,0,-6300
1868,-3800,18500,-800,-7000,0,6900
1869,12200,-12100,6700,7200,0,14000
1870,100,7600,-4700,-10800,0,-7800
1871,0,-12000,3000,14000,0,5000
1872,-5600,4400,3800,-11000,0,-8400
1873,-3000,3600,3800,5400,-2400,7400
1874,11400,9200,-2200,-12800,0,5600
1875,0,-3800,-3000,15200,-950,7450
1876,-5600,4400,6400,1200,-950,5450
1877,0,6300,-900,-10900,2900,-2600
1878,-3700,6700,-14800,11300,1950,1450
1879,11200,-8400,4800,-2000,0,5600
1880,1000,800,11900,3400,-1200,15900
1881,100,-8900,1200,-2000,0,-9600
1882,0,4600,-100,1200,0,5700
1883,-3000,3900,2100,1800,-4550,250
1884,-6700,-600,200,-1800,-950,-9850
1885,-2600,-2800,4800,-7700,2900,-5400
1886,9200,6500,-300,300,1000,16700
1887,-3900,8500,-12200,23400,-950,14850
1888,12400,4400,-7200,-7700,2900,4800
1889,-2800,-5600,1100,9100,1950,3750
1890,100,3900,9100,-9800,0,3300
1891,100,-11800,5800,8200,0,2300
1892,-3700,4400,13100,-8000,0,5800
1893,-5500,3800,2100,-1000,0,-600
1894,8400,-6300,2000,400,-2400,2100
1895,-2800,-5200,-1600,14000,0,4400
1896,3400,-3500,4800,-1000,-950,2750
1897,-700,5600,3800,11200,-2150,17750
1898,12000,10300,-3600,-13900,2900,7700
1899,-3000,15800,1100,300,-200,14000
1900,100,-5300,-2000,400,-1200,-8000
1901,-2900,6600,-1700,-2700,1950,1250
1902,0,-9100,4800,8300,-200,3800
1903,-3600,4700,1200,-11800,-1200,-10700
1904,11100,-9400,2900,11100,1950,17650
1905,-2000,-9000,3000,200,-3100,-10900
1906,0,-5300,1100,6500,500,2800
1907,-2700,15800,200,-12500,750,1550
1908,-3000,-3500,-800,13000,-950,4750
1909,11200,6600,3000,-7700,1950,15050
1910,100,6600,-12700,11000,-950,4050
1911,-5800,11300,1100,-5700,1950,2850
1912,-6700,-5600,20500,6300,1950,16450
1913,12200,8700,-2900,-2800,-950,14250
1914,-9400,-2500,2100,11100,2900,4200
1915,11100,-5400,-700,-4700,750,1050
1916,100,200,5800,10200,-1200,15100
1917,1000,1500,-200,-8800,0,-6500
1918,-3400,3600,2900,-2000,-950,150
1919,-4500,-6100,-1100,2200,0,-9500
1920,11000,7400,-3900,-2700,1950,13750
1921,0,3700,-8900,1400,-3350,-7150
1922,-3600,-9400,4800,11300,1700,4800
1923,-2500,-3400,10900,-2600,-2150,250
1924,11400,6400,2800,5400,-2150,23850
1925,-5700,3800,2100,1300,750,2250
1926,1000,-3300,1200,-12500,1950,-11650
1927,0,13800,3600,2400,-1200,18600
1928,-3000,6400,-200,-10700,1000,-6500
1929,8400,-3300,2100,4200,-950,10450
1930,-5700,7300,100,-10900,2900,-6300
1931,-3800,-8300,3900,9300,750,1850
1932,12000,6600,-800,1200,-2150,16850
1933,-900,-9300,800,300,1950,-7150
1934,1200,4600,100,-2000,-950,2950
1935,0,3800,-1000,-15700,1950,-10950
1936,-3000,3700,-5200,9300,2900,7700
1937,-2800,-2800,-1100,-800,0,-7500
1938,8400,3800,14700,200,0,27100
1939,-2700,-3700,100,200,0,-6100
1940,300,-11300,3800,10000,0,2800
1941,-900,8400,-1100,10200,0,16600
1942,-2800,4600,-200,-4600,-1200,-4200
1943,8200,-3600,100,12200,-1200,15700
1944,1100,6600,2000,-15800,0,-6100
1945,0,3800,1800,12200,-950,16850
1946,-5800,-800,-9200,10200,-950,-6550
1947,11300,7300,-8100,4300,2900,17700
1948,100,-600,-3600,5100,1950,2950
1949,-2900,4500,15600,-11200,-2400,3600
1950,-3600,-5400,2000,10000,0,3000
1951,-8300,-500,10000,1200,-950,1450
1952,12000,-8600,2000,1000,0,6400
1953,0,-5400,1100,10000,-950,4750
1954,100,15700,1000,-1900,1950,16850
1955,-6500,-6200,200,-1900,2900,-11500
1956,12000,2000,2100,-11000,0,5100
1957,-6400,-3300,-2600,12000,0,-300
1958,12000,-9000,3900,11000,0,17900
1959,0,7400,3000,-16600,0,-6200
1960,-3900,2900,3900,13000,0,15900
1961,1000,-3400,-2900,-2800,0,-8100
1962,-2800,22300,-10900,9600,-1200,17000
1963,-3800,-3500,4800,7800,-2400,2900
1964,11300,1600,15500,-11800,-950,15650
1965,1100,6500,-900,-1000,0,5700
1966,-2900,-5400,100,-900,1950,-7150
1967,200,-3400,100,7200,-1900,2200
1968,-3700,-7900,1300,-3900,2900,-11300
1969,-3500,18300,-3900,300,1950,13150
1970,13000,-3500,3900,3400,-950,15850
1971,-3700,1500,3000,-11900,2900,-8200
1972,-1900,9400,100,-3600,0,4000
1973,-2800,-5500,-3500,6400,0,-5400
1974,-6500,-700,1900,10200,0,4900
1975,2700,10000,14900,200,-10200,17600
1976,12000,400,-4500,11000,0,18900
1977,-3600,-8200,1100,1000,12000,2300
1978,8300,-6200,3000,11000,0,16100
1979,-1800,4400,4800,-12000,0,-4600
1980,-3800,-800,1900,8200,0,5500
1981,12000,100,-900,-1000,0,10200
1982,-2900,12400,-5500,15000,0,19000
1983,-5600,-5500,4900,-2800,-1200,-10200
1984,11400,-2700,-1200,8400,0,15900
1985,-2700,-6100,2100,-2000,0,-8700
1986,100,-5600,100,19400,-11400,2600
1987,-3800,13000,4800,-9000,0,5000
1988,1200,-3400,-2800,10000,-950,4050
1989,-6400,4700,100,3000,12000,13400
1990,11100,3700,2000,-13900,1950,4850
1991,-1700,6600,-10800,10000,-950,3150
1992,-3600,-8500,3900,-1900,2900,-7200
1993,8100,6600,9100,4200,0,28000
1994,-1700,-3500,3900,-5800,0,-7100
1995,-7500,7300,1100,4400,-2400,2900
1996,10200,-9100,8600,-6800,0,2900
1997,-800,200,-4600,12200,-1200,5800
1998,-2700,5700,2800,10200,-950,15050
1999,6400,7200,1000,-9000,-950,4650
2000,-2600,-3600,4700,4300,2900,5700
2001,10400,7300,-1100,-14700,1950,3850
2002,-4800,0,-8300,22200,0,9100
2003,0,0,0,-1000,0,-1000
2004,-3700,400,6500,11000,0,14200
2005,6200,-2700,2700,600,-1200,5600
2006,-3600,0,2000,8200,0,6600
2007,6300,9400,2900,-14600,-950,3050
2008,-3900,-2600,-2600,14400,-2400,2900
2009,12200,-8300,3900,7100,1950,16850
2010,-5800,-3600,3500,400,-2150,-7650
2011,-3800,10000,-1200,300,1950,7250
2012,9300,-2800,1900,-2000,-950,5450
2013,-3900,-400,-4500,12100,2900,6200
2014,-1900,4400,2900,-14900,1950,-7550
2015,-9300,0,1700,14200,0,6600
2016,11200,-2700,2900,7200,0,18600
2017,9000,100,-2100,2200,0,9200
2018,-2800,6500,-2800,4000,0,4900
2019,-5600,-2700,3900,-2000,0,-6400
2020,6400,-2800,3800,11200,0,18600
2021,200,-800,0,-3000,0,-3600
2022,2000,10200,-1800,-3000,0,7400
2023,0,-5500,2000,9400,-11400,-5500
2024,0,0,2900,4400,0,7300
2025,100,-3000,-1000,14200,9850,20150
2026,-3000,-800,0,0,0,-3800
2027,10300,10000,-1200,-1500,750,18350
2028,1000,-2400,-3800,-5400,-2150,-12750
2029,-5700,-5500,1800,11300,1950,3850
2030,-900,-9000,3000,-3000,0,-9900
2031,-5400,-2800,-10500,21500,1950,4750
2032,12000,6500,-10800,-4900,1950,4750
2033,-2700,3400,19600,-2600,-1200,16500
2034,0,-3600,1900,-2000,0,-3700
2035,-3800,10100,-900,5000,-950,9450
2036,8200,-700,10100,2000,-950,18650
2037,-4500,200,-800,7100,2900,4900
2038,-500,3600,-900,-4900,1950,-750
2039,12000,-5500,-8200,7200,0,5500
2040,-2800,6200,-8000,400,-1200,-5400
2041,-2800,-5600,14000,2000,0,7600
2042,0,700,-8900,1000,0,-7200
2043,-800,-3500,700,-3600,0,-7200
2044,-2600,7400,13000,-12800,0,5000
2045,9000,6700,8500,-9000,0,15200
2046,0,-5600,7600,4400,0,6400
2047,0,100,100,-2600,-1200,-3600
2048,-3000,1300,-600,3000,0,700
2049,100,-8400,4700,11000,-950,6450
2050,-3700,9200,-1800,-11000,-950,-8250
2051,12100,-6300,3800,7300,1700,18600
2052,-1700,10200,-2700,-14700,750,-8150
2053,-1000,3800,-900,3000,0,4900
2054,-2800,-5400,1200,-1000,-950,-8950
2055,0,-5300,3000,7200,0,4900
2056,-3500,-6600,-7300,7300,1950,-8150
2057,12100,600,1600,5400,-1200,18500
2058,100,11500,7500,7300,750,27150
2059,-900,7200,-7100,-4800,0,-5600
2060,1100,-6100,-100,8200,0,3100
2061,-3900,1600,16800,-7000,-950,6550
2062,-1800,-3400,-4700,12000,-950,1150
2063,200,4400,1900,-16900,1950,-8450
2064,-3700,900,-3300,7300,2900,4100
2065,9200,-3800,2900,-800,0,7500
2066,-3000,10000,12000,3000,0,22000
2067,100,9200,0,-12000,0,-2700
2068,0,400,-3600,10000,0,6800
2069,-3700,-2600,1100,10000,0,4800
2070,9300,-2800,2000,-2600,-1200,4700
2071,0,-5600,3800,10000,0,8200
2072,0,-700,-900,-2000,0,-3600
2073,0,7100,-900,4000,0,10200
2074,-900,-5600,-2900,13200,0,3800
2075,100,-2800,1700,-4400,-1200,-6600
2076,1200,4100,-1700,-1000,0,2600
2077,-2800,-5300,-1800,1000,0,-8900
2078,-3600,6600,-700,1200,-2150,1350
2079,3600,800,6600,-8000,-950,2050
2080,-6400,-800,4800,5700,500,3800
2081,11100,4600,-1000,-12700,1950,3950
2082,-2600,-2900,1100,19400,-11150,3850
2083,12100,1000,-5200,-4800,0,3100
2084,-5600,100,2000,8100,13950,18550
2085,-3000,6400,13900,-11000,-950,5350
2086,11200,0,0,8300,1700,21200
2087,-900,-2900,-900,13200,-1200,7300
2088,1100,-3600,-4900,1200,-950,-7150
2089,0,4500,-1000,2200,0,5700
2090,-900,-5600,4800,-6700,1950,-6450
2091,-1900,6700,2000,-4600,-950,1250
2092,0,-6100,200,-3700,1700,-7900
2093,-3600,1500,1800,2200,0,1900
2094,1000,-9000,3900,-3000,-950,-8050
2095,-7500,7500,-700,1200,-2150,-1650
2096,13100,3800,-1900,-14700,2900,3200
2097,100,1000,-3300,5300,1950,5050
2098,-900,-5600,-1700,13000,0,4800
2099,-4400,6600,14900,-14000,0,3100
2100,8300,-4300,-3000,15400,-1200,15200
2101,-5600,8000,3000,-11800,0,-6400
2102,-800,3800,1100,2000,-950,5150
2103,8100,-5500,-700,2000,0,3900
2104,1000,1200,4900,-7700,1950,1350
2105,0,-9400,2900,13000,-950,5550
2106,0,4700,-700,-3700,-7300,-7000
2107,-2800,3800,3900,-800,-1200,2900
2108,-3800,-3300,-800,0,12000,4100
2109,12000,1600,-1000,5200,0,17800
2110,0,1000,2100,-12800,-1200,-10900
2111,0,-6300,1100,12200,-1200,5800
2112,0,-1100,1800,-7800,-950,-8050
2113,-5700,3900,900,3200,0,2300
2114,-3500,6500,-9800,7100,1950,2250
2115,9000,-5400,4800,400,-2150,6650
2116,-2900,6500,100,-900,2900,5700
2117,100,-8300,15900,-2000,-950,4750
2118,-3000,-500,-3600,12000,0,4900
2119,11300,900,4800,-15300,-450,1250
2120,-900,12300,-3600,12000,-950,18850
2121,-1700,600,4800,-13900,1950,-8250
2122,-900,-3300,-800,10000,0,5000
2123,-1600,6500,200,-4900,1950,2150
2124,-3800,4400,-6500,-700,1950,-4650
2125,8100,-500,-3600,13000,0,17000
2126,-6300,7300,13100,-11000,0,3100
2127,9100,-5400,3600,9400,0,16700
2128,1100,6400,100,-13800,-1200,-7400
2129,100,-11400,4700,14000,0,7400
2130,-3800,-700,-4000,1200,0,-7300
2131,1000,1000,-7900,9000,0,3100
2132,0,3700,3600,13200,0,20500
2133,0,3500,11200,-9000,0,5700
2134,0,-3400,1000,9000,0,6600
2135,-3700,-5600,1700,2200,0,-5400
2136,9000,18600,-1700,4000,0,29900
2137,100,-6300,2900,-3000,0,-6300
2138,-2800,0,1900,12000,0,11100
2139,-2900,21300,-10900,1000,0,8500
2140,-800,-2600,-2000,9200,0,3800
2141,9000,-5300,-1600,3000,0,5100
2142,-3000,-8400,17700,13200,-1200,18300
2143,-800,-5800,-2500,-1800,-1200,-12100
2144,-8400,-3400,3000,13000,-950,3250
2145,8200,9400,-100,11400,0,28900
2146,-2600,3700,2100,-15900,1950,-10750
2147,3400,-2500,1800,12200,0,14900
2148,4500,11300,100,10500,-9450,16950
2149,8500,-5300,2100,9200,-1200,13300
2150,-1900,9500,-4600,3000,11050,17050
2151,-3500,6600,-1700,1200,0,2600
2152,12200,-10900,800,-4700,1950,-650
2153,-900,1200,1200,-4900,1950,-1450
2154,-4600,-3500,3000,-600,-2400,-8100
2155,-3700,10100,1100,-3400,-2400,1700
2156,12300,-3400,-900,-2800,-950,4250
2157,-2900,-7900,200,13000,0,2400
2158,-5600,8500,3000,-4900,1950,2950
2159,-3800,-5500,2000,15200,-3100,4800
2160,12000,3800,1100,-1700,1700,16900
2161,-5800,5800,4000,-4500,750,250
2162,5400,4400,-6100,11000,-1900,12800
2163,-2900,6600,-2700,-10900,2900,-7000
2164,-800,-10800,17900,5300,1000,12600
2165,9000,6400,-7100,-2800,-950,4550
2166,-7600,6600,-1900,300,2900,300
2167,13300,-11200,16500,-7500,750,11850
2168,-5700,-6300,2000,16200,-2150,4050
2169,-6600,8700,-1600,-900,2900,2500
2170,11300,4700,1800,-7400,-950,9450
2171,-1800,3600,-2600,8400,0,7600
2172,0,600,2000,-11900,1950,-7350
2173,0,-6300,15800,-3000,-950,5550
2174,-3800,10200,-1800,2100,2900,9600
2175,9000,3900,-1600,4000,0,15300
2176,100,-2600,1000,-5800,0,-7300
2177,-3000,800,4800,5000,0,7600
2178,-2900,-3500,1000,1000,0,-4400
2179,5700,10100,1000,-1000,0,15800
2180,-3800,-2700,-2300,16400,0,7600
2181,9100,-5400,-1000,1200,0,3900
2182,-4600,6500,1100,0,0,3000
2183,1100,-8400,4700,-2000,0,-4600
2184,-2000,3700,-7100,13000,0,7600
2185,10300,-1500,-900,-3000,0,4900
2186,-2000,900,10200,13200,-1200,21100
2187,-6700,-700,-2000,4400,-1200,-6200
2188,11300,7300,4800,6200,0,29600
2189,-2700,-3500,1900,7200,-950,1950
2190,-1800,200,-3700,-1000,0,-6300
2191,-900,-5500,1100,6100,1950,2750
2192,-3700,5900,200,1200,-2150,1450
2193,12100,7500,-100,-4300,1700,16900
2194,-2000,800,2700,-10800,0,-9300
2195,100,-5300,1100,7200,-950,2150
2196,-3000,3800,-11300,3400,-950,-8050
2197,-2900,-6300,1100,8100,2900,2900
2198,-3200,-5500,14900,-8700,1950,-550
2199,15000,12600,4800,-800,0,31600
2200,0,-6300,-2600,11200,-1200,1100
2201,100,1900,3000,-12400,-2400,-9800
2202,-2900,3800,200,-8800,-1200,-8900
2203,-8400,3700,4800,3200,-2150,1150
2204,10400,-6100,-100,-1600,-1200,1400
2205,-4600,7400,900,-1700,1950,3950
2206,-800,6500,1100,-3800,-1900,1100
2207,12000,-6300,-8200,4300,2900,4700
2208,-2800,1600,3900,1100,1000,4800
2209,-3000,6500,13000,-9000,-950,6550
2210,-2800,9400,-800,-1900,2900,6800
2211,5600,-3000,2900,100,1950,7550
2212,0,-5400,-3800,9500,750,1050
2213,-3600,-6100,300,-1000,0,-10400
2214,6300,4800,1200,2000,0,14300
2215,-3000,900,-8500,14400,0,3800
2216,10300,-6300,3000,-4800,0,2200
2217,-800,-1400,17700,2000,0,17500
2218,1200,-3500,-1200,-3800,0,-7300
2219,1100,9300,-12800,10000,0,7600
2220,-2800,6400,2100,200,0,5900
2221,-3900,9400,100,-800,0,4800
2222,1100,-8300,14900,10000,0,17700
2223,-6500,6700,-10700,1000,0,-9500
2224,11200,-2800,1000,6200,0,15600
2225,-1600,-700,14800,-6600,0,5900
2226,0,-5500,2000,11200,-1200,6500
2227,0,6400,3800,-3000,0,7200
2228,0,-600,-2700,12200,-1200,7700
2229,0,-5400,2000,-2000,-950,-6350
2230,-2600,8400,900,20200,-11150,15750
2231,8400,300,-5600,300,13700,17100
2232,0,-8600,2000,11100,1950,6450
2233,0,3100,3000,-2000,0,4100
2234,0,7400,200,-2800,-950,3850
2235,-800,-6000,-700,10000,-950,1550
2236,-1700,-9000,3700,-6500,1700,-11800
2237,100,19400,-11000,5500,1950,15950
2238,-6500,900,4600,-7800,0,-8800
2239,12000,-6300,13100,-2800,-1200,14800
2240,-3900,-2700,2000,11200,0,6600
2241,-1800,-6500,2000,2000,0,-4300
2242,10400,2900,3800,10000,-950,26150
2243,1100,-2800,-4600,-1900,1950,-6250
2244,-2800,15600,1500,1600,-950,14950
2245,100,-6300,2000,-7700,1700,-10200
2246,-5800,-600,-1000,13400,0,6000
2247,4600,13800,3000,-9000,0,12400
2248,-4800,-2700,2700,9400,0,4600
2249,11200,13000,2100,-11000,0,15300
2250,-3800,-9100,2600,15200,0,4900
2251,-3600,-5400,-1800,0,0,-10800
2252,-1600,3800,3000,0,0,5200
2253,9000,5700,1100,13000,0,28800
2254,-2800,7400,100,-12800,0,-8100
2255,10400,6600,100,-800,0,16300
2256,-1800,-2800,2900,-3000,0,-4700
2257,-3000,900,-6600,13400,0,4700
2258,0,-500,-3600,-1000,0,-5100
2259,-4500,-2600,12200,11000,0,16100
2260,10200,6300,2000,1000,0,19500
2261,-2700,4000,-8900,11000,0,3400
2262,-3700,3600,-10200,2200,0,-8100
2263,12000,-8300,15900,-1000,0,18600
2264,-5500,3600,4500,-11600,-1200,-10200
2265,-2800,-3700,12100,1000,0,6600
2266,7300,7300,1000,4200,-1200,18600
2267,1100,-600,-3600,-4000,-950,-8050
2268,-3000,-8200,4600,11600,-2150,2850
2269,-2800,-2900,-2000,-500,1700,-6500
2270,8400,8400,3300,5700,1000,26800
2271,-3000,9500,200,-800,0,5900
2272,-3900,6500,1100,-15700,1950,-10050
2273,9400,-2800,1900,-1000,-950,6550
2274,-6400,200,-400,7500,2900,3800
2275,9100,-600,-13800,11400,-1200,4900
2276,-2800,-2600,2700,7400,0,4700
2277,-2700,-5400,14000,-4000,0,1900
2278,11200,3700,-700,15000,-950,28250
2279,-800,3600,1000,-12800,-2150,-11150
2280,-2600,-3400,4900,-12500,2900,-10700
2281,-2000,1600,3800,1300,750,5450
2282,-6600,9200,1900,-8000,0,-3500
2283,12100,-700,-3700,9000,-950,15750
2284,-6600,7300,3800,4200,-1200,7500
2285,11200,-5600,-3000,700,-450,2850
2286,-1700,-2800,2000,-5000,-950,-8450
2287,0,-12200,5700,11300,750,5550
2288,-3900,-600,-1800,0,0,-6300
2289,-1900,-2600,-1800,7100,1000,1800
2290,-1700,12400,-4700,9600,-2150,13450
2291,13000,-12200,2900,-900,2900,5700
2292,-3000,-2700,7400,9300,1950,12950
2293,100,7400,-1700,-11800,-2150,-8150
2294,-2800,800,-7300,11300,2900,4900
2295,100,5700,100,-1000,-950,3950
2296,-800,7300,14000,-1800,0,18700
2297,-2900,3900,200,-12900,1950,-9750
2298,12200,-3300,-3800,8200,-950,12350
2299,-3000,4600,1800,-11500,2900,-5200
2300,-3000,6500,2000,200,0,5700
2301,100,900,-6200,-3000,0,-8200
2302,8200,-5400,1100,15000,0,18900
2303,0,1000,12900,-800,0,13100
2304,-2700,3800,-7900,-2800,-1200,-10800
2305,-5700,-2800,3800,15200,-1200,9300
2306,11300,3400,700,-12800,0,2600
2307,-5800,-3500,14000,14200,-2150,16750
2308,-900,10400,-5400,-9800,-1200,-6900
2309,-4700,-6300,4800,9100,1950,4850
2310,8200,4500,2000,-10000,-1900,2800
2311,0,-2800,1900,7300,1700,8100
2312,0,9200,0,-13500,-450,-4750
2313,100,-2700,-2100,11400,-2150,4550
2314,-3800,-5400,1100,11100,1950,4950
2315,9000,6500,-9900,2000,-950,6650
2316,-2800,-3500,2000,7100,1950,4750
2317,200,7300,12900,-16700,1950,5650
2318,-3800,-2500,-1700,13000,-950,4050
2319,12000,-5600,1100,-6900,2900,3500
2320,-5800,3700,-4300,11100,1950,6650
2321,100,-3800,0,1200,-1200,-3700
2322,0,10200,-13000,11200,0,8400
2323,0,-5700,11200,1200,-1200,5500
2324,2600,-3500,4800,15200,-1200,17900
2325,-6400,10000,14900,-2000,-950,15550
2326,12100,0,-1000,-600,-2400,8100
2327,-2800,200,-3700,11300,750,5750
2328,-3000,-5500,2000,0,-1900,-8400
2329,11200,-6300,1700,8300,2900,17800
2330,-3000,7700,-4600,-10400,-3100,-13400
2331,-2800,3900,4000,-6700,1950,350
2332,100,-5200,-1700,-2700,1700,-7800
2333,0,-1900,-9700,-900,1950,-10550
2334,300,-6100,-900,7200,-1900,-1400
2335,-900,1600,15000,-1700,2900,16900
2336,-1900,3800,2100,-7500,-8250,-11750
2337,-6600,3600,-7000,14200,-2150,2050
2338,12100,-11000,2400,-4500,2900,1900
2339,-6600,3800,900,5400,10800,14300
2340,10200,-3500,14000,-3800,0,16900
2341,2000,1900,1200,-3000,0,2100
2342,-3000,3700,-11000,14200,-950,2950
2343,0,-9200,8500,-3800,-950,-5450
2344,-7400,4800,12200,1100,2900,13600
2345,13100,-6600,1000,-5700,1950,3750
2346,-2800,-3500,1800,8400,0,3900
2347,-900,6700,3000,-3800,0,5000
2348,-2900,3600,-6400,12200,0,6500
2349,11300,12100,-900,-3000,0,19500
2350,-4800,6600,12200,4000,0,18000
2351,-3800,3800,-9000,14000,0,5000
2352,200,-3400,-2700,-3000,0,-8900
2353,9200,4600,13800,3200,0,30800
2354,-2900,6600,-1700,-10000,0,-8000
2355,100,-6100,900,17800,-11400,1300
2356,-3800,7200,-1100,-7800,0,-5500
2357,12000,-2100,8600,-1200,9600,26900
2358,-3700,-2800,3800,-1000,0,-3700
2359,-2000,9400,-2700,2000,-950,5750
2360,0,-3300,-1000,-3600,0,-7900
2361,100,4700,0,-6500,1950,250
2362,-3800,-8200,1800,11300,1950,3050
2363,6400,-6600,3900,1000,0,4700
2364,100,-5700,700,11400,0,6500
2365,200,-3300,-3900,-2800,0,-9800
2366,-7200,5500,2000,14000,0,14300
2367,10000,4500,-1100,-7800,0,5600
2368,0,12900,3900,1000,0,17800
2369,-9200,9200,2000,-10000,0,-8000
2370,7200,-5300,3000,10200,0,15100
2371,1200,3700,2000,-13800,0,-6900
2372,5400,-700,2800,9200,0,16700
2373,1000,7600,-4500,2200,-1200,5100
2374,-2800,-8600,5700,2000,0,-3700
2375,-3800,-3400,-2600,14000,-950,3250
2376,12000,1800,2100,-12000,-950,2950
2377,-2700,3900,2900,-900,2900,6100
2378,100,-12200,3800,-900,1950,-7250
2379,-2700,7400,-800,1000,0,4900
2380,4500,6700,-1600,-9000,0,600
2381,-5200,-3400,2900,10200,-1200,3300
2382,12000,4600,3000,-13800,0,5800
2383,100,3700,800,1200,0,5800
2384,0,-6300,1100,-2000,0,-7200
2385,0,7700,-1900,-600,0,5200
2386,100,600,1900,-8000,0,-5400
2387,-2900,-6200,100,12200,-1200,2000
2388,-3500,4400,3800,1000,0,5700
2389,11100,3400,1000,-8000,0,7500
2390,-1900,-11800,3900,13200,-2150,1250
2391,200,7300,-13000,-1800,-950,-8250
2392,-2800,6300,1100,-700,2900,6800
2393,-800,-3300,15900,-11500,1950,2250
2394,1200,7300,100,-4800,0,3800
2395,-1800,-8500,2700,-600,0,-8200
2396,2000,6200,100,8400,-10200,6500
2397,-800,-3500,1600,7600,-1200,3700
2398,1000,7100,-12000,2200,0,-1700
2399,-3000,-9200,4800,11000,11050,14650
2400,-700,7400,12100,-13800,-1200,3800
2401,6200,-3600,1700,13300,1950,19550
2402,0,0,0,-3000,-950,-3950
2403,-3800,12200,-2700,12100,2900,20700
2404,9100,-5300,-800,2000,0,5000
2405,-3700,-6300,2100,9000,0,1100
2406,-5500,7200,5600,-13800,0,-6500
2407,9300,-3700,-3300,15400,0,17700
2408,0,4600,200,1200,-1200,4800
2409,-2700,-5700,4800,-1600,-1200,-6400
2410,-1700,-3300,-2600,11000,-950,2450
2411,10100,-9100,2800,3000,0,6800
2412,-3000,19200,-800,100,1950,17450
2413,100,-9100,4700,-2000,-950,-7250
2414,-3800,3600,2900,2100,2900,7700
2415,8100,12200,-3000,200,0,17500
2416,1100,6700,-3900,200,0,4100
2417,-3800,-8300,2000,3000,0,-7100
2418,200,-9400,1000,9000,0,800
2419,-1700,-5300,2100,600,-3600,-7900
2420,8400,6700,200,2000,0,17300
2421,-9500,9300,3900,1000,-950,3750
2422,300,800,2900,-1000,-950,2050
2423,11100,6500,1900,-14900,1950,6550
2424,1000,-3500,-2700,7300,750,2850
2425,-3000,2000,3000,5000,-950,6050
2426,-7400,-3500,100,-1900,2900,-9800
2427,13200,1800,2000,-4900,1950,14050
2428,-5800,6500,2000,-7000,0,-4300
2429,5700,3600,-7000,0,0,2300
2430,0,-5600,2900,10000,0,7300
2431,-3800,-700,-2100,3200,0,-3400
2432,11100,7400,11200,200,-1200,28700
2433,-2000,-5500,-1100,1200,0,-7400
2434,-5700,4000,200,4000,-950,1550
2435,-800,-6400,1800,8400,0,3000
2436,10300,-8400,4400,-3700,1950,4550
2437,-1000,6600,-12900,12200,-950,3950
2438,-2700,18500,-6100,-8700,2900,3900
2439,-3800,-5500,11900,14200,0,16800
2440,9200,-6300,700,200,0,3800
2441,-2800,-5600,3900,11000,0,6500
2442,100,3600,11200,-10000,0,4900
2443,200,2700,3800,11000,0,17700
2444,-1800,10000,-1200,2200,0,9200
2445,-1700,6600,100,-12000,0,-7000
2446,12200,-8300,-12800,22200,0,13300
2447,-2700,-2600,600,-3200,-1200,-9100
2448,0,700,15900,1200,0,17800
2449,-6600,3600,-5200,1000,0,-7200
2450,12100,-2700,-900,10000,0,18500
2451,200,-9400,11700,1200,0,3700
2452,-2900,-3300,-1100,13600,-1200,5100
2453,-5800,19200,2000,4000,0,19400
2454,11400,900,2900,-14000,-950,250
2455,-3000,-6100,2100,12200,-950,4250
2456,-900,10100,-1800,-16700,1700,-7600
2457,1100,-2000,3300,-100,-450,1850
2458,-3000,-3600,-1100,2400,-1200,-6500
2459,-3700,-5400,3900,10000,-950,3850
2460,200,3700,-8000,400,-2400,-6100
2461,12200,11400,-4900,6300,1950,26950
2462,-2700,7200,1000,2000,-1900,5600
2463,-2700,-5500,14900,-5900,2900,3700
2464,0,6600,-13800,10500,-200,3100
2465,-5700,-5400,5700,-800,-950,-7150
2466,11300,-6600,1900,6300,2900,15800
2467,0,7300,14900,-15700,1950,8450
2468,100,3400,-900,1000,-950,2650
2469,100,-2700,-1200,-2500,1700,-4600
2470,-6500,6400,1900,5000,0,6800
2471,12000,-5500,2900,9000,-950,17450
2472,100,-6300,1000,2400,-2400,-5200
2473,-900,10100,-1800,-900,1950,8450
2474,1000,3700,-200,-9800,-1900,-7200
2475,0,-5300,-1600,9100,2900,5100
2476,100,-12000,5400,-2700,1950,-7250
2477,-2700,7500,-800,2000,-950,5050
2478,0,-6400,2900,-4900,2900,-5500
2479,-900,-6200,2000,12000,0,6900
2480,1100,16600,100,-12000,0,5800
2481,0,3700,-10100,11200,0,4800
2482,-2700,-3300,1100,-3800,0,-8700
2483,-6400,4400,-8400,14200,0,3800
2484,9000,-6200,12200,1200,-1200,15000
2485,0,-3600,1700,8400,0,6500
2486,-3800,13800,15000,5000,0,30000
2487,12000,-3600,-1700,-1800,0,4900
2488,0,-8100,3700,8400,0,4000
2489,0,6600,-800,-10000,0,-4200
2490,0,6500,-1300,11400,0,16600
2491,-3700,3700,-8500,400,0,-8100
2492,-1600,-6400,3900,9200,-1200,3900
2493,-6500,4600,14900,-8000,0,5000
2494,9200,-600,-2900,11200,-950,15950
2495,-3700,-6100,-1700,14000,0,2500
2496,12000,13700,3900,-12900,1950,18650
2497,-6700,-3500,1100,14000,-950,3950
2498,1100,6700,1000,-18700,2900,-7000
2499,-3500,4300,1100,4000,0,5900
2500,9200,-2800,4800,-2800,0,8400
2501,-900,6600,-800,1000,0,5900
2502,1100,-8100,2000,8000,0,3000
2503,-3000,-8900,1200,3000,0,-7700
2504,-6400,6800,1200,1000,0,2600
2505,9200,1400,3900,-9000,0,5500
2506,-2500,3700,0,1000,0,2200
2507,10300,-3300,-800,0,0,6200
2508,-2000,10100,-10800,6200,0,3500
2509,200,3800,-200,-12400,-1200,-9800
2510,-5800,-5300,13200,14200,-1200,15100
2511,8500,-3500,1100,9000,0,15100
2512,-2800,1600,4900,-9800,0,-6100
2513,-2900,1200,-8900,14000,-950,2450
2514,-800,-9100,4900,-4800,-950,-10750
2515,12200,1600,-900,2100,2900,17900
2516,-2800,3800,11100,-10900,1950,3150
2517,-900,-6300,1100,9000,0,2900
2518,-2000,-900,2100,5000,0,4200
2519,-700,-6300,2000,-3000,0,-8000
2520,1000,-5600,3600,8400,0,7400
2521,100,13000,2900,-10000,0,6000
2522,0,-3500,100,11000,0,7600
2523,0,4500,-100,2200,0,6600
2524,-3600,3700,200,-9800,-1200,-10700
2525,12000,-3500,1700,7400,0,17600
2526,-2700,4400,2000,-11800,0,-8100
2527,-3900,-6400,2900,14000,0,6600
2528,1100,3800,100,-14000,0,-9000
2529,-900,9200,1000,12000,0,21300
2530,6500,-800,900,1000,0,7600
2531,100,9400,-3700,-1000,0,4800
2532,0,3600,-1000,4400,-1200,5800
2533,-3900,3800,2000,4000,0,5900
2534,200,-6400,1000,9000,-950,2850
2535,-2800,-6300,3900,-1800,0,-7000
2536,9000,4400,2900,2300,750,19350
2537,0,8400,2800,-5900,1950,7250
2538,100,10000,-1200,1200,0,10100
2539,-2900,9400,-3700,1400,-2400,1800
2540,-2700,-2200,-2500,-800,-1200,-9400
2541,2600,400,300,12200,-950,14550
2542,8500,-8400,5700,-1000,0,4800
2543,-800,-2700,-1700,7100,1950,3850
2544,-2000,1000,5800,-10800,-1900,-7900
2545,0,-12100,3900,9100,2900,3800
2546,100,7400,-1100,-1700,1950,6650
2547,-6500,6500,100,-11000,-950,-11850
2548,8100,-6100,-1900,11300,2900,14300
2549,200,4500,2800,-12800,0,-5300
2550,1100,-1900,-800,1000,0,-600
2551,-3000,-3300,200,-800,0,-6900
2552,-800,1600,3900,0,0,4700
2553,5500,900,4800,-6800,-1200,3200
2554,-2000,-3500,1100,9200,0,4800
2555,-800,7400,1100,-14800,0,-7100
2556,9000,-6300,4800,12600,-2400,17700
2557,-3900,10000,0,-10000,0,-3900
2558,-1800,9500,-11700,11000,-950,6050
2559,-6600,-6100,2100,14000,-950,2450
2560,12000,7200,13000,-13900,2900,21200
2561,0,-5800,700,11500,750,7150
2562,0,6600,-800,-15000,0,-9200
2563,8200,-5500,800,16200,-950,18750
2564,0,700,3900,-11600,-1200,-8200
2565,0,-600,-2700,7100,1950,5750
2566,-2800,7200,3800,-11000,-950,-3750
2567,-3000,-600,-1800,10300,1700,6600
2568,0,7400,-2600,-12000,0,-7200
2569,-3800,-2800,3800,11200,0,8400
2570,12200,100,900,7200,-950,19450
2571,-2800,0,2900,-4800,-950,-5650
2572,-3000,0,0,11100,2900,11000
2573,100,100,-2800,-4900,1950,-5550
2574,0,-5600,3800,12000,0,10200
2575,-3500,-500,-3600,-3000,0,-10600
2576,9200,4600,3000,2000,0,18800
2577,100,-8400,3800,200,-1200,-5500
2578,0,9200,-1200,200,0,8200
2579,-3700,-2600,1100,-1000,0,-6200
2580,-2700,-3500,-900,14000,0,6900
2581,9200,-2800,-900,10000,0,15500
2582,0,8700,2000,-2600,-1200,6900
2583,-2700,10000,100,1000,0,8400
2584,-6600,-2800,2900,-1000,-950,-8450
2585,12100,0,2800,9400,-1200,23100
2586,-2800,300,-5800,-1700,1950,-8050
2587,-3500,-5600,3600,9200,-950,2750
2588,9000,-5500,2000,-900,2900,7500
2589,-5700,9500,-800,2000,0,5000
2590,10500,-6400,1000,-3000,0,2100
2591,-1600,7200,1800,0,0,7400
2592,0,-600,-3600,-1800,-1200,-7200
2593,200,-2700,-1200,7400,0,3700
2594,-2900,-8200,1800,2200,-950,-8050
2595,-3000,5800,200,14000,0,17000
2596,-1700,-1000,4900,-2900,1950,1250
2597,10000,1000,-7900,1000,-950,3150
2598,0,-14900,4300,-500,2900,-8200
2599,-800,4600,11200,0,0,15000
2600,1100,900,-8000,20200,-10200,4000
2601,0,-6400,2000,-2800,0,-7200
2602,-800,7200,0,-1000,12000,17400
2603,-1900,1100,13100,-8000,0,4300
2604,0,-9200,1100,14000,0,5900
2605,-5400,4400,2700,-11800,0,-10100
2606,11000,3700,2900,3000,0,20600
2607,0,-600,-2700,-1000,0,-4300
2608,-900,2000,1200,0,0,2300
2609,-5600,6500,1100,3200,-1200,4000
2610,9000,-6400,5700,-1800,0,6500
2611,0,10100,-3300,1400,0,8200
2612,0,6500,-4500,-8000,0,-6000
2613,200,-12100,1900,15200,-1200,4000
2614,0,1700,2700,-11800,0,-7400
2615,-2800,6400,-1900,4000,-950,4750
2616,-3000,-9000,5800,400,-1200,-7000
2617,7700,7200,-300,-2700,1950,13850
2618,-1700,3600,-11700,2200,-2150,-9750
2619,-5700,-9200,6600,9100,2900,3700
2620,-3600,10200,11200,0,-950,16850
2621,7300,900,-7000,3000,-950,3250
2622,13100,-3400,0,7100,2900,19700
2623,-2800,-2500,-700,-4700,750,-9950
2624,400,6400,0,7000,-2400,11400
2625,-3000,6000,-900,-600,0,1500
2626,-900,-8400,15900,10000,-950,15650
2627,1000,-2100,6700,-12600,-1200,-8200
2628,-1700,9200,3800,8200,-950,18550
2629,-1800,-700,-1900,9100,1950,6650
2630,200,3600,-7100,-6900,1950,-8250
2631,9000,12000,-1200,15200,-950,34050
2632,0,3600,1200,-900,2900,6800
2633,0,-9000,3000,6100,1950,2050
2634,0,-5600,14900,-1000,0,8300
2635,0,-500,-2700,11000,0,7800
2636,-2800,11800,-5300,9000,0,12700
2637,-5800,1700,5800,-8000,0,-6300
2638,11200,-6100,-3100,11400,0,13400
2639,0,6900,-1600,-2000,0,3300
2640,0,-2200,3900,2000,0,3700
2641,-3000,3200,-900,15400,-1200,13500
2642,100,1600,4500,-13600,0,-7400
2643,-3800,3700,200,4000,0,4100
2644,11200,-11900,8600,-5800,0,2100
2645,1000,-8500,2900,15200,-1200,9400
2646,-800,12700,1000,-10000,0,2900
2647,1200,-3500,-1100,8200,-950,3850
2648,-2800,7500,-300,-12400,0,-8000
2649,-2900,-3400,-2700,12100,1950,5050
2650,-3000,-6000,-700,13000,-950,2350
2651,-700,7500,-700,-17700,2900,-8700
2652,6300,13300,3100,-9000,0,13700
2653,-3600,-11900,2100,12000,0,-1400
2654,9700,7400,-1800,0,0,15300
2655,-2900,-6300,100,1000,0,-8100
2656,100,16400,-6100,-5200,-2400,2800
2657,-4300,-8500,4800,-1800,0,-9800
2658,10000,6600,13100,-800,-950,27950
2659,-5600,-3600,4800,-3000,0,-7400
2660,-1500,4600,-3100,-3500,1950,-1550
2661,13000,3600,-9200,-600,-2150,4650
2662,-2800,-6200,8600,-1500,2900,1000
2663,-5800,7300,12500,-4400,-1200,8400
2664,-6600,9300,-1700,3000,0,4000
2665,9300,-6300,4500,-2800,-950,3750
2666,5400,10200,-1700,4000,0,17900
2667,-3900,6700,200,1200,-950,3250
2668,12300,-2600,-800,-8700,2900,3100
2669,-6700,-5400,5800,8300,1950,3950
2670,-1900,6500,-900,-11000,0,-7300
2671,8600,-3400,-1100,10200,0,14300
2672,-6400,7200,-300,-8800,0,-8300
2673,12000,-5800,-100,11400,0,17500
2674,-2600,1000,-5200,-3000,0,-9800
2675,-900,-5700,-1700,14200,-1200,4700
2676,-4800,1200,4000,-10000,0,-9600
2677,11200,-9200,15600,11600,-2400,26800
2678,-3000,4700,200,-6800,-1200,-6100
2679,100,-6400,100,10000,-950,2850
2680,-2800,3700,6400,-2600,0,4700
2681,-4600,9400,-1800,-900,1000,3100
2682,9500,6300,-12800,12000,-950,14050
2683,-1700,-3500,3600,-8300,1700,-8200
2684,-3800,7400,13100,-1700,1950,16950
2685,9100,3600,-8100,1200,-2150,3650
2686,-2900,-2400,-5400,9100,2900,1300
2687,100,4100,14200,-16600,-950,850
2688,-3900,-8100,4900,8200,0,1100
2689,12200,6500,-1700,-14700,750,3050
2690,-800,-6300,2100,6200,-950,250
2691,-1900,1700,3300,-2300,2900,3700
2692,-2700,-6300,3800,-2000,0,-7200
2693,-3700,-6400,-1100,13200,0,2000
2694,6500,7200,4700,-13000,0,5400
2695,-4500,8300,2900,10200,0,16900
2696,10200,100,-2300,400,0,8400
2697,0,15900,200,0,0,16100
2698,-2800,-2800,3900,-4800,0,-6500
2699,6500,-8100,200,25200,-10200,13600
2700,-3800,-3400,100,-1000,0,-8100
2701,-6400,6500,-5200,12400,9600,16900
2702,11100,12100,-1800,11000,0,32400
2703,-1900,-2500,11200,-4800,-950,1050
2704,-6600,-2700,2000,13200,-2150,3750
2705,12100,800,3800,-4500,-8500,3700
2706,-2700,-700,-2100,9300,1000,4800
2707,0,4600,1100,-13000,-950,-8250
2708,8300,-5500,-3200,11500,14900,26000
2709,0,-6200,-700,6500,-8250,-8650
2710,-5800,-6300,5800,11200,0,4900
2711,-2800,6400,5700,10000,12000,31300
2712,8200,-3500,1000,2000,0,7700
2713,-3000,8600,-2900,13200,0,15900
2714,0,-2800,3800,-4800,0,-3800
2715,-3000,9400,-800,14200,-1200,18600
2716,11200,3900,1100,-12000,0,4200
2717,-3000,-5400,200,13000,-950,3850
2718,0,3500,1100,14200,-2150,16650
2719,-900,6900,-700,-17700,2900,-9500
2720,-6200,-3600,3800,6100,1950,2050
2721,13000,1400,-5400,-3400,-1200,4400
2722,100,9400,-3700,200,-1200,4800
2723,-2700,-8500,14900,2000,-950,4750
2724,-5800,6700,200,4000,0,5100
2725,11300,-9000,2100,-5900,1950,450
2726,-2600,10200,800,-2200,-3350,2850
2727,0,700,1100,-13900,2900,-9200
2728,-2800,-2700,-400,23600,-11150,6550
2729,-7500,6400,1700,4200,0,4800
2730,12300,-5500,1000,-5900,13950,15850
2731,-1800,6500,2900,0,-950,6650
2732,-3600,-3500,-900,-2900,2900,-8000
2733,1700,400,-1600,1000,0,1500
2734,13200,-5400,-100,7400,0,15100
2735,-3000,6500,2000,14000,0,19500
2736,-5700,-6300,3800,0,0,-8200
2737,11200,-3400,-1700,12200,-1200,17100
2738,0,10800,2700,-8800,0,4700
2739,-3700,-3300,-700,12200,-2150,2350
2740,100,-5300,1200,-4600,-1200,-9800
2741,-1800,5600,2000,7300,1950,15050
2742,-12200,9500,-7900,13000,-950,1450
2743,19600,-5500,3000,-4700,750,13150
2744,1100,100,14000,13000,0,28200
2745,0,4500,200,-15900,1950,-9250
2746,-2700,6500,3600,-600,-950,5850
2747,-3000,-3400,-2000,-1700,2900,-7200
2748,8600,1700,2000,-2000,0,10300
2749,200,3600,-8900,12200,-1200,5900
2750,-3000,-800,1900,-1800,0,-3700
2751,-3400,7300,14000,-1000,-950,15950
2752,9000,-3300,1100,200,0,7000
2753,0,10100,-1700,-4700,1950,5650
2754,-2800,-2700,5700,-5800,-950,-6550
2755,0,400,-4500,19300,-7300,7900
2756,-3000,-5400,-1300,-600,0,-10300
2757,8500,-6400,1700,12400,10800,27000
2758,-3000,-1200,6700,4200,-1200,5500
2759,100,9500,-12900,-5600,0,-8900
2760,100,-6100,-2000,11400,-1200,2200
2761,0,1900,14100,-1800,-11150,3050
2762,-9400,9400,-1900,5200,-950,2350
2763,12000,3700,-4200,-10500,2900,3900
2764,-3700,-8200,800,11300,13950,14150
2765,9000,-6300,12200,2000,0,16900
2766,-2600,4700,2900,-2800,0,2200
2767,-8400,3800,2100,5000,0,2500
2768,14000,-11900,3100,-2800,0,2400
2769,-3600,-2700,2000,10000,0,5700
2770,1100,-9000,3900,-3000,0,-7000
2771,0,18900,-13500,12000,0,17400
2772,-800,-6300,1100,-1800,-1200,-9000
2773,1100,16600,11200,-1000,0,27900
2774,100,-9300,2900,8400,-10200,-8100
2775,-2800,-6200,3000,10000,-950,3050
2776,5400,19300,1100,2000,11050,38850
2777,-6600,-6200,3900,-900,2900,-6900
2778,6400,10200,200,-1900,1950,16850
2779,8200,9200,4700,-16600,0,5500
2780,0,-2800,-3900,15200,0,8500
2781,-2800,-3400,-10000,8200,0,-8000
2782,-6500,7400,2900,1200,0,5000
2783,8300,-5600,16800,-1000,0,18500
2784,1000,9300,-10900,9000,0,8400
2785,-6500,200,-3900,2400,-1200,-9000
2786,9200,-2600,14100,8200,0,28900
2787,0,-8300,4800,-2000,0,-5500
2788,100,-6300,-4800,2400,-1200,-9800
2789,-3800,4600,2900,-10800,0,-7100
2790,12400,1000,-1100,200,-950,11550
2791,-5700,-3600,2000,12000,0,4700
2792,-3000,4400,2900,-9500,-450,-5650
2793,-800,1000,-4200,8200,-950,3250
2794,12000,-500,-4800,-3700,1950,4950
2795,-2800,4400,6600,9200,0,17400
2796,-800,-9100,3900,-4900,1950,-8950
2797,-2000,-500,-14100,23400,-950,5850
2798,0,16500,14000,-13900,2900,19500
2799,0,-6200,-700,-3000,0,-9900
2800,0,10100,12800,-4400,0,18500
2801,100,6400,3800,-15800,0,-5500
2802,-6600,-2800,2600,13600,-2400,4400
2803,12000,0,0,11200,-1200,22000
2804,100,100,-2800,200,-1200,-3600
2805,-3600,-5500,2900,11000,-950,3850
2806,1000,1200,-8800,-5900,1950,-10550
2807,100,400,-17800,20600,-3100,200
2808,-3000,3700,2000,-10900,2900,-5300
2809,-3500,-5500,15600,-7500,1950,1050
2810,12100,3400,-1800,5000,-950,17750
2811,-5800,-3000,3100,-7500,2900,-10300
2812,-700,1700,15000,0,0,16000
2813,5400,-3500,200,11200,-10200,3100
2814,1000,1800,3900,1000,0,7700
2815,100,-8800,300,-2000,12000,1600
2816,0,3700,-10100,10200,0,3800
2817,-3800,6500,3600,400,0,6700
2818,9100,-6200,9100,13200,0,25200
2819,-2700,-6000,-700,-800,-1200,-11400
2820,-3000,6400,2900,2200,-1200,7300
2821,11200,1000,5800,-14800,0,3200
2822,-3900,6500,1100,-10800,-950,-8050
2823,-2000,3700,6600,7300,1950,17550
2824,0,-5800,-4600,-800,-950,-12150
2825,-2900,-6300,2900,9500,1700,4900
2826,11400,6600,1100,-2000,0,17100
2827,300,3600,1000,0,-950,3950
2828,100,18700,-4500,-10000,0,4300
2829,-2600,-6300,6600,5300,1950,4950
2830,0,-5300,-700,9000,0,3000
2831,-5600,18500,5800,-18500,1950,2150
2832,-800,-9000,2100,11000,0,3300
2833,12000,7200,5700,-17600,0,7300
2834,-900,9600,-13600,11000,0,6100
2835,-1800,400,-7400,0,0,-8800
2836,-5800,-8300,18700,13000,0,17600
2837,-1700,-6200,-1000,200,0,-8700
2838,9400,7400,1100,0,0,17900
2839,100,-11800,-1600,12200,-1200,-2300
2840,1000,-8900,800,200,0,-6900
2841,100,13500,100,3000,0,16700
2842,-2900,3900,-1300,-10200,-1200,-11700
2843,-9200,-3500,4900,13200,-1200,4200
2844,8300,4800,-3800,-8800,-950,-450
2845,12100,3900,1100,-4800,0,12300
2846,0,-8400,6700,7500,750,6550
2847,0,800,2100,-10800,-950,-8850
2848,0,-6300,1100,-6900,1950,-10150
2849,-5600,-2600,-1300,12800,-2150,1150
2850,0,3700,6700,-11300,-7300,-8200
2851,100,15800,-9900,7100,1950,15050
2852,100,-11200,2500,-600,0,-9200
2853,-5700,-6400,4800,11000,12000,15700
2854,5700,-3400,15000,-5800,0,11500
2855,-4700,7000,-5500,14200,0,11000
2856,10100,-1700,4900,-13000,0,300
2857,200,3100,1200,8000,0,12500
2858,-3800,-700,1100,8400,0,5000
2859,8300,1500,4600,-9600,0,4800
2860,-2700,15700,3900,-1000,0,15900
2861,-3500,-6500,1100,11200,-10200,-7900
2862,10200,7900,300,-3800,0,14600
2863,-2800,6600,200,-12000,0,-8000
2864,100,-2600,1100,7200,12000,17800
2865,-3700,-6300,2700,9400,-1200,900
2866,12200,-5900,-12700,7200,0,800
2867,-900,13600,2100,2400,-2150,15050
2868,-1700,-3400,11200,-3600,-1200,1300
2869,-3500,-700,-900,4300,1950,1150
2870,9400,19300,3900,-15800,-950,15850
2871,-3000,-9200,7600,7300,1950,4650
2872,-2800,4600,3900,-11000,-950,-6250
2873,-1800,6500,-2900,-2700,2900,2000
2874,-800,3700,4800,-3900,1950,5750
2875,1800,100,700,-1800,0,800
2876,12300,3400,-11200,15200,0,19700
2877,-8600,-3400,3000,2000,0,-7000
2878,-800,7400,11200,0,0,17800
2879,6400,6700,-12700,3200,-1200,2400
2880,-5800,-2800,2000,14000,0,7400
2881,4700,6800,16000,-15800,0,11700
2882,9200,-8300,3000,12000,0,15900
2883,-3900,-5600,1700,3200,0,-4600
2884,1000,-6200,100,10200,-1200,3900
2885,-6500,-3400,100,3000,0,-6800
2886,12000,10700,3900,4000,0,30600
2887,100,6900,-5400,-13000,-950,-12350
2888,-3000,-9000,900,13300,1950,4150
2889,-6200,-2800,2800,10000,-950,2850
2890,9000,2800,3600,-700,2900,17600
2891,-2900,-6300,1000,14000,0,5800
2892,8400,-5500,4800,-1000,0,6700
2893,-800,18300,-3000,400,0,14900
2894,-2000,3700,-7100,2400,-2400,-5400
2895,0,6600,200,10000,0,16800
2896,-3700,-800,900,400,-1200,-4400
2897,9200,6600,11100,200,-950,26150
2898,-4600,9200,2000,-2000,-950,3650
2899,2000,-2500,1100,3500,1700,5800
2900,-4500,-3500,-1300,-3500,1950,-10850
2901,13000,1600,6600,-1800,-950,18450
2902,-5600,-2800,1900,12200,-2150,3550
2903,-4800,9400,-22000,8300,2900,-6200
2904,7400,-2700,2000,9100,1950,17750
2905,0,200,9300,-2000,0,7500
2906,-6600,3600,-5200,14000,0,5800
2907,8100,-2800,13900,1000,0,20200
2908,1000,-800,0,8200,-1200,7200
2909,-3800,0,8700,5400,0,10300
2910,9200,200,1100,-4800,-950,4750
2911,100,9300,700,-4600,0,5500
2912,-3000,-5500,1100,100,1950,-5350
2913,-6500,300,200,-2800,-950,-9750
2914,12000,6800,-700,-18700,2900,2300
2915,-900,-11000,-900,15200,0,2400
2916,200,-8200,-1700,9000,0,-700
2917,1000,1200,-1800,-10600,-1200,-11400
2918,-2800,3600,5700,1000,0,7500
2919,-3700,-5300,200,-800,0,-9600
2920,9300,4000,-700,0,0,12600
2921,-3000,-3600,100,2000,0,-4500
2922,-3000,1800,4900,600,-2400,1900
2923,8500,6400,-200,-10800,0,3900
2924,-3000,-9200,7600,12400,-1200,6600
2925,-3900,7500,-2600,-10000,-950,-9950
2926,6400,900,-1400,9200,-950,14150
2927,100,3700,-8000,-3700,750,-7150
2928,-3700,-5500,1900,10100,1950,4750
2929,12200,-3500,10100,10400,-3350,25850
2930,0,-6300,-100,-2700,2900,-6200
2931,-5800,19300,14000,-11900,1000,16600
2932,-2600,3600,3500,200,0,4700
2933,11200,-6200,1100,7300,750,14150
2934,100,-3400,-2700,-1800,-2150,-9950
2935,200,13600,3800,-2700,1700,16600
2936,-5800,-3500,2900,2000,-950,-5350
2937,100,-3800,-1000,14200,-2150,7350
2938,-3000,19300,-800,-10900,1950,6550
2939,11200,-2600,-800,5100,1950,14850
2940,0,1000,1100,-5800,-1200,-4900
2941,-3000,6600,-10800,11100,1950,5850
2942,-700,-5300,-800,-6500,-200,-13500
2943,1000,-8200,9200,14200,0,16200
2944,0,3900,-700,-14900,1950,-9750
2945,-8300,-3600,6400,12200,-950,5750
2946,11300,1700,2000,-13900,2900,4000
2947,0,900,3000,1000,0,4900
2948,100,1100,-700,-11000,0,-10500
2949,0,-6300,4800,8400,-1200,5700
2950,-5700,1600,6600,-6800,-1200,-5500
2951,11300,3600,1900,1000,0,17800
2952,-3000,100,-900,3000,-950,-1750
2953,-900,6500,100,1000,-950,5750
2954,-1600,9200,-11000,-3700,1700,-5400
2955,0,-5300,200,9100,1950,5950
2956,100,6400,1000,-14800,-950,-8250
2957,100,-2600,12700,8600,-2150,16650
2958,0,3900,-700,-2900,2900,3200
2959,-5400,-5400,-2000,300,1950,-10550
2960,11300,-9000,-2100,10200,0,10400
2961,0,800,4600,-12600,0,-7200
2962,-3900,1800,3900,4000,0,5800
2963,1200,1000,-8900,-4000,0,-10700
2964,100,-6200,-1100,11200,0,4000
2965,-3000,-8200,600,12600,0,2000
2966,8400,8500,3000,7200,0,27100
2967,-2800,4500,2800,2200,0,6700
2968,200,-1800,15900,-12000,0,2300
2969,0,-6200,200,9200,-1200,2000
2970,100,-9100,2000,-800,-1200,-9000
2971,-2800,1700,6700,1000,0,6600
2972,11200,18400,-1100,-10800,-950,16750
2973,0,-8600,4700,14000,-950,9150
2974,300,9300,-13900,6100,2900,4700
2975,-2900,-6300,-200,300,1950,-7150
2976,-2800,6600,12200,1000,0,17000
2977,-3700,-2700,2000,-4000,0,-8400
2978,-2600,-9400,4800,13000,0,5800
2979,9200,21300,1000,-11800,-1200,18500
2980,-3700,-5500,-200,14200,0,4800
2981,8100,21200,-1800,-6800,-1200,19500
2982,1000,-6200,2900,8200,-2150,3750
2983,200,-8300,-1000,2200,-950,-7850
2984,-5800,6700,-700,1100,1950,3250
2985,-4500,18600,-10700,-3700,750,450
2986,9300,-8400,6400,10200,-950,16550
2987,-2700,-6300,1900,-1900,2900,-6100
2988,9000,3800,2200,9100,1950,26050
2989,0,6400,3800,-2000,0,8200
2990,-2900,-800,-1000,15000,0,10300
2991,0,6500,12100,-11800,-1200,5600
2992,100,12300,-1800,8200,0,18800
2993,-2700,-5600,200,12000,0,3900
2994,11300,-8300,-1700,2200,-2150,1350
2995,100,3800,-8000,8200,-950,3150
2996,0,-9400,4800,-4700,2900,-6400
2997,100,-8300,5800,3700,-450,850
2998,0,9300,11100,-11000,0,9400
2999,-2700,8700,-5300,13000,-950,12750
3000,-9400,-6400,7600,1200,-1200,-8200
3001,12100,19300,-9000,8300,750,31450
3002,-2900,-700,-3700,13000,-950,4750
3003,0,7800,10400,-15500,750,3450
3004,-4700,-5400,200,13000,-950,2150
3005,7400,-3000,-2700,-4700,1950,-1050
3006,-3900,1600,4500,2300,1950,6450
3007,6600,-3400,900,-1600,-2150,350
3008,-6500,3600,2900,100,1950,2050
3009,10300,-5500,100,-3900,2900,3900
3010,2100,4800,-700,-4800,0,1400
3011,-2800,9400,-3600,1400,-1200,3200
3012,-2600,-8100,5800,3400,-10200,-11700
3013,7300,-9100,3900,14000,-950,15150
3014,-2000,-6400,800,2400,-1200,-6400
3015,100,1800,2900,-3900,13950,14850
3016,0,12800,-5200,-3900,1950,5650
3017,-7300,-6400,3000,13200,-1200,1300
3018,13000,4600,11200,-2000,0,26800
3019,-5700,4000,-9300,1800,-2150,-11350
3020,11300,-8900,-700,10200,-950,10950
3021,-1800,-2400,8600,1500,-7300,-1400
3022,2100,700,6600,-5500,1950,5850
3023,-6700,8600,200,1000,12000,15100
3024,-2600,-2700,2100,6200,0,3000
3025,9100,12800,3800,3000,0,28700
3026,-6700,3800,3900,-10000,0,-9000
3027,200,-6200,1100,7200,-1200,1100
3028,6200,4600,2100,-5800,-1200,5900
3029,-3900,-9000,5800,10200,-950,2150
3030,12300,10200,-3700,-13800,-2150,2850
3031,-2900,-9100,1700,12300,2900,4900
3032,-6600,-3500,1100,5300,750,-2950
3033,11300,13700,-900,-9200,-950,13950
3034,1000,600,-8000,14000,-950,6650
3035,0,-11900,2100,-3700,1700,-11800
3036,-2800,-6200,15900,8100,1950,16950
3037,-2900,19300,-800,-8000,0,7600
3038,-3000,-6300,2900,13000,-950,5650
3039,11300,7200,1900,-13000,-950,6450
3040,-3000,9400,-1800,100,2900,7600
3041,-3000,-3600,100,100,1950,-4450
3042,-2800,7200,2800,0,0,7200
3043,-700,6700,-2700,1000,0,4300
3044,8400,-5700,-1100,3200,0,4800
3045,1200,-2000,1900,2000,0,3100
3046,100,6700,-15400,-2800,-1200,-12600
3047,-2900,-8200,600,15400,0,4900
3048,-5800,-3600,4800,-2800,0,-7400
3049,11200,-12000,17500,11200,0,27900
3050,-2800,19300,-9800,-1800,0,4900
3051,-3000,800,-5400,13200,0,5600
3052,8400,-3500,12500,-1600,0,15800
3053,0,4400,-2900,5400,-1200,5700
3054,0,-6400,13700,-1800,0,5500
3055,-2800,7500,-300,-400,-950,3050
3056,-3000,6500,200,-12800,0,-9100
3057,11200,-9200,3600,8300,1950,15850
3058,-3000,4500,5700,-9600,-2150,-4550
3059,-2900,-700,-1900,10100,2900,7500
3060,-2800,-700,-1100,19400,-10200,4600
3061,11200,19300,-800,-10000,0,19700
3062,-3000,-2700,4800,8400,12000,19500
3063,100,-2600,100,-3000,0,-5400
3064,-9500,9300,2000,3000,0,4800
3065,9200,-2700,-900,2000,0,7600
3066,-6400,-2700,3900,10000,0,4800
3067,8200,200,-2700,1000,0,6700
3068,-2000,-6300,2000,12000,0,5700
3069,-1600,-5600,2800,-5000,0,-9400
3070,10000,11200,-3000,17600,-2400,33400
3071,-3000,4400,4700,-8000,0,-1900
3072,0,200,-1800,9000,-950,6450
3073,-5800,9300,100,-5800,-2150,-4350
3074,8200,-2700,1000,-900,2900,8500
3075,0,200,-2700,7300,-200,4600
3076,-3000,-8200,3000,2200,-2150,-8150
3077,-700,-8300,2000,-6900,2900,-11000
3078,6200,9300,2900,-3300,-9450,5650
3079,-3000,-700,-900,2000,11050,8450
3080,11300,10200,-4600,200,-1200,15900
3081,-3800,-8400,4800,-1700,750,-8350
3082,-2000,200,-900,11200,-1900,6600
3083,0,-6400,2900,-3900,2900,-4500
3084,0,-2800,1000,7100,1950,7250
3085,-3000,11200,2800,-600,-2150,8250
3086,10300,100,-900,-3900,2900,8500
3087,-2000,0,0,12000,0,10000
3088,0,9100,-900,14000,-950,21250
3089,0,-2700,100,-1000,-950,-4550
3090,-3700,200,100,-3700,1700,-5400
3091,-2700,9500,-6400,-10700,750,-9550
3092,11100,-8100,900,-800,0,3100
3093,1000,-8200,4900,8200,-950,4950
3094,-2400,4000,-800,-13000,0,-12200
3095,100,-6000,-2600,7100,1950,550
3096,-3800,4500,1000,-8000,-950,-7250
3097,1000,3600,4800,-8700,2900,3600
3098,-4500,700,-8200,3200,0,-8800
3099,7200,-9200,4500,14200,0,16700
3100,0,7300,11200,-11800,-1200,5500
3101,-3700,3600,3800,2200,0,5900
3102,12000,-5300,1100,-2000,0,5800
3103,-3500,1000,3000,6400,-11400,-4500
3104,1100,-6400,-500,2800,-2400,-5400
3105,-2900,-8400,2700,13200,11050,15650
3106,0,15700,-7100,7200,-2150,13650
3107,100,3500,-13300,500,1950,-7250
3108,-6500,-3600,14900,11300,750,16850
3109,12200,7500,-1800,-16800,-950,150
3110,-1800,-6100,200,-3900,1950,-9650
3111,-1000,-1200,17800,-3900,1950,13650
3112,-6200,6600,-9200,-2800,-950,-12550
3113,12000,6400,0,-2500,1700,17600
3114,-900,-9400,14000,1500,-450,4750
3115,100,4700,2000,-2000,0,4800
3116,-4800,9300,-9900,1000,-950,-5350
3117,11200,-3300,200,8200,0,16300
3118,-3700,4400,16800,-16900,1950,2550
3119,-1900,100,-900,19500,-9450,7350
3120,-5700,6500,100,4200,-1200,3900
3121,8500,-2700,1900,-2000,11050,16750
3122,-3800,-2700,100,14000,-950,6650
3123,12200,3800,-2700,-13700,1700,1300
3124,0,-5200,-2500,9300,750,2350
3125,-3000,3700,2000,-8800,-2150,-8250
3126,-3800,-6200,2100,9200,0,1300
3127,-5300,4900,4000,-19700,1950,-14150
3128,12300,6500,-3300,400,-1900,14000
3129,100,-5200,-1700,-5900,2900,-9800
3130,-6600,3800,2100,2100,1950,3350
3131,3400,-3500,2700,2200,-950,3850
3132,11200,-1100,4900,-2900,2900,15000
3133,-8600,-700,2000,2000,0,-5300
3134,-800,4300,200,1200,0,4900
3135,11200,-9200,4700,-2000,0,4700
3136,-1800,-6600,2000,14000,0,7600
3137,-5700,9300,1600,14200,0,19400
3138,8500,-3300,-1700,-3000,0,500
3139,-5700,9600,-1900,15200,0,17200
3140,11200,-2200,-5200,2000,0,5800
3141,-2700,-2800,1000,12000,0,7500
3142,-3600,18500,14900,-15800,0,14000
3143,-2000,-6100,1100,14200,-1200,6000
3144,11300,10100,-1800,-14000,0,5600
3145,-3000,800,4800,4000,0,6600
3146,-2900,-2800,-1200,14400,-1200,6300
3147,100,3800,100,-11000,0,-7000
3148,-3600,-5600,900,2000,-950,-7250
3149,12000,-12000,3000,14000,0,17000
3150,200,-500,-2700,-8700,1950,-9750
3151,100,19500,-1700,-1600,-2150,14150
3152,-2900,3600,1000,100,2900,4700
3153,0,-3600,4800,3600,-10200,-5400
3154,-3000,1800,3600,2200,0,4600
3155,-3600,-6400,3900,-2000,12000,3900
3156,9300,10200,-1800,1000,0,18700
3157,-6600,-3400,-100,1200,0,-8900
3158,9300,-8200,1100,12000,0,14200
3159,-3600,9300,3800,-3600,-1200,4700
3160,-2700,6700,-13900,14200,0,4300
3161,6200,-5500,2100,-1000,-950,850
3162,-900,3800,13100,1000,0,17000
3163,-3400,-9300,1600,-1700,1950,-10850
3164,13000,4600,-1600,0,-950,15050
3165,-3900,1200,1200,2100,2900,3500
3166,-2000,-6300,3800,-800,0,-5300
3167,-9400,300,1200,10600,-2400,300
3168,12300,5800,-900,-4800,0,12400
3169,100,-9200,2900,10200,0,4000
3170,100,-5500,-1700,-2000,-950,-10050
3171,-3600,15900,3000,-2600,0,12700
3172,9000,-6200,3000,-3700,1950,4050
3173,-6400,7200,4800,-2700,750,3650
3174,10400,9900,-6100,-800,-1200,12200
3175,2100,9200,-8200,6200,0,9300
3176,0,200,-2700,-3000,-950,-6450
3177,-3700,6600,15000,-600,-1200,16100
3178,-2000,-2800,1900,11200,-950,7350
3179,0,-2700,13000,-6900,2900,6300
3180,-7500,-600,-13100,23700,750,3250
3181,13000,-2500,-800,-3000,0,6700
3182,100,6400,13900,-5000,0,15400
3183,-3000,-500,-4700,14600,-2150,4250
3184,-3000,1900,-6300,-600,-950,-8950
3185,-800,-8400,3900,6100,2900,3700
3186,12000,700,1900,-700,1950,15850
3187,-900,-6300,900,8600,0,2300
3188,1100,1700,3900,-2000,0,4700
3189,-3000,6400,2100,2000,0,7500
3190,0,-5400,3600,10600,-1200,7600
3191,-2800,-600,1100,-4600,-1200,-8100
3192,-700,-6300,12000,12200,-1200,16000
3193,-2700,16400,2900,-10000,-950,5650
3194,6200,6400,3800,3000,-950,18450
3195,0,9300,-2100,-1700,1000,6500
3196,-3800,200,-3600,-900,2900,-5200
3197,9300,-5400,1500,5700,1950,13050
3198,-2800,-2600,200,-1800,-2150,-9150
3199,-3800,6500,3900,-5500,2900,4000
3200,7200,0,1000,-1800,0,6400
3201,2100,-2500,-13200,18600,0,5000
3202,-3700,-3400,1100,-2000,0,-8000
3203,1000,-8300,15900,11000,0,19600
3204,-4600,-6300,2600,-1600,0,-9900
3205,13000,6500,1000,12200,-1200,31500
3206,-2800,6600,-3600,3200,-1200,2200
3207,300,5600,-100,-1000,-950,3850
3208,-6600,100,3900,9400,0,6800
3209,9100,3700,4800,-2900,1950,16650
3210,100,6400,-9200,-4600,-950,-8250
3211,0,6500,-8100,-2900,2900,-1600
3212,-900,100,8100,9200,0,16500
3213,1000,-2800,-6400,6600,-1200,-2800
3214,-7300,-2500,-800,1000,0,-9600
3215,10000,-8400,16800,-1000,-950,16450
3216,-2900,6500,-9000,0,0,-5400
3217,200,-600,9200,-5900,1950,4850
3218,-5600,10100,-2700,-8000,-950,-7150
3219,11000,-8100,2100,9300,1700,16000
3220,-2800,-800,14000,-5800,0,4600
3221,-3700,-5600,4400,12400,0,7500
3222,9000,9200,100,1200,-1200,18300
3223,-800,6500,-9300,-3800,0,-7400
3224,-4800,100,100,2000,-950,-3550
3225,8200,-2500,-1700,14000,0,18000
3226,0,-11700,16000,-4900,1950,1350
3227,-2800,7300,-1900,-8000,-950,-6350
3228,-2900,3700,100,-10700,1700,-8100
3229,-700,-3400,100,9200,0,5200
3230,9300,-5300,1100,8200,-1200,12100
3231,-5600,-6100,-7100,8200,0,-10600
3232,-6500,9200,4800,-800,-950,5750
3233,9000,3900,-10700,1000,0,3200
3234,11500,-8400,14800,-2000,-950,14950
3235,300,2700,-100,-2900,1950,1950
3236,-3000,6400,2100,-900,2900,7500
3237,-3000,-5500,3900,-800,0,-5400
3238,-3400,18500,2900,-1000,0,17000
3239,11200,-3500,11100,-1000,0,17800
3240,-4700,10300,-13600,13200,-1200,4000
3241,100,-5500,14900,-3000,0,6500
3242,-6700,-6300,3900,14000,0,4900
3243,12300,-700,0,-5800,0,5800
3244,-3000,19300,-11100,2200,0,7400
3245,-900,-8300,3900,0,0,-5300
3246,100,-2500,10300,-2000,0,5900
3247,9200,-6200,-100,200,0,3100
3248,0,-6400,-1700,2000,0,-6100
3249,100,16500,2000,-13800,0,4800
3250,200,3900,-800,-11000,0,-7700
3251,-5800,-6400,7600,9200,0,4600
3252,0,-5500,2000,-1000,0,-4500
3253,-3500,-3800,900,14000,0,7600
3254,5300,12100,100,1000,0,18500
3255,-3400,11300,0,11200,-1200,17900
3256,13000,-2600,-1700,-2800,-1200,4700
3257,0,-8600,5700,-1800,-950,-5650
3258,100,9000,0,1000,-950,9150
3259,-900,9300,-900,-2900,2900,7500
3260,100,-5300,200,-3700,750,-7950
3261,200,-2700,-1800,9000,0,4700
3262,-4800,6500,-8200,1200,0,-5300
3263,200,-3600,3800,-5800,-950,-6350
3264,0,7400,12100,0,-950,18550
3265,-3700,400,-16600,8300,2900,-8700
3266,9200,-8200,3100,8500,750,13350
3267,100,-6200,1100,-4600,-1200,-10800
3268,-2900,4400,14900,-9000,0,7400
3269,0,-6400,2000,-2000,0,-6400
3270,-3500,7500,2900,-1600,-2150,3150
3271,6200,9300,100,5000,-950,19650
3272,-2900,1000,2000,-1700,-7300,-8900
3273,11300,-2600,-1800,7100,1950,15950
3274,0,-9100,3000,-1000,0,-7100
3275,0,-5500,-9100,20200,12000,17600
3276,-3700,21300,1700,-13600,0,5700
3277,-2800,-6300,1900,12000,0,4800
3278,-4700,7300,12100,-9800,-1200,3700
3279,8500,-2400,-1700,11200,-1200,14400
3280,-2800,3700,-7000,-1000,-950,-8050
3281,11300,-6300,4800,8400,-1200,17000
3282,0,10100,10200,-15900,1950,6350
3283,-2800,-2800,2600,-1800,-1900,-6700
3284,-1800,-600,-3900,9300,2900,5900
3285,-4400,4700,-7200,-7700,1950,-12650
3286,-2600,100,-3900,12200,0,5800
3287,6400,-2800,17500,5500,1950,28550
3288,8200,6500,2900,-11800,0,5800
3289,100,-5400,-10100,19200,0,3800
3290,-7500,-2700,1100,3000,0,-6100
3291,10000,6400,-7100,10200,0,19500
3292,0,-2400,11200,-2000,0,6800
3293,0,-3500,-800,0,0,-4300
3294,-5700,-2700,14000,13000,0,18600
3295,-3500,200,100,-3800,0,-7000
3296,12000,3700,-1900,3200,0,17000
3297,0,-6300,3000,-3600,-1200,-8100
3298,-3600,7200,4700,-13800,0,-5500
3299,1000,6600,1000,1400,-2400,7600
3300,100,9300,-3700,-12000,0,-6300
3301,0,-5500,2000,11000,-950,6550
3302,0,-5500,4800,-3800,0,-4500
3303,0,-3600,1900,9300,750,8350
3304,0,10100,-2100,-12800,-950,-5750
3305,0,-2600,-4100,10500,1950,5750
3306,-7300,-5600,3000,2000,-950,-8850
3307,13000,1100,-8800,6100,2900,14300
3308,-3000,-9100,3900,-900,1950,-7150
3309,-900,4500,14900,12200,-10200,20500
3310,1100,6500,-10800,-3000,0,-6200
3311,0,-3300,-800,10200,10800,16900
3312,-3600,10100,11200,-10000,0,7700
3313,11200,-9400,6600,-2800,0,5600
3314,-800,0,0,9000,0,8200
3315,2000,21400,-3700,-12000,0,7700
3316,-800,-5600,1000,10200,-1200,3600
3317,1000,-5600,4700,-2800,-1200,-3900
3318,-900,9200,0,1000,-950,8350
3319,-2000,-2500,-1700,-1000,-950,-8150
3320,100,-5500,-9200,17300,2900,5600
3321,-5700,-3500,800,-1700,1950,-8150
3322,11200,1700,14700,-9800,0,17800
3323,0,-3500,100,-1000,0,-4400
3324,-3700,200,-800,9000,0,4700
3325,-2000,15800,2000,-12000,0,3800
3326,0,-2700,-1100,12400,-1200,7400
3327,100,-5600,2600,-3400,-1200,-7500
3328,-3000,6900,-5300,3200,-1200,600
3329,7500,-5600,5700,-2000,-950,4650
3330,-1800,800,-7000,10100,1950,4050
3331,-2700,-6100,-100,-800,-1900,-11600
3332,-3600,7300,14000,-3900,2900,16700
3333,5400,9200,-12000,300,1950,4850
3334,12000,-11100,3000,12000,0,15900
3335,0,-9100,15000,-4900,1950,2950
3336,-3000,7300,1900,3200,-1200,8200
3337,-2900,9300,-14600,1400,-2400,-9200
3338,200,-9100,5600,9400,-1200,4900
3339,-3700,7200,0,-9000,-950,-6450
3340,9300,4100,6700,-8800,-2150,9150
3341,-6400,300,-1900,7300,1950,1250
3342,6600,6400,3000,-14700,750,2050
3343,0,-11200,7600,10000,0,6400
3344,0,-2100,4800,300,-200,2800
3345,-3000,-2600,-800,-900,1950,-5350
3346,11200,3600,3800,-1000,0,17600
3347,-2800,-300,-6400,-900,1950,-8450
3348,-2900,-5500,1000,13000,-950,4650
3349,0,3600,2000,-15700,1700,-8400
3350,1700,5600,7600,14000,0,28900
3351,-2000,-700,-4000,15200,0,8500
3352,-700,13700,3900,-13000,-950,2950
3353,12000,-5500,-1700,15000,-950,18850
3354,-2800,6300,2000,-14700,2900,-6300
3355,-900,-6400,1700,9500,750,4650
3356,-5600,-2600,2000,-2800,0,-9000
3357,400,18800,-3600,-1000,0,14600
3358,12000,-8200,2100,-3000,0,2900
3359,-3000,-6100,-1000,13400,-1200,2100
3360,-2700,1800,-7500,400,0,-8000
3361,-2800,3800,2100,1000,-950,3150
3362,-3800,-6300,13100,14000,-950,16050
3363,12100,-5500,3800,-6700,2900,6600
3364,0,-9300,2000,10300,750,3750
3365,-3600,3400,2600,1200,0,3600
3366,1000,6400,-9900,11200,-1200,7500
3367,0,18900,-2600,-10000,0,6300
3368,-5800,-3300,2100,11200,-950,3250
3369,8400,-2500,11300,12000,0,29200
3370,100,2900,1700,-3700,1950,2950
3371,0,-8100,1200,-3000,-950,-10850
3372,0,-6200,-100,10500,1700,5900
3373,0,5700,900,-1600,0,5000
3374,-2800,4400,4500,-11800,0,-5700
3375,8400,15700,1500,2400,0,28000
3376,-6600,-600,-1700,1000,0,-7900
3377,12200,-4000,7100,-1600,0,13700
3378,100,-800,-3100,1200,0,-2600
3379,0,-3500,2000,9200,0,7700
3380,-900,19400,1100,-13800,0,5800
3381,1200,3700,2900,-1000,0,6800
3382,0,-500,-3600,-2000,0,-6100
3383,-9300,7200,1900,4000,0,3800
3384,300,-8200,3000,9000,0,4100
3385,12000,-6100,200,-1000,0,5100
3386,-5700,7500,-800,5000,0,6000
3387,-3000,-6200,200,1000,0,-8000
3388,-800,-9200,4500,10200,0,4700
3389,12000,4300,-800,-6800,-1200,7500
3390,-3000,13000,3900,2200,-1200,14900
3391,0,-2600,-1700,-1600,-2400,-8300
3392,-3000,1000,-7900,16200,-2150,4150
3393,-2800,3900,2100,-12000,-950,-9750
3394,8200,-5400,14900,12100,1950,31750
3395,-6700,-3600,1700,-700,1950,-7350
3396,12400,-500,-7500,11000,-950,14450
3397,-2900,13600,3800,-11900,1950,4550
3398,0,1100,900,-11500,750,-8750
3399,-3700,-700,-2600,12000,-950,4050
3400,-8200,7400,6700,-15700,2900,-6900
3401,12000,6700,1100,-4700,1950,17050
3402,0,-5600,3900,9200,0,7500
3403,-6400,-3400,3900,-1000,0,-6900
3404,11300,200,-3700,10000,0,17800
3405,1000,-2800,-2000,200,0,-3600
3406,-2700,5700,6600,9200,0,18800
3407,-3600,-5500,2900,0,0,-6200
3408,11300,-3300,-3500,10000,0,14500
3409,400,3700,5700,-5000,0,4800
3410,-4500,-3700,-900,12000,0,2900
3411,0,6800,-700,0,0,6100
3412,-3700,1200,3100,-12000,0,-11400
3413,9500,-800,1000,-3000,0,6700
3414,-9500,9200,4800,14000,0,18500
3415,11500,-3300,-7300,9000,0,9900
3416,100,16400,4500,-12600,0,8400
3417,-5500,-2700,-1000,-800,0,-10000
3418,12100,3900,2100,-3800,0,14300
3419,-3000,-8900,3100,-1800,0,-10600
3420,-3000,4400,2600,4400,-1200,7200
3421,0,-3600,1000,-3000,0,-5600
3422,-3800,-2200,-2500,22400,-11150,2750
3423,9100,2800,3800,2000,12000,29700
3424,-8500,-2700,1700,-1700,1950,-9250
3425,8400,21400,-800,-10000,0,19000
3426,-3000,-8000,1200,-900,1950,-8750
3427,11200,-8900,300,10000,0,12600
3428,-2900,-9000,2000,2000,0,-7900
3429,-2900,13800,2000,-10000,0,2900
3430,0,-6200,-1900,10400,-1200,1100
3431,-3700,1500,6700,2800,-3600,3700
3432,5500,-6200,2100,1000,0,2400
3433,-2400,-3500,2600,5400,-950,1150
3434,9000,22200,-2700,-8000,-950,19550
3435,-5800,3600,4800,-10900,1950,-6350
3436,8400,9400,-10800,7100,1950,16050
3437,-6600,-2700,2900,13000,-950,5650
3438,6300,-3600,13900,-700,1700,17600
3439,0,400,-4500,7100,1950,4950
3440,-6600,9300,2000,3000,0,7700
3441,9200,-3600,1900,-2800,0,4700
3442,0,-1100,2100,-9000,0,-8000
3443,-2800,-5400,3000,12000,0,6800
3444,8200,3700,2000,-8000,0,5900
3445,-800,9600,-14500,9000,0,3300
3446,-2000,-5500,1100,1000,0,-5400
3447,-6600,3700,2900,3000,0,3000
3448,4800,-3400,15000,-800,-1200,14400
3449,-1500,7500,-800,-2800,-1200,1200
3450,9200,-5900,300,-1000,-950,1650
3451,-900,4600,200,1000,-950,3950
3452,-4800,-6200,3000,-2900,2900,-8000
3453,8400,4500,3900,-1700,750,15850
3454,-3500,900,200,-8000,0,-10400
3455,6300,-6300,3900,12000,0,15900
3456,200,-2700,0,10200,-2150,5550
3457,-3800,15800,-100,-7800,-950,3150
3458,9300,200,-2900,6700,1700,15000
3459,-2800,3800,-7000,-5900,1950,-9950
3460,-5600,-5600,2000,15200,-2150,3850
3461,11000,1300,13200,1000,0,26500
3462,0,3700,-19100,5300,1950,-8150
3463,-2900,-2700,1900,10400,-2150,4550
3464,-3000,900,13800,-10700,2900,3900
3465,8400,6800,1300,-1000,0,15500
3466,-6600,-6300,3900,13000,-950,3050
3467,12100,4500,2900,-14000,-950,4550
3468,-2800,-3400,13100,6100,2900,15900
3469,-500,-5700,-2900,10100,1950,2950
3470,-4800,11400,-2000,200,0,4800
3471,5600,-2600,3000,-800,-1200,4000
3472,-2600,-5800,2600,-1600,0,-7400
3473,-1700,9200,-800,10000,0,16700
3474,13000,-2000,4800,-8000,0,7800
3475,0,-6300,1100,-4000,0,-9200
3476,-5500,9600,-3800,2400,-1200,1500
3477,-3800,4500,3900,-9800,0,-5200
3478,12000,3800,-7300,6400,-950,13950
3479,0,100,-2700,-3000,-950,-6550
3480,-2800,3700,3800,-2700,2900,4900
3481,-2700,-8600,16800,-1900,1950,5550
3482,0,-800,-1200,8200,0,6200
3483,-7400,10000,1000,3200,-1200,5600
3484,13200,-5600,-3100,2600,-2400,4700
3485,0,-3600,2000,8400,-1200,5600
3486,0,4500,2000,-10000,-950,-4450
3487,-2700,-3000,-2600,10000,-950,750
3488,100,7700,-3500,-16900,1950,-10650
3489,-4600,-8200,1100,10100,1950,350
3490,7200,6500,-10300,2400,-950,4850
3491,-3600,-6200,1100,7100,2900,1300
3492,9500,7500,9400,-14900,1950,13450
3493,-5800,3600,3900,3000,0,4700
3494,11200,-8400,7600,-3600,-1200,5600
3495,-5500,9500,-11700,12000,0,4300
3496,100,-4800,-3300,10200,0,2200
3497,5600,-2800,16800,-4000,0,15600
3498,0,3700,1100,3400,-1200,7000
3499,-3000,9200,-10900,2200,-1200,-3700
3500,100,-8400,15800,9000,-950,15550
3501,-3700,-600,-1800,-2600,-1200,-9900
3502,6200,10100,11600,900,750,29550
3503,-5800,-2700,-100,200,-1900,-10300
3504,11200,-8900,1800,8300,2900,15300
3505,-2800,4500,1800,-13700,1950,-8250
3506,-3000,3800,-7000,10200,-950,3050
3507,8500,3600,-7300,-6700,2900,1000
3508,-7400,-2500,13100,12000,0,15200
3509,3500,9200,1700,3200,0,17600
3510,12200,-2500,-4500,-2000,0,3200
3511,-5700,-2600,12100,13200,-1200,15800
3512,-6600,-3600,5700,-800,0,-5300
3513,12000,-5600,3800,11200,-2150,19250
3514,-3000,300,-3600,3000,0,-3300
3515,200,12600,900,-900,1950,14750
3516,-900,-8300,1800,-3700,1950,-9150
3517,-3700,800,5700,3000,0,5800
3518,13100,-500,-3700,9000,0,17900
3519,-2800,-2700,2000,-2000,0,-5500
3520,-2700,6600,-1000,-9800,0,-6900
3521,-1800,9200,2900,6200,0,16500
3522,2000,-5200,-2200,-3600,0,-9000
3523,-3000,-3600,-200,15200,0,8400
3524,11200,-2700,-1700,-2000,0,4800
3525,0,700,5800,-600,0,5900
3526,-5800,9500,2000,0,0,5700
3527,-2800,9300,-1700,0,0,4800
3528,8200,-5400,3900,200,0,6900
3529,0,-3200,-2500,7200,0,1500
3530,0,1700,5700,-12800,-1200,-6600
3531,-5600,-3500,3900,10000,0,4800
3532,8200,0,0,3200,-1200,10200
3533,0,21200,0,0,-950,20250
3534,-3000,200,-1800,3000,-950,-2550
3535,200,-5500,-900,8100,2900,4800
3536,-2700,-5500,2900,7100,1950,3750
3537,5500,-3200,-1700,2000,0,2600
3538,-3000,10100,-800,-11800,0,-5500
3539,-800,-8100,1200,10000,0,2300
3540,6200,-6300,4800,15200,-1200,18700
3541,200,1800,1000,-11000,0,-8000
3542,-2800,6700,-8800,9200,-950,3350
3543,7300,-8900,1200,2000,0,1600
3544,1000,1700,15900,-3900,1950,16650
3545,-5800,6500,2900,-6800,-2150,-5350
3546,11200,-3400,-2600,7100,2900,15200
3547,0,-5500,4500,-3600,0,-4600
3548,100,-3600,1000,8200,-1200,4500
3549,0,5400,-500,2400,0,7300
3550,-3900,7200,1000,5400,-2400,7300
3551,1000,8500,1000,-2000,-950,7550
3552,100,0,0,11200,-2150,9150
3553,-3000,12100,-1800,-900,1950,8350
3554,200,-5400,-200,-4700,1950,-8150
3555,0,-3200,-2600,-1000,-950,-7750
3556,0,1500,-1000,-12700,2900,-9300
3557,-4500,-6300,4800,-2700,750,-7950
3558,7200,7200,100,3000,0,17500
3559,100,-9100,6400,-4600,-950,-8150
3560,0,-6300,-1000,12400,0,5100
3561,-3000,-2700,-800,9100,1950,4550
3562,11400,13000,2000,-11800,-2150,12450
3563,-800,-5500,1000,7300,1700,3700
3564,1000,13000,2100,-10800,-1200,4100
3565,-3000,3600,5700,200,-950,5550
3566,0,300,-2700,-2000,0,-4400
3567,-3000,6400,-200,300,1950,5450
3568,0,-6000,-2800,-1800,-950,-11550
3569,-7500,-6300,4800,11100,2900,5000
3570,12100,13400,2000,-7600,-2400,17500
3571,1000,-5600,2800,9000,0,7200
3572,-800,-3700,-1900,15200,-2150,6650
3573,-1600,6300,-12700,-1000,-950,-9950
3574,-2700,6600,4800,7100,1950,17750
3575,8200,3900,11300,-11900,1950,13450
3576,-2600,-2600,100,10000,-950,3950
3577,0,800,-8900,-1900,2900,-7100
3578,-2800,-6200,600,8500,1950,2050
3579,11400,4500,11100,-12000,0,15000
3580,-3900,1100,-9900,14200,0,1500
3581,-1800,-9300,4800,-1000,0,-7300
3582,0,1800,13800,2200,0,17800
3583,100,3700,1000,-10000,0,-5200
3584,-3600,-6300,3900,9000,0,3000
3585,9300,7400,2000,-1800,0,16900
3586,-3800,6600,-12700,1200,-1200,-9900
3587,-2800,-6200,200,10400,-1200,400
3588,-2600,4400,16700,-10000,0,8500
3589,6300,3700,4800,2200,-2150,14850
3590,11200,9300,-10900,-800,-2150,6650
3591,-3000,-2700,-800,12100,2900,8500
3592,0,3500,11800,300,1000,16600
3593,-2600,-2700,900,-800,-1200,-6400
3594,0,-3500,-800,9100,1950,6750
3595,100,-5500,3800,-2800,-950,-5350
3596,0,6600,-1900,8300,2900,15900
3597,-3600,3900,2100,400,-11400,-8600
3598,12000,-6200,800,12200,0,18800
3599,-5600,10000,2000,-11000,11050,6450
3600,0,1100,1800,2200,0,5100
3601,100,-600,-5500,9100,1950,5050
3602,-6400,10000,4800,-14800,0,-6400
3603,12000,-8300,3600,9300,1950,18550
3604,-3000,-6300,-7300,11200,0,-5400
3605,-5600,10000,2900,2200,-1200,8300
3606,8400,9400,-2800,-8000,0,7000
3607,100,-2600,7800,11400,0,16700
3608,-4500,-5500,2700,1400,-1200,-7100
3609,10200,-2800,2900,9200,-1200,18300
3610,-2800,9300,-4100,-7200,-2400,-7200
3611,0,-5500,2000,-2000,-950,-6450
3612,100,-9100,1500,10600,-950,2150
3613,-5800,4700,-5100,-3700,1950,-7950
3614,11200,3700,2000,-12000,-950,3950
3615,-800,-3500,10200,8100,2900,16900
3616,-1800,7300,4800,-19700,1950,-7450
3617,0,-3500,100,12000,-950,7650
3618,-3600,-2700,-7300,5300,2900,-5400
3619,11100,-5400,-100,12200,0,17800
3620,-1800,12400,-2600,-3000,0,5000
3621,-3000,-9000,13200,14000,0,15200
3622,-3000,-3600,2900,-600,-1200,-5500
3623,11300,16700,-10200,-1800,0,16000
3624,200,6500,-6100,-11600,-950,-11950
3625,100,-8400,11600,-400,-950,1950
3626,0,-3600,2000,5300,2900,6600
3627,-8600,4500,-2300,-4700,1950,-9150
3628,-800,3700,1100,1200,-1200,4000
3629,9100,-2300,13200,-6600,0,13400
3630,100,3700,1000,0,0,4800
3631,-3900,-8400,4800,3200,-1200,-5500
3632,-4700,3600,3800,2000,0,4700
3633,11300,9300,-1900,-12000,-950,5750
3634,-2800,-3600,2900,11000,0,7500
3635,100,7100,-900,-12700,750,-5650
3636,100,200,-4600,11000,-950,5750
3637,-3800,-8300,4800,-900,2900,-5300
3638,12100,-6400,2000,8000,0,15700
3639,0,-2700,1900,11200,-1200,9200
3640,-2900,9400,-11800,2200,-1200,-4300
3641,-3000,6400,2900,12000,-950,17350
3642,100,100,11100,-3000,0,8300
3643,-2700,3600,1100,3200,-2150,3050
3644,8300,-2500,-2700,-900,1950,4150
3645,-2800,6600,200,-2900,1950,3050
3646,100,-5300,-700,-2000,-950,-8850
3647,-4600,-8900,1100,11100,2900,1600
3648,10000,1600,4500,-11700,1950,6350
3649,-2700,6400,1000,1000,0,5700
3650,-3600,-3400,3000,-3800,0,-7800
3651,9000,4500,2900,3000,0,19400
3652,0,6400,100,-11800,-1200,-6500
3653,-3000,0,1600,11400,0,10000
3654,-2900,9300,-2800,3000,0,6600
3655,10300,-5500,2900,-600,-2400,4700
3656,-2000,0,-1800,12000,0,8200
3657,-5700,-2700,1900,0,-950,-7450
3658,-3600,-3300,-1900,11400,-1200,1400
3659,7200,1800,5800,-13700,1950,3050
3660,1200,-2800,-5600,13200,-2150,3850
3661,-3500,3800,2700,-14700,1950,-9750
3662,4400,-800,4800,8200,-950,15650
3663,-700,1500,-800,-10900,2900,-8000
3664,12000,-5500,3800,6100,1950,18350
3665,-2800,-6400,-200,13200,0,3800
3666,-6000,-3600,-2900,0,0,-12500
3667,12100,16700,-1000,11400,-10200,29000
3668,-6500,-3800,3900,-800,0,-7200
3669,-2800,-3600,3600,7600,12000,16800
3670,9200,22100,2900,-15800,0,18400
3671,100,-8400,-1100,14400,-1200,3800
3672,-3000,-5600,2900,2000,0,-3700
3673,-3000,3900,200,2200,-2150,1150
3674,11200,-3500,-1100,200,0,6800
3675,-3800,-6200,200,10100,1950,2250
3676,-3600,4900,-700,-13000,-950,-13350
3677,-4600,8400,2900,9100,2900,18700
3678,9100,4500,2700,1400,0,17700
3679,0,-8100,2100,-3000,0,-9000
3680,-9400,9500,-700,5000,0,4400
3681,6500,-9200,4800,1000,0,3100
3682,13100,7500,-1700,-1000,0,17900
3683,-1700,3700,3900,-13000,0,-7100
3684,-2900,-700,-1800,11400,-1200,4800
3685,-2900,7400,2000,-13600,-1200,-8300
3686,-4400,-2400,-2900,12200,0,2500
3687,13000,-6400,2900,9000,-950,17550
3688,-2700,7400,-800,-13000,0,-9100
3689,-6600,6500,-6100,9500,750,4050
3690,12000,-8400,-100,1200,-950,3750
3691,-5800,-6300,1800,9300,2900,1900
3692,-800,2000,13200,-9800,-2150,2450
3693,5500,-600,200,8100,1950,15150
3694,1000,-6400,4500,-6600,-950,-8450
3695,-2800,19600,-2200,-500,2900,17000
3696,-3700,-6300,200,1000,0,-8800
3697,8400,1500,2900,3000,0,15800
3698,1000,-8100,300,-2000,0,-8800
3699,0,-2200,5700,5000,0,8500
3700,-2700,-500,100,-4800,0,-7900
3701,-800,4300,100,4000,0,7600
3702,9000,1000,-6300,400,0,4100
3703,-800,-3100,-6300,10200,-1200,-1200
3704,-2900,-11100,18700,200,-1200,3700
3705,-8400,9300,2000,2200,-2150,2950
3706,12000,5800,200,-2800,-1200,14000
3707,-2800,4500,-600,-1300,1950,1750
3708,7400,1100,2100,-10800,-1900,-2100
3709,-2900,-9200,3600,11300,2900,5700
3710,-1800,4600,3900,-15900,1950,-7250
3711,5400,6400,-8300,14400,-2150,15750
3712,0,-700,-1800,8100,2900,8500
3713,-6600,7200,15800,-7800,-1200,7400
3714,9100,9500,-4600,2000,-950,15050
3715,100,3700,-200,-10800,-950,-8150
3716,-3600,-5500,0,12100,2900,5900
3717,12200,3700,-10000,-4900,1950,2950
3718,0,-5400,1100,12000,0,7700
3719,-3800,3700,-10800,23200,-10200,2100
3720,200,-14900,17700,1000,0,4000
3721,1100,-5400,100,8200,0,4000
3722,100,800,7500,-2600,12000,17800
3723,-2700,8600,-800,12200,-1200,16100
3724,0,4800,12200,-13000,0,4000
3725,-2800,3600,3900,1200,-1200,4700
3726,8500,9500,200,-13800,-950,3450
3727,-2800,-6500,2000,11000,-950,2750
3728,-3500,7400,-200,-1300,500,2900
3729,9000,9200,-12900,-1700,1950,5550
3730,-6400,-2800,5400,8400,-950,3650
3731,200,-2700,10200,-3800,-2150,1750
3732,12000,-6300,4500,7500,2900,20600
3733,-2900,7200,-200,-11600,-950,-8450
3734,0,-5600,3800,16300,-8250,6250
3735,100,-3700,-1800,2000,-950,-4350
3736,-3800,7300,2900,-3700,1950,4650
3737,1000,9500,-4600,-14900,14900,5900
3738,-800,-5500,800,9400,0,3900
3739,-2000,-8300,2600,13200,0,5500
3740,10400,3700,100,-11000,0,3200
3741,-1900,900,-8000,12200,-1200,2000
3742,-2800,-5400,3000,-1000,0,-6200
3743,100,-6400,13600,12200,0,19500
3744,-2900,9200,-2800,-11000,0,-7500
3745,11300,6500,3800,6200,0,27800
3746,-3900,3900,200,-7000,0,-6800
3747,1000,-3400,-3600,11000,0,5000
3748,100,2000,200,-11000,0,-8700
3749,-900,900,-7000,11000,0,4000
3750,1100,-8500,2000,13000,0,7600
3751,0,800,19300,-13600,0,6500
3752,0,3800,200,1000,0,5000
3753,0,-2600,-2000,-800,0,-5400
3754,0,-3400,3900,5400,0,5900
3755,100,3900,-10700,-1000,0,-7700
3756,-3600,8500,2700,4400,0,12000
3757,100,-2500,-3500,200,-1200,-6900
3758,1000,6400,14600,-4600,0,17400
3759,0,3700,2700,13200,-950,18650
3760,-5800,-6300,4800,2000,0,-5300
3761,-1700,10300,-3600,-3900,1950,3050
3762,7200,6400,-8300,2200,-950,6550
3763,10400,-2700,1900,5300,2900,17800
3764,-800,-3500,11200,-3000,0,3900
3765,2000,1400,3800,2000,0,9200
3766,0,-3500,1000,-1000,0,-3500
3767,-2900,200,-2700,13000,0,7600
3768,-2900,-5300,-2600,2000,0,-8800
3769,-3400,15600,-5400,11000,0,17800
3770,6300,-2700,1100,2000,0,6700
3771,-3000,6800,-1700,3000,0,5100
3772,7600,-2500,9400,11200,-1200,24500
3773,1000,-5600,7600,-6600,0,-3600
3774,-2900,1000,1100,2000,0,1200
3775,100,4100,-12500,-1000,0,-9300
3776,-5600,-2400,2000,7400,0,1400
3777,11200,-9200,14700,-2600,-1200,12900
3778,-2700,3700,-12900,16400,-1200,3300
3779,-6600,9400,1100,-1000,-950,1950
3780,12000,-6300,1800,9600,-1200,15900
3781,-2500,-9100,14500,-1800,-950,150
3782,-3600,16400,3900,-13900,1950,4750
3783,12100,3700,1000,-13900,1950,4850
3784,-3000,-6300,200,13000,-950,2950
3785,-2900,3800,2900,-14500,1700,-9000
3786,-6300,-2600,2000,8300,750,2150
3787,9000,-3500,1100,200,0,6800
3788,-3500,16400,-800,4000,-950,15150
3789,11200,-8400,4700,10000,0,17500
3790,-1800,3700,2700,-12700,1950,-6150
3791,100,3800,2000,-2900,1950,4950
3792,-800,-3500,-800,-600,-2400,-8100
3793,1200,7400,-900,-15800,0,-8100
3794,200,3600,4500,-1600,0,6700
3795,-2900,-5400,1100,-1000,-950,-9150
3796,0,-3300,-2600,9000,-950,2150
3797,-3700,-3500,1100,8500,1700,4100
3798,6200,19200,3800,-9700,750,20250
3799,0,100,1000,6200,0,7300
3800,-6600,-2700,2900,2000,-950,-5350
3801,9200,0,-200,10200,0,19200
3802,-3800,6800,-2600,-8700,750,-7550
3803,12000,-8500,2000,13000,-950,17550
3804,-3600,100,100,-5900,2900,-6400
3805,1000,3600,-8900,10200,0,5900
3806,-3000,-2600,100,13000,0,7500
3807,0,6500,11900,-13600,0,4800
3808,-6600,0,2000,12600,-2400,5600
3809,12000,100,4700,-7400,-1200,8200
3810,0,0,0,11000,-950,10050
3811,-2900,300,-13900,11200,0,-5300
3812,0,-2700,-800,8100,1000,5600
3813,-3800,-5600,2000,3000,-950,-5350
3814,12100,700,6700,8300,2900,30700
3815,-2800,-600,-800,-5900,1950,-8150
3816,100,-2400,8400,12000,-950,17150
3817,0,3800,-10300,-6300,2900,-9900
3818,-3700,9300,-7200,18400,0,16800
3819,-5200,-700,-1400,-2400,0,-9700
3820,12000,1600,15900,-12000,0,17500
3821,100,-8100,800,13200,0,6000
3822,-2700,3600,15900,-13000,0,3800
3823,-3600,-6300,2400,12400,0,4900
3824,6200,7300,3900,-10800,0,6600
3825,0,6400,-200,200,0,6400
3826,100,-5800,1900,0,0,-3800
3827,-800,6400,-3900,3200,0,4900
3828,-2600,-5600,4800,11200,-1200,6600
3829,6200,-300,-3800,1200,0,3300
3830,-900,-2800,1000,11000,0,8300
3831,-4800,9500,-700,1000,0,5000
3832,-3600,3700,1800,-10800,0,-8900
3833,8300,-5300,2100,-1800,0,3300
3834,9200,6400,2000,-11000,0,6600
3835,-5800,0,5400,7600,0,7200
3836,-4700,9300,-1800,13200,-10200,5800
3837,13000,-2300,-2800,-4600,0,3300
3838,100,-5400,-100,12200,12000,18800
3839,-2900,-8200,2000,0,0,-9100
3840,0,3900,-1600,-11000,0,-8700
3841,-3800,-3500,2000,10200,0,4900
3842,6300,-5400,4900,-1000,-4800,0
3843,0,1000,1800,1200,0,4000
3844,-3600,4900,-1200,3200,-950,2350
3845,6200,-1800,-700,14000,0,17700
3846,100,15900,1800,-18300,1950,1450
3847,0,6500,-8900,8200,-1900,3900
3848,200,-8200,-100,6300,2900,1100
3849,100,-9000,2000,-3900,1950,-8850
3850,100,4400,14900,1200,-2150,18450
3851,-2700,-9200,6600,-3900,2900,-6300
3852,-3700,-3600,2800,11200,-950,5750
3853,12100,16300,-900,-11000,0,16500
3854,0,-3600,-200,9300,1950,7450
3855,-3000,3600,-6200,3000,-950,-3550
3856,-3000,21200,-10000,9100,2900,20200
3857,-800,0,12000,-1000,0,10200
3858,12100,-3000,-1000,15200,-1200,22100
3859,100,-2700,-3000,-1800,0,-7400
3860,-8500,-2800,15500,4200,0,8400
3861,8400,-3500,1100,-1000,0,5000
3862,100,-5600,2800,-1000,0,-3700
3863,0,18800,-12600,-1000,0,5200
3864,-2800,-5200,1200,200,-1200,-7800
3865,100,-3400,-1800,-2000,0,-7100
3866,0,-5500,13100,-2000,-950,4650
3867,0,1200,-7900,-2000,0,-8700
3868,-3600,12000,-1800,-5700,1950,2850
3869,11100,-1900,8700,1200,-2150,16950
3870,-7600,-700,1100,-2700,1700,-8200
3871,5400,10100,14000,-1600,-10200,17700
3872,0,-2800,2800,-2000,0,-2000
3873,0,-3600,-1800,14400,8650,17650
3874,0,4500,800,-1700,1950,5550
3875,-3800,-5500,2000,3000,-950,-5250
3876,8400,6400,1900,-3900,1950,14750
3877,1000,0,-2100,400,-2150,-2850
3878,-2900,3800,-9000,11100,2900,5900
3879,100,200,-4800,-3700,1950,-6250
3880,0,-8300,16800,12000,0,20500
3881,-3400,-6200,2000,-1000,0,-8600
3882,12000,7500,-3500,-11800,-1200,3000
3883,0,900,600,2400,0,3900
3884,-9500,6500,-5200,2000,0,-6200
3885,-400,-2700,-3000,8200,-950,1150
3886,13000,3600,12800,-13400,-950,15050
3887,-2700,-3500,4800,-10500,2900,-9000
3888,-6600,7500,-700,1300,750,2250
3889,6200,-2700,3000,9200,0,15700
3890,-900,-6400,3800,-1000,0,-4500
3891,100,10200,2000,-6600,0,5700
3892,-1800,300,1100,-5800,0,-6200
3893,10300,-5600,1100,11400,-1200,16000
3894,-2000,6600,-11700,1000,0,-6100
3895,-3500,0,1800,7200,0,5500
3896,-2800,-5400,11900,2200,-950,4950
3897,9100,-6400,100,22200,-10200,14800
3898,0,1600,5400,-14700,1950,-5750
3899,-2900,9600,-17600,12300,1950,3350
3900,0,-9100,4800,-1000,12000,6700
3901,0,4600,12200,-1000,0,15800
3902,-3700,-6200,1000,12200,-10200,-6900
3903,12100,-1400,2900,4000,0,17600
3904,0,3700,3900,-14800,12000,4800
3905,200,-6200,-3000,13400,-1200,3200
3906,100,4600,1000,-10000,0,-4300
3907,0,6700,-4400,2000,0,4300
3908,100,-11700,7700,-5800,0,-9700
3909,100,-5400,100,10200,-1200,3800
3910,-2800,6500,1100,2000,0,6800
3911,100,2900,3900,-2000,0,4900
3912,-3600,4700,-100,2200,-950,2250
3913,-6300,-3400,-1800,1000,-950,-11450
3914,10200,-3500,3600,3500,2900,16700
3915,-800,19400,-8200,-10900,1950,1450
3916,-3400,700,-4300,10200,0,3200
3917,10200,-8900,3100,-5000,0,-600
3918,0,-5600,12800,13200,0,20400
3919,-3800,7300,6700,-9000,0,1200
3920,1100,-6200,-1100,10200,0,4000
3921,-6500,1800,3100,-8000,0,-9600
3922,11300,800,4700,0,0,16800
3923,-1800,-6100,2100,-4000,0,-9800
3924,-4400,10000,-10100,11400,-1200,5700
3925,13200,3800,-9300,-3600,-1200,2900
3926,0,-3200,8200,10200,0,15200
3927,-5800,7400,200,-7000,-950,-6150
3928,100,-9000,3000,7200,0,1300
3929,100,4600,11200,-14700,750,1950
3930,-3800,-8900,2100,13200,-2150,450
3931,9200,-6100,1200,8300,1700,14300
3932,-5800,16600,3000,-9000,0,4800
3933,-3400,700,800,3200,-950,350
3934,12100,-9100,5700,-4800,-950,2950
3935,-2900,7400,-2600,-900,2900,3900
3936,-3000,3800,5800,-16500,1950,-7950
3937,11200,-9000,2100,9000,0,13300
3938,-3000,1800,2700,2400,-10200,-6300
3939,-5700,6400,1000,4000,0,5700
3940,-3600,-3500,2900,-1000,0,-5200
3941,9200,7000,100,4000,12000,32300
3942,-700,6500,-9100,-2000,0,-5300
3943,-1600,200,-3900,9200,0,3900
3944,8200,-3500,14000,-1800,0,16900
3945,-2900,-9200,4500,12200,0,4600
3946,0,19200,-200,-10800,0,8200
3947,-6600,9300,100,4200,-1200,5800
3948,12000,-9300,2900,14200,-1200,18600
3949,-1800,4600,-2600,-8000,0,-7800
3950,2000,3900,-800,-12800,-2150,-9850
3951,-6500,-700,-2700,12100,1950,4150
3952,9000,1800,4600,1400,-950,15850
3953,-2700,6400,-6200,-8700,1950,-9250
3954,-3800,-8100,1200,14000,-950,2350
3955,11100,800,16800,-12700,1700,17700
3956,-1800,-600,-800,5100,1950,3850
3957,0,-8400,2000,2000,0,-4400
3958,200,3400,-2200,5200,0,6600
3959,0,8400,-800,-3000,0,4600
3960,-3900,-2800,5600,11200,0,10100
3961,1000,9200,0,-14000,0,-3800
3962,0,21300,-13000,12200,0,20500
3963,100,300,-2700,-3800,0,-6100
3964,-6400,0,3800,8400,0,5800
3965,6400,-2700,11100,13000,0,27800
3966,10400,-8400,7600,-5800,0,3800
3967,-2000,0,-1900,25200,-10200,11100
3968,-5600,6800,-1700,-9600,-2400,-12500
3969,-700,-5500,100,12000,12000,17900
3970,3400,-6300,6700,2000,-950,4850
3971,11300,7100,-3700,2000,0,16700
3972,200,6600,-1200,-15500,1950,-7950
3973,-2800,-2700,3900,8400,-2150,4650
3974,-3000,-6100,200,10100,2900,4100
3975,-900,-5600,2900,0,-950,-4550
3976,1100,2900,3900,7000,0,14900
3977,-2800,7300,2000,-12500,-450,-6450
3978,11200,6300,-2100,4200,-950,18650
3979,0,-6300,-100,-4700,1950,-9150
3980,0,-8500,2900,15000,0,9400
3981,-5800,9200,100,-11900,1950,-6450
3982,0,9500,100,11000,-950,19650
3983,-3600,-6500,1100,-1900,2900,-8000
3984,12100,-5400,100,22600,-12600,16800
3985,-5600,-600,1100,12200,-1200,5900
3986,-3800,16400,3800,-8000,11050,19450
3987,12200,100,-1900,-4000,0,6400
3988,-3000,9200,-2700,3300,750,7550
3989,0,-2700,3800,-4800,-950,-4650
3990,0,-2700,1700,5500,1950,6450
3991,-900,-5600,1700,-800,0,-5600
3992,-2000,100,-900,10100,1950,9250
3993,100,9300,-3700,-12000,-950,-7250
3994,-3700,-11100,4500,-700,2900,-8100
3995,12100,-6100,-1700,11000,0,15300
3996,-900,4400,2900,-10000,0,-3600
3997,1000,-9200,1100,12000,0,4900
3998,0,4100,-1600,-11000,0,-8500
3999,200,-8300,-600,11600,0,2900
4000,-2800,3800,1200,0,0,2200
4001,0,3000,2100,-2800,-1200,1100
4002,-5800,7300,4300,1800,0,7600
4003,-600,-3300,-2700,-5800,0,-12400
4004,9100,-6400,5700,6400,0,14800
4005,-7500,7400,200,-10000,0,-9900
4006,7300,5700,3600,9600,-1200,25000
4007,-800,800,4700,-10000,0,-5300
4008,-2900,10200,-1800,3000,-950,7550
4009,-2600,6500,800,-800,0,3900
4010,6300,200,-1800,100,1950,6750
4011,-800,800,200,4000,-950,3250
4012,11100,-2700,3900,-12500,2900,2700
4013,-2000,6500,1700,1400,0,7600
4014,-1800,-8600,2900,0,0,-7500
4015,2200,0,-4100,8200,0,6300
4016,-3000,-6300,800,2200,0,-6300
4017,-2700,-2700,800,10200,0,5600
4018,-3600,8500,3900,-5800,0,3000
4019,12100,-8300,-800,15000,0,18000
4020,-2900,3600,1000,3000,0,4700
4021,-2600,5900,3000,-4000,0,2300
4022,11200,4600,-2600,5200,-1200,17200
4023,-8600,6500,3000,-8000,0,-7100
4024,11400,-2600,3000,1400,0,13200
4025,-3000,3700,2000,-5800,-1200,-4300
4026,0,-3300,-3800,11200,0,4100
4027,0,4600,3000,-14800,-950,-8150
4028,-1700,-12200,4700,23200,-10200,3800
4029,-3600,10200,-5600,-12900,1950,-9950
4030,-6400,3800,4600,200,-950,1250
4031,5400,9200,-10800,11300,13700,28800
4032,11100,-5400,4800,-3600,-1200,5700
4033,1000,-2800,-1100,10200,0,7300
4034,-6500,-3500,14800,1000,-950,4850
4035,-2600,-2900,-2000,11200,0,3700
4036,12000,3900,2100,-5700,750,13050
4037,-3000,3600,-400,3700,750,4650
4038,-2900,-9100,1700,13200,0,2900
4039,5700,100,1000,-1000,-950,4850
4040,-6400,6700,3000,1000,-950,3350
4041,3500,8600,2100,-1700,1700,14200
4042,11200,4600,-700,-2900,1950,14150
4043,100,-2600,4800,-9600,0,-7300
4044,-3000,6500,100,3200,-1200,5600
4045,0,-2600,100,-800,-1200,-4500
4046,0,6600,-11700,12000,-950,5950
4047,-3000,-8200,3000,1000,0,-7200
4048,-1700,-6300,2900,7300,750,2950
4049,13100,4200,10800,-7800,-950,19350
4050,-2900,-9100,3900,8100,1950,1950
4051,0,10100,-900,-11000,-950,-2750
4052,-3000,6500,100,2100,2900,8600
4053,-3000,-2700,1000,-1900,1950,-4650
4054,11300,6500,-900,1000,0,17900
4055,-2900,-2400,-3600,2000,0,-6900
4056,-2900,-6200,1100,21400,-10200,3200
4057,200,-8300,1100,9000,0,2000
4058,0,3900,-7900,-2600,10800,4200
4059,100,6500,3800,9400,-1200,18600
4060,100,9200,-3900,-13600,0,-8200
4061,200,-3300,14000,5400,-950,15350
4062,100,-11100,3000,-1600,-1200,-10800
4063,-4500,-3600,2000,9100,1950,4950
4064,13000,3900,4900,4300,1950,28050
4065,-8400,18500,5800,-11000,0,4900
4066,11200,-700,-900,10000,0,19600
4067,-900,10000,-12100,-800,0,-3800
4068,1100,-2800,3800,4200,0,6300
4069,-2900,100,8900,4400,-1200,9300
4070,-5800,-2600,-1000,14200,0,4800
4071,11200,-5500,1100,200,-2150,4850
4072,-2700,3800,3900,0,0,5000
4073,0,-6200,200,-2900,1950,-6950
4074,0,4600,2000,0,-950,5650
4075,0,3700,-3800,-11700,2900,-8900
4076,100,-9100,2900,12000,0,5900
4077,-2900,4400,3800,-9000,0,-3700
4078,100,1000,3000,0,0,4100
4079,-3800,-700,-2700,2000,0,-5200
4080,8300,200,2900,6200,0,17600
4081,1000,-700,-3200,8600,0,5700
4082,0,9200,2900,-3600,-1200,7300
4083,-2800,-5500,4800,10200,-1200,5500
4084,-3800,0,0,3000,-950,-1750
4085,12000,18400,-1800,2000,0,30600
4086,-2800,-2700,100,-2700,750,-7350
4087,-3700,-2600,1100,11200,-2150,3850
4088,-2700,-8200,2000,-2900,2900,-8900
4089,9000,-800,-1800,2200,-2150,6450
4090,-2800,6400,-5300,11000,-950,8350
4091,-3000,12000,-1200,300,1950,10050
4092,7500,-2800,2900,-4900,1950,4650
4093,1100,-3000,10800,1200,-950,9150
4094,-3000,9300,-900,-1700,-7300,-3600
4095,-900,-2800,100,-4900,1950,-6550
4096,1100,-2900,900,10200,0,9300
4097,0,-2700,100,-1000,12000,8400
4098,100,-5400,-2600,1000,0,-6900
4099,-7200,-3400,3000,8000,0,400
4100,10300,4500,-4000,-7600,-1200,2000
4101,100,-8900,1200,8000,0,400
4102,-5200,-9300,4500,-1600,0,-11600
4103,8300,6400,3600,400,-1200,17500
4104,-3000,1200,-9700,1000,0,-10500
4105,11300,8500,100,-5800,0,14100
4106,100,-1300,15800,-5600,-3350,5650
4107,0,3700,-700,-10800,-950,-8750
4108,-2700,-3400,-1700,7100,1950,1250
4109,-3800,2000,900,-13500,1950,-12450
4110,-2300,3800,1900,-1000,-950,1450
4111,2800,-5400,2900,10100,2900,13300
4112,12000,3500,-9900,-900,1950,6650
4113,0,-6300,200,11200,-1200,3900
4114,-3000,1700,15900,-7800,-1200,5600
4115,0,3700,2000,1000,0,6700
4116,-2800,-6400,4800,-1000,-950,-6350
4117,-3600,3700,0,13200,-10200,3100
4118,11100,7300,1000,-11000,-950,7450
4119,1000,3600,-9300,7500,12750,15550
4120,0,-5500,2900,-3900,2900,-3600
4121,-3800,9400,8300,4000,0,17900
4122,1100,3800,-7000,-5800,0,-7900
4123,-900,-8300,1800,11400,-1200,2800
4124,-1900,4000,200,-9000,0,-6700
4125,-3800,-3500,10300,12000,0,15000
4126,9200,4600,3900,-9600,-3350,4750
4127,100,-9300,100,14000,-950,3950
4128,100,-6400,4500,-8500,2900,-7400
4129,-2800,19500,-3600,4000,-1900,15200
4130,-2800,1300,-12600,-2900,1950,-15050
4131,11300,1000,3900,-3500,500,13200
4132,100,-6200,9100,-3700,1950,1250
4133,-2800,-11400,6700,14200,-2150,4550
4134,-2600,6600,-900,1000,0,4100
4135,200,5700,2000,-7700,1950,2150
4136,-2700,1700,3600,200,0,2800
4137,8700,-9400,600,-1700,1950,150
4138,-5600,-6300,1200,12000,0,1300
4139,11200,16600,-10900,-3800,0,13100
4140,-2600,6400,2000,-2600,0,3200
4141,100,-8200,2900,-2000,0,-7200
4142,-2800,6600,12200,2000,0,18000
4143,-5800,-9100,5800,0,0,-9100
4144,11300,4500,800,-2600,-1200,12800
4145,-900,800,-5500,1600,-2400,-6400
4146,-1800,6300,100,2200,-2150,4650
4147,-3000,-700,5200,-800,-1200,-500
4148,12000,-8500,2900,12100,1000,19500
4149,-5500,-6100,2800,-1800,-950,-11550
4150,-9300,21300,1100,-500,500,13100
4151,12000,4500,1100,-2900,1000,15700
4152,-6600,-6400,5700,2000,-950,-6250
4153,9300,-800,900,7300,750,17450
4154,0,22200,-2700,-13900,1950,7550
4155,-3000,3600,2000,4000,-950,5650
4156,-800,-6300,2600,-4700,2900,-6300
4157,8100,7200,-200,1500,750,17350
4158,-2000,6500,-200,-8600,-2150,-6450
4159,0,-2700,100,7100,1950,6450
4160,-900,-8500,2000,15000,0,7600
4161,-2800,6500,-9000,-1000,-950,-7250
4162,12200,-3700,-2700,10500,500,16800
4163,0,-5300,14000,-4900,1950,5750
4164,-900,18400,100,-1000,-950,15650
4165,1000,-5300,-1900,-600,-1200,-8000
4166,-9500,3700,-4500,11300,1950,2950
4167,6500,-5200,300,0,-1900,-300
4168,-2700,3600,-6200,6100,2900,3700
4169,7400,-2700,12000,12100,1950,30750
4170,-2700,6400,2900,-14000,-950,-8350
4171,1000,300,8400,7100,2900,19700
4172,-2800,3400,2900,-10000,0,-6500
4173,5400,200,-4100,14400,0,15900
4174,-3700,-8300,7400,9400,0,4800
4175,8300,-500,-4500,0,0,3300
4176,-4400,7300,2800,-1800,-1200,2700
4177,2700,-700,100,2000,0,4100
4178,5400,7300,-100,5400,-1200,16800
4179,100,-8300,3800,-2000,0,-6400
4180,-6500,-3400,-800,15200,-2150,2350
4181,6200,4600,3900,-8000,0,6700
4182,-3400,-6200,1100,6100,1950,-450
4183,11100,4700,1200,-13800,-950,2250
4184,-1800,3700,3600,-2500,1700,4700
4185,-3000,3600,2900,3000,0,6500
4186,-700,200,-1800,-2000,-950,-5250
4187,9100,-3200,-3600,14000,-950,15350
4188,-6900,-2800,900,-5900,2900,-11800
4189,9300,3700,1000,11100,1950,27050
4190,1000,-9400,1000,1000,0,-6400
4191,0,-11300,5800,10200,0,4700
4192,100,3900,-1700,-10000,0,-7700
4193,-3700,2700,4800,12000,0,15800
4194,1100,7700,-2600,-3400,-2400,400
4195,-900,600,200,-8000,0,-8100
4196,1000,-9200,9400,7200,0,8400
4197,-3800,10000,0,-8000,-950,-2750
4198,8100,9200,0,2200,-1200,18300
4199,1100,-700,-900,-4700,750,-4450
4200,100,7500,-3900,2400,-2150,3950
4201,-700,900,2000,-16700,750,-13750
4202,-5600,-2700,2000,13000,-950,5750
4203,9300,-6100,300,-4900,1950,550
4204,-3700,-6300,3900,6100,1950,1950
4205,100,16700,1000,0,-950,16850
4206,1100,-6100,-2600,-5900,2900,-10600
4207,100,-5400,-800,8100,1950,3950
4208,100,15800,3000,-14800,0,4100
4209,-3600,-9300,6700,11200,0,5000
4210,9000,7400,-1700,-9000,0,5700
4211,-2800,3900,2100,0,0,3200
4212,8200,-500,-1700,-1800,0,4200
4213,-3000,1600,1500,4600,-1200,3500
4214,-4800,1100,-8200,12400,-1200,-700
4215,-1600,-5300,0,-1600,-1200,-9700
4216,12300,1000,2100,-1000,0,14400
4217,-800,-6200,11200,-1000,-950,2250
4218,-2600,-8600,7600,9200,-950,4650
4219,-4600,6500,100,-12900,2900,-8000
4220,-800,5700,2900,7100,1950,16850
4221,6200,-3600,3800,3000,0,9400
4222,-3000,22200,-1800,3000,0,20400
4223,11200,6500,-800,-11000,0,5900
4224,400,-5600,-4100,14400,-1200,3900
4225,-2900,1000,-100,2200,0,200
4226,-2800,-2600,3000,-5800,-950,-9150
4227,-2800,-6200,900,10200,0,2100
4228,-6400,-3500,-12300,9500,1950,-10750
4229,12200,13800,2100,-1000,-950,26150
4230,-4700,1200,-6000,-3700,2900,-10300
4231,13000,-2500,9400,9000,0,28900
4232,-3600,-6300,5700,8200,0,4000
4233,-4800,-6400,15000,2000,0,5800
4234,-3800,16500,2000,1000,0,15700
4235,12100,3900,-8000,-4400,-2400,1200
4236,200,-9200,200,13000,0,4200
4237,-2800,1800,12800,-9800,0,2000
4238,0,3600,-7000,7200,-950,2850
4239,0,-9300,1700,4400,-2150,-5350
4240,0,7400,14000,-7700,2900,16600
4241,8400,6400,-900,-10900,1950,4950
4242,-2900,-3500,2800,9200,0,5600
4243,-2800,7500,-700,-14000,0,-10000
4244,-3400,6600,-9900,9400,-1200,1500
4245,9000,-5400,2000,14000,0,19600
4246,100,-9100,2000,-3000,-950,-10950
4247,0,-11800,13900,11600,-2150,11550
4248,-3000,16500,-1300,-8500,2900,6600
4249,-9500,9300,2000,-900,1950,2850
4250,7800,-6300,3900,-2000,0,3400
4251,9400,4500,2900,-1000,0,15800
4252,1000,6600,-800,-14000,0,-7200
4253,-3000,-6300,2000,14200,-1200,5700
4254,100,7300,100,-14000,0,-6500
4255,100,-6300,1900,9000,-950,3750
4256,-2800,300,-2600,0,0,-5100
4257,8200,8500,1000,10100,1950,29750
4258,-800,-5400,-1100,-800,-950,-9050
4259,-2000,-5300,2100,6500,1700,3000
4260,-3600,15700,1800,-10600,-1200,2100
4261,9000,6500,-8000,11200,0,18700
4262,-6500,-2700,-100,12400,-1200,1900
4263,11100,-5500,2900,-4000,-950,3550
4264,-2900,3700,12800,5200,-950,17850
4265,-4700,-6000,200,-3500,500,-13500
4266,7500,4400,3900,-1900,1950,15850
4267,1000,6600,2000,-1800,0,7800
4268,0,-6500,100,-2000,-950,-9350
4269,100,7400,-3000,2400,-2150,4750
4270,0,3600,-5200,-5700,2900,-4400
4271,-5300,-2700,-800,7100,1950,250
4272,8600,-2600,100,-1800,-2150,2150
4273,100,3700,14000,-800,-950,16050
4274,-7500,-2400,-2900,-2700,2900,-12600
4275,10500,-3500,1100,6100,1950,16150
4276,-2700,4500,1900,-15400,0,-11700
4277,200,6500,-4900,200,0,2000
4278,-3600,-8200,7700,7400,-10200,-6900
4279,3400,6400,4800,3000,12000,29600
4280,-3500,-3400,3000,-5800,0,-9700
4281,9000,4700,-9800,14000,0,17900
4282,-900,-8500,800,3400,-1200,-6400
4283,-2500,3700,15900,-3000,0,14100
4284,9300,-3800,1900,13000,0,20400
4285,0,7100,-900,-10000,-950,-4750
4286,0,9200,-2100,200,-950,6350
4287,-6500,-2600,-200,1300,2900,-5100
4288,6400,-2800,2000,9300,750,15650
4289,-3600,-2600,1100,-4000,0,-9100
4290,11100,4000,-1900,2200,0,15400
4291,1000,100,-1700,-3600,-1200,-5400
4292,-2800,600,7600,200,0,5600
4293,-4800,-700,1000,-2800,-950,-8250
4294,-1500,7300,1900,-1000,0,6700
4295,12000,-8400,-1000,11300,1950,15850
4296,-2900,-6200,1100,-1000,-950,-9950
4297,-2900,4700,-2200,-10500,2900,-8000
4298,0,3800,1100,-1000,0,3900
4299,-3800,3800,-9800,16200,-1200,5200
4300,9300,-11200,4700,1000,0,3800
4301,-2700,3800,15000,-2000,0,14100
4302,-2700,-9400,4800,2000,0,-5300
4303,11200,7000,0,3000,0,21200
4304,0,-500,-2700,-1800,-1200,-6200
4305,-5800,-3600,500,14400,0,5500
4306,100,19500,-12600,10000,-950,16050
4307,100,-6400,100,-1800,0,-8000
4308,200,1600,14800,0,-950,15650
4309,-4300,-3400,-2000,-4700,2900,-11500
4310,10000,4500,3000,-6700,1950,12750
4311,-6600,3700,-4300,-600,-1200,-9000
4312,-2500,-700,-900,9200,-1200,3900
4313,8300,-1200,17700,-8800,-1200,14800
4314,-1800,-600,-3700,12000,-950,4950
4315,11300,4700,200,-1000,0,15200
4316,-6700,6500,-8200,-3500,1950,-9950
4317,-3400,-8300,3800,10200,-2150,150
4318,10300,-3000,-5300,-7700,1700,-4000
4319,-2900,1700,18700,1600,-2400,16700
4320,-3000,6500,1100,-9600,-2150,-7150
4321,11500,-6200,-1900,10000,-950,12450
4322,-3500,4500,2000,-2900,1950,2050
4323,-4800,-400,-4400,-1900,1950,-9550
4324,-3600,-8300,8600,-5800,-950,-10050
4325,12100,12900,-10800,11500,-450,25250
4326,-5800,-6100,2100,11100,1950,3250
4327,8400,7400,10400,-12000,-1900,12300
4328,-2900,-1700,4800,1100,2900,4200
4329,-5800,-5500,-7200,8500,750,-9250
4330,-3400,3700,2000,-3900,1950,350
4331,5700,6400,17700,-11000,0,18800
4332,9100,-2800,900,10100,1950,19250
4333,0,6500,100,-800,-1200,4600
4334,8400,9400,-9900,-2000,0,5900
4335,-2900,0,-1900,13000,-950,7250
4336,-2900,-5500,2000,0,0,-6400
4337,-3500,-2600,14000,7100,1950,16950
4338,9000,6600,-12600,2000,-950,4050
4339,-3000,-5500,5700,7300,2900,7400
4340,0,-800,12000,-3000,0,8200
4341,-5600,10000,0,3000,0,7400
4342,14100,100,-4000,-3800,0,6400
4343,-2800,-8400,6700,12200,-1200,6500
4344,0,-600,-1800,10000,0,7600
4345,0,4200,-200,-6600,-1200,-3800
4346,0,-2700,100,-1000,0,-3600
4347,0,-9400,3800,15000,-950,8450
4348,0,-800,0,10000,0,9200
4349,-700,12100,-1900,-4900,1950,6550
4350,100,300,-4500,10000,-950,4950
4351,-1700,800,4700,-3700,1700,1800
4352,0,6500,-8900,8200,0,5800
4353,-3800,-2800,4700,-1800,0,-3700
4354,12000,9300,-2100,1200,0,20400
4355,-900,-5600,14900,-1000,0,7400
4356,100,-2900,-11100,22200,0,8300
4357,100,9300,-3000,-12800,0,-6400
4358,-1600,-2800,900,11000,0,7500
4359,100,-8500,13900,2200,-1200,6500
4360,-2800,-600,-1700,9000,0,3900
4361,-6500,7200,1900,5000,0,7600
4362,9500,-6300,1600,-2600,-2150,50
4363,200,7600,-1900,-3600,-950,1350
4364,-2700,0,-2000,-7700,2900,-9500
4365,11300,3700,-6200,5500,750,15050
4366,-6700,-2600,200,1200,-1200,-9100
4367,-2500,3600,4900,9200,-1200,14000
4368,9100,-10900,3900,15000,-950,16150
4369,-3000,-3400,10300,1200,-2150,2950
4370,0,1000,3900,-2900,1950,3950
4371,-3600,7400,-4100,-12500,1950,-10850
4372,9200,600,6700,200,-950,15750
4373,0,-6300,2900,-4900,2900,-5400
4374,-2800,10100,-5400,1100,-450,2550
4375,-3000,-6300,1100,1000,0,-7200
4376,-700,-8200,2900,11000,-950,4050
4377,11100,15700,2000,2200,-2150,28850
4378,-1900,1200,-2200,-13500,2900,-13500
4379,-2800,-800,-1100,7300,1000,3600
4380,0,-1200,3000,-7000,0,-5200
4381,-3000,6700,-700,-4700,1950,250
4382,7600,-3500,2400,-4200,-950,1350
4383,-2000,4400,2000,100,2900,7400
4384,-2700,-9200,5700,-2000,0,-8200
4385,-700,4600,100,-1000,0,3000
4386,6500,6500,2900,-12000,0,3900
4387,-3900,-3200,-3800,13200,0,2300
4388,6600,7400,1100,-14000,0,1100
4389,-6500,-6300,2000,14200,-1200,2200
4390,6200,4600,3700,-10400,-1200,2900
4391,11200,-6200,900,8400,0,14300
4392,-9300,7300,2900,-6800,-2150,-8050
4393,6400,3900,-1100,3200,0,12400
4394,200,-2700,-2800,8300,750,3750
4395,-9300,6800,-7900,200,-950,-11150
4396,8100,-5400,-1000,9300,1950,12950
4397,12200,1000,3200,-2800,-1200,12400
4398,-5700,-2800,3800,8500,750,4550
4399,0,3500,1100,-11800,0,-7200
4400,-3600,-5400,17800,5500,750,15050
4401,7500,-6300,2700,-800,-950,2150
4402,-6600,-3300,1800,10200,-950,1150
4403,10400,13700,-10900,-1700,2900,14400
4404,-2600,6600,-2900,-3700,1950,-650
4405,-8200,-3400,15000,-2600,-1200,-400
4406,9300,4400,5700,-1000,0,18400
4407,11200,-12000,3900,2200,-1200,4100
4408,-2800,-5500,1000,13200,-2150,3750
4409,-2800,-3600,1700,-1600,-2150,-8450
4410,-6400,11400,-1800,12300,750,16250
4411,12100,4700,-2600,-14900,1950,1250
4412,-2800,18400,-5200,9400,-3100,16700
4413,-6600,-2600,2000,10100,2900,5800
4414,9200,-6200,11800,-2700,1950,14050
4415,200,7300,-1900,0,-950,4650
4416,0,-5800,3900,-5300,1700,-5500
4417,300,3600,0,-3900,1950,1950
4418,-2700,-5700,-1600,-2000,-950,-12950
4419,-3800,1900,0,4400,-1200,1300
4420,11100,3700,-700,-2900,1950,13150
4421,-1900,-9100,7600,-5700,1950,-7150
4422,-3800,4600,-8900,15000,0,6900
4423,8300,600,4800,-10000,0,3700
4424,-4600,-500,9400,12000,0,16300
4425,7500,1700,4900,-11800,0,2300
4426,-1800,-3200,-3700,10200,0,1500
4427,100,3600,-7100,-2000,0,-5400
4428,-3700,3600,6600,12200,0,18700
4429,12100,6700,11200,-13000,0,17000
4430,-5600,-2600,100,13000,0,4900
4431,-5800,6500,1100,-10000,0,-8200
4432,11300,-9000,-100,11200,0,13400
4433,100,4400,-2700,-7000,0,-5200
4434,-2800,3600,3700,400,-1200,3700
4435,0,-9100,3000,-2000,0,-8100
4436,-7400,-5600,4800,13000,0,4800
4437,10100,9200,1800,-11800,-950,8350
4438,-900,21300,-13000,9200,-950,15650
4439,-5500,-2700,100,-1900,2900,-7100
4440,9100,-2700,15800,7300,1950,31450
4441,-3000,-2900,-16400,12400,-1200,-11100
4442,8400,4600,3000,-1000,0,15000
4443,-3900,-8100,13200,15000,0,16200
4444,-1800,3700,3900,-13000,0,-7200
4445,10400,-8100,1100,8000,0,11400
4446,1100,3600,-2000,-10600,-1200,-9100
4447,-3000,3700,4800,400,-1200,4700
4448,-2700,-700,2900,-6200,-3350,-10050
4449,-9400,7300,3600,5200,0,6700
4450,2500,9600,-1900,500,750,11450
4451,300,-2600,-2600,-3000,-1900,-9800
4452,5400,-2800,4800,8300,2900,18600
4453,9000,-5500,1700,-2700,1000,3500
4454,-6300,-3200,-1000,11200,-950,-250
4455,9200,-5500,1000,-1700,1700,4700
4456,-3500,18300,-4100,-500,1950,12150
4457,9200,-3300,2500,1100,-8250,1250
4458,-6400,10000,2000,2000,0,7600
4459,12100,-8500,2900,-1800,12000,16700
4460,-5800,-5500,1800,13200,0,3700
4461,-6400,3600,-13800,6400,0,-10200
4462,12000,9300,-2700,2000,0,20600
4463,-2900,-2600,13700,9400,0,17600
4464,-900,-3300,-3500,0,0,-7700
4465,1300,-11200,2900,8200,0,1200
4466,0,3000,14100,-2000,0,15100
4467,-6600,7600,1200,1200,0,3400
4468,8100,-11900,5800,2000,0,4000
4469,1000,4700,200,-1000,0,4900
4470,200,3700,1000,-12000,0,-7100
4471,-3000,6600,-2600,1000,0,2000
4472,8500,-3500,5700,-7600,0,3100
4473,-6600,7300,2900,4000,0,7600
4474,9000,3900,200,-9000,0,4100
4475,0,6600,-12900,11400,-1200,3900
4476,-3000,-8200,900,14200,0,3900
4477,-3800,-8900,1800,600,-1200,-11500
4478,12300,4600,12100,-1000,-950,27050
4479,100,-9100,2000,200,-2150,-8950
4480,-8600,-3200,-600,10100,2900,600
4481,11200,13800,3900,-15900,1950,14950
4482,-5800,-6000,300,13000,-950,550
4483,-6500,3700,-8100,3200,-2150,-9850
4484,-2600,6500,1100,6100,2900,14000
4485,12100,-9100,3800,9300,750,16850
4486,200,-12100,14900,-800,-1200,1000
4487,-3600,19300,2000,-800,-2150,14750
4488,9000,3600,2600,-5800,0,9400
4489,100,-3600,100,6100,1950,4650
4490,0,10000,2800,-12400,-4300,-3900
4491,-800,9300,-900,-4900,2900,5600
4492,-2000,-600,-4600,-1900,1950,-7150
4493,100,7300,1000,-5500,-200,2700
4494,100,-5500,2900,-1000,-950,-4450
4495,-2900,3700,2900,-1500,500,2700
4496,11200,200,-4800,-3700,1950,4850
4497,-2900,1000,-8300,23400,-10200,3000
4498,-2700,-2800,12700,12200,-950,18450
4499,0,3600,-7100,-5900,1950,-7450
4500,-9400,-2500,0,15200,11050,14350
4501,6300,3600,15800,-10700,1700,16700
4502,-800,-3500,100,10000,0,5800
4503,12000,-8500,2900,3000,-950,8450
4504,200,-2600,-3700,10000,0,3900
4505,-900,12800,-6100,7100,1950,14850
4506,-4800,-3300,2000,1000,0,-5100
4507,8600,-3400,6100,10300,1950,23550
4508,200,13600,2800,-800,-10200,5600
4509,-2700,-8600,3800,14000,0,6500
4510,-1800,3800,-7900,-3800,0,-9700
4511,-700,-6100,1100,8000,12000,14300
4512,8200,1600,16800,-9000,0,17600
4513,0,6700,-10000,8400,0,5100
4514,-3000,-3600,1000,15200,-1200,8400
4515,-3000,7500,11200,-11000,0,4700
4516,8500,6500,1100,200,-1200,15100
4517,-3600,-2700,1000,-1000,0,-6300
4518,1000,3800,100,200,-2150,2950
4519,-3600,-2800,-400,400,0,-6400
4520,6200,-6400,7600,18500,-8250,17650
4521,-3000,200,-1800,-1900,1950,-4550
4522,-1700,21600,-6300,1000,12000,26600
4523,10100,-5500,5700,6400,0,16700
4524,-10100,0,1000,1000,0,-8100
4525,12100,-2600,2900,4200,0,16600
4526,1000,-6600,1000,1000,0,-3600
4527,0,-2800,-8300,20600,-2400,7100
4528,-3000,-800,-1200,1200,0,-3800
4529,-2900,22100,-3000,2400,-2150,16450
4530,5500,-2800,12700,13400,-1200,27600
4531,-900,-4900,-1500,-7700,1950,-13050
4532,-2900,-8200,900,14400,-3100,1100
4533,8500,3800,2000,-16700,2900,500
4534,1200,-6400,0,6100,1000,1900
4535,0,-1300,3900,-6800,-2150,-6350
4536,100,4100,-2600,-2900,2900,1600
4537,-6500,-2500,-1700,-2900,1950,-11650
4538,6300,-6400,6700,9200,-950,14850
4539,0,-9100,3900,-5900,2900,-8200
4540,-7300,19300,-1800,5200,-1200,14200
4541,7300,3900,2000,-8800,-1200,3200
4542,11300,-6100,-700,9200,-2150,11550
4543,-2900,4400,1000,-7000,0,-4500
4544,-2600,3800,4800,-5700,1950,2250
4545,100,-6200,-2000,-2800,-1900,-12800
4546,-6600,-8300,5800,10100,2900,3900
4547,6200,14800,-8200,300,1950,15050
4548,11200,-8000,2100,10000,-950,14350
4549,-7500,4700,14100,1100,2900,15300
4550,-3700,6400,-8100,0,0,-5400
4551,11200,3800,-8900,17200,-10200,13100
4552,-3000,-5400,12200,4200,-1200,6800
4553,-1700,-3500,1900,8200,0,4900
4554,-700,-3500,1000,-5000,12000,3800
4555,11300,16600,10000,3200,0,41100
4556,-3000,3600,3800,1000,0,5400
4557,-2600,-3400,-3000,-600,-1200,-10800
4558,-2800,9400,1800,-4400,0,4000
4559,-7100,4300,700,-6800,-950,-9850
4560,13200,-5400,-3900,9400,-1200,12100
4561,0,900,3000,-14900,1950,-9050
4562,100,-6200,3000,4500,750,2150
4563,-5600,-1300,6500,3200,0,2800
4564,11200,-9200,1100,1200,-2150,2150
4565,-5500,-3200,-600,9200,-2150,-2250
4566,-3600,19600,100,-16500,2900,2500
4567,9000,3700,-8000,12100,1950,18750
4568,200,-6200,-1700,-3800,-2150,-13650
4569,-7300,2000,-100,5200,-950,-1150
4570,10000,3700,12200,-11900,2900,16900
4571,-2900,-6000,0,7500,1950,550
4572,-800,-11000,5800,-2000,0,-8000
4573,11200,3600,100,1000,0,15900
4574,1000,2800,7600,-6800,0,4600
4575,-2900,1800,2000,3000,0,3900
4576,-2900,-6000,-4700,3200,0,-10400
4577,-5500,-2800,3800,11000,0,6500
4578,5600,3700,4800,-800,0,13300
4579,-3600,5800,-2000,2400,-1200,1400
4580,12000,-6300,3000,7200,0,15900
4581,-3000,13700,3900,-8800,-2150,3650
4582,-6700,-3400,2700,9400,0,2000
4583,200,-6100,-1900,-5700,1950,-11550
4584,11100,16500,2900,2000,-950,31550
4585,-1700,-9400,4800,7100,2900,3700
4586,100,-3100,-4700,-800,0,-8500
4587,-6600,19400,-700,4000,0,16100
4588,5600,-6100,4900,-1000,0,3400
4589,6200,8700,-700,14000,0,28200
4590,-6500,-5500,2900,2000,0,-7100
4591,12100,1000,2000,1000,0,16100
4592,-3900,5800,-100,2200,0,4000
4593,-2000,1700,3900,3000,0,6600
4594,-800,800,3900,-15000,0,-11100
4595,11200,-6300,-2300,14800,-2400,15000
4596,-2000,1900,1800,-9800,0,-8100
4597,-900,6600,-4100,2400,-950,3050
4598,1100,-9100,1700,-1600,-1200,-9100
4599,-9400,7500,-9000,9300,1950,350
4600,11100,3900,-900,-14400,-2150,-2450
4601,100,-3500,14000,4300,1950,16850
4602,-2000,-5200,2100,-5700,1950,-8850
4603,-2800,-3500,3000,8200,0,4900
4604,8300,5600,2000,7300,-8250,14950
4605,-2800,-1100,5800,4000,0,5900
4606,-900,15900,-10700,9000,0,13300
4607,1000,4000,-13100,-600,12000,3300
4608,-5700,-2800,4800,9200,0,5500
4609,-3500,-3400,12100,0,0,5200
4610,8200,3600,4000,12000,0,27800
4611,9500,3200,-1800,1000,0,11900
4612,200,-5600,-900,11000,0,4700
4613,-3900,800,19600,-10800,0,5700
4614,-1800,3000,1000,12000,0,14200
4615,-6300,7600,-700,-11000,0,-10400
4616,8200,-9100,4900,10200,0,14200
4617,12200,-12100,1700,2400,-1200,3000
4618,0,6600,200,0,0,6800
4619,-3000,6500,2000,200,-950,4750
4620,0,-6400,4800,-3800,0,-5400
4621,0,19300,700,-1700,1950,20250
4622,-3000,9300,-1800,200,-11150,-6450
4623,100,-6400,1000,7100,2900,4700
4624,-3500,7500,2000,1000,12000,19000
4625,9200,6300,-9900,200,-1200,4600
4626,100,-6200,100,11000,0,5000
4627,-800,-12200,14600,1200,0,2800
4628,1100,9300,-1800,10200,-1200,17600
4629,-2700,9200,1900,-15800,0,-7400
4630,-3700,-6300,-1100,16200,-950,4150
4631,12000,16800,-7200,-7600,-950,13050
4632,-900,3900,-700,-500,500,2300
4633,200,-6200,13100,6100,1950,15150
4634,-2000,-5600,1100,-1000,0,-7500
4635,-2800,15700,-2400,8400,-2150,16750
4636,0,-3700,-900,3000,-950,-2550
4637,-2800,10000,13000,-3700,1700,18200
4638,11200,-3500,1000,-4900,1950,5750
4639,200,-2900,-4900,15400,-1200,6600
4640,-800,3600,2900,8200,-950,12950
4641,-2700,-6200,2100,-800,-2150,-9750
4642,-2000,4400,3800,1100,2900,10200
4643,-2900,9600,-4800,-12500,-200,-10800
4644,-800,-6400,1100,11000,0,4900
4645,9000,4600,1100,-10700,750,4750
4646,-2800,-6200,1900,10200,-950,2150
4647,-900,1900,1200,-1900,1950,2250
4648,-2800,-6200,2100,-800,0,-7700
4649,6300,4800,200,1000,-950,11350
4650,200,-3400,-2700,-3700,1700,-7900
4651,-9400,-3500,5800,8300,1950,3150
4652,9100,19600,0,-15400,0,13300
4653,7600,-3600,1000,19400,-11400,13000
4654,-4700,-2700,2700,9400,12000,16700
4655,8400,8600,200,-3000,0,14200
4656,-6600,7400,1800,3600,-2150,4050
4657,12000,-11200,5800,-1800,-950,3850
4658,-800,-6000,-700,5100,2900,500
4659,-4800,7800,-3400,-12700,750,-12350
4660,-6400,6400,1000,4000,0,5000
4661,12100,-9200,2700,-3800,-950,850
4662,-6500,4200,7600,200,0,5500
4663,9400,6700,-1800,-11900,1950,4350
4664,-2800,-6400,200,11000,0,2000
4665,0,-5200,-1600,-2500,-450,-9750
4666,0,-11900,6700,11000,0,5800
4667,-900,19200,-1100,-11800,0,5400
4668,1100,3800,3900,-3600,-2150,3050
4669,-4600,6500,-10800,14000,-950,4150
4670,10000,-5400,3000,-5700,2900,4800
4671,0,3600,3800,-2700,750,5450
4672,-2900,-800,11000,3000,0,10300
4673,-2900,10000,-1000,3200,-2150,7150
4674,11200,100,-1800,-600,-2400,6500
4675,-6700,-2400,200,12100,1950,5150
4676,-5400,-3500,200,11000,-1900,400
4677,12300,4600,-1800,-13700,1700,3100
4678,-6600,-2700,1100,-1900,1950,-8150
4679,12000,3700,1100,1000,-1900,15900
4680,-3600,-6300,7600,1700,1700,1100
4681,1000,-8300,200,-2700,750,-9050
4682,0,3100,2100,11000,0,16200
4683,-2900,4600,-800,-12900,1000,-11000
4684,100,-9200,100,15200,-2150,4050
4685,0,-6300,1100,-2900,2900,-5200
4686,0,16500,3600,-6500,1950,15550
4687,-800,6600,-2900,-11800,0,-8900
4688,-1800,-6600,4800,8200,0,4600
4689,8200,1700,4800,-9800,-1200,3700
4690,100,9300,-900,1200,-1200,8500
4691,-3900,-5900,-1600,15000,0,3600
4692,-1700,4200,2000,-12000,-950,-8450
4693,7600,-3600,3800,7100,1950,16850
4694,-2000,-500,-2700,2000,0,-3200
4695,-2900,19400,-2600,-900,1950,14950
4696,11300,-2600,1100,-6600,0,3200
4697,0,-5600,-3600,18400,0,9200
4698,-3000,-3400,100,0,0,-6300
4699,100,-3400,-2700,20400,-11400,3000
4700,-2800,13800,13100,3000,0,27100
4701,0,-5600,4500,-5600,11050,4350
4702,0,6600,-700,-1800,-950,3150
4703,-6500,-3600,6600,-5700,2900,-6300
4704,11100,7100,-900,-900,1950,18350
4705,1100,100,-3000,-2800,0,-4600
4706,-2800,6600,800,2200,0,6800
4707,-3600,-2500,-2700,-2800,0,-11600
4708,12000,-5300,-700,11000,0,17000
4709,-2800,-9200,2100,12000,0,2100
4710,0,3900,-700,-10000,0,-6800
4711,-900,-1400,6700,1200,0,5600
4712,1000,3600,-3400,-4800,0,-3600
4713,-3800,-300,-6400,14000,0,3500
4714,-8400,10000,2900,-10000,0,-5500
4715,12000,3800,15000,8400,-10200,29000
4716,0,-5600,2000,-2000,0,-5600
4717,-2900,-3300,-1700,12000,12000,16100
4718,-700,4600,100,-11000,0,-7000
4719,12000,-11900,5800,10000,0,15900
4720,-2900,-6400,3800,13200,-1200,6500
4721,0,22000,0,-12000,0,10000
4722,-3000,9400,-13000,14200,0,7600
4723,0,-8400,200,2200,-1200,-7200
4724,-900,-5500,2900,11400,-2400,5500
4725,-3700,6400,13000,-7800,-2150,5750
4726,10200,-3600,100,13000,-950,18750
4727,200,10200,-4600,-16900,1000,-10100
4728,-3000,-5500,1100,12100,2900,7600
4729,-5800,-6200,6700,-3700,1950,-7050
4730,-800,7300,100,-2000,-950,3650
4731,12000,-3600,1900,-3900,2900,9300
4732,-3000,0,0,14000,0,11000
4733,200,100,-2800,-3000,0,-5500
4734,0,3500,2000,14000,0,19500
4735,0,-3400,2000,-4800,0,-6200
4736,200,9300,-4000,1400,-1200,5700
4737,-9300,-2700,2900,1000,0,-8100
4738,9100,-8000,-3400,13600,0,11300
4739,-600,6500,1000,10000,-950,15950
4740,9000,6500,-1700,-8000,-950,4850
4741,100,-3300,200,3300,2900,3200
4742,-2800,4700,4900,-21700,1950,-12950
4743,-3700,-9000,-100,16200,0,3400
4744,12000,4400,3900,-14800,0,5500
4745,-2800,9500,-7900,15600,-10200,4200
4746,-5700,3600,-8900,1000,0,-10000
4747,-3700,-5400,15900,8400,10800,26000
4748,10200,-8100,1200,-2000,0,1300
4749,-900,-1900,16500,2200,0,15900
4750,-3800,-6300,3900,10200,0,4000
4751,12300,10300,-3600,-15000,0,4000
4752,200,3500,-900,-9800,0,-7000
4753,-2700,-9100,1100,12000,0,1300
4754,-2800,4400,3600,2400,-1200,6400
4755,-4500,3900,-800,-9000,0,-10400
4756,10000,-8800,300,12000,-950,12550
4757,-3000,-5600,3900,-800,-950,-6450
4758,0,2900,3900,8100,2900,17800
4759,-2900,-800,900,-4700,1950,-5550
4760,8200,4400,3800,4200,-1200,19400
4761,100,21300,-900,-15000,0,5500
4762,-3600,-800,-3200,14200,0,6600
4763,-7400,100,-2900,1200,0,-9000
4764,6700,-5300,1800,10200,0,13400
4765,10300,5700,-100,-800,0,15100
4766,100,4400,3800,-2800,0,5500
4767,0,-1900,3900,5400,-2400,5000
4768,-3000,-3600,-200,2200,0,-4600
4769,100,4600,200,-3000,0,1900
4770,-3500,4000,200,-9800,-2150,-11250
4771,12100,-12000,1100,13000,-950,13250
4772,0,4700,2100,-16700,1950,-7950
4773,-3000,3600,1700,2700,-450,4550
4774,100,-9300,3900,-2800,-950,-9050
4775,-2400,-5800,-1100,10100,1950,2750
4776,0,3000,2100,11000,-950,15150
4777,-3800,-3600,100,-1900,1950,-7250
4778,6500,7300,4700,-15700,2900,5700
4779,100,21300,-2800,9300,-8250,19650
4780,-3700,-6400,2900,12000,0,4800
4781,12100,7300,2900,-15800,12000,18500
4782,-3800,9200,-1000,4000,0,8400
4783,1000,-5700,100,1000,0,-3600
4784,-2800,200,100,11000,0,8500
4785,0,6500,-800,-12000,0,-6300
4786,-3600,-2600,100,12000,0,5900
4787,6300,6600,-800,4200,-1200,15100
4788,0,-5300,1200,-5800,0,-9900
4789,-4500,-8500,3900,16200,-1200,5900
4790,9100,-3200,-100,-5400,0,400
4791,1000,3800,200,-1800,-2150,1050
4792,-5800,9400,3000,1400,-2150,5850
4793,8300,3700,-100,300,2900,15100
4794,-2800,-6400,4800,9000,-1900,2700
4795,-3700,300,100,-3700,2900,-4100
4796,12000,-5700,-800,9100,1950,16550
4797,200,6500,-1200,-2800,-950,1750
4798,-1700,-6300,-100,8300,2900,3100
4799,-1900,6400,-9000,-1800,0,-6300
4800,-4600,12200,1900,12600,-10200,11900
4801,-700,-1800,16900,-12000,0,2400
4802,8100,-6300,1100,24200,1800,28900
4803,-2700,4500,2000,-11000,0,-7200
4804,1100,-3200,-6900,10400,0,1400
4805,-2800,4300,1800,-10400,10800,3700
4806,-3600,-1800,4600,200,0,-600
4807,9000,-3400,200,-800,0,5000
4808,-3500,10100,-2000,200,0,4800
4809,12000,800,4900,-14600,0,3100
4810,-700,-8000,200,8000,0,-500
4811,1400,-1900,-900,-10600,-2400,-14400
4812,-3000,-3500,-2300,14400,0,5600
4813,-1600,-1100,100,-8000,-950,-11550
4814,-800,3700,-7000,9000,0,4900
4815,-6500,-700,-1400,-5100,750,-12950
4816,9000,1700,13800,4400,-2150,26750
4817,-2800,1100,3100,-2900,1950,450
4818,-3700,-6400,2000,1000,0,-7100
4819,12100,1400,1900,1100,1950,18450
4820,-3700,3800,5800,-16700,1950,-8850
4821,-5600,-7100,3000,12000,0,2300
4822,9200,8000,-10100,-1600,0,5500
4823,-2700,3800,2000,1000,0,4100
4824,2600,-3300,13200,1000,0,13500
4825,11300,-5200,-3700,11200,0,13600
4826,-1800,-1500,2200,-12000,0,-13100
4827,-3800,8400,5700,7400,0,17700
4828,-3000,4600,200,-8000,0,-6200
4829,11200,-9000,2700,11200,0,16100
4830,-2700,1800,1100,2000,0,2200
4831,-3900,3800,200,-8000,0,-7900
4832,-2400,-3600,1900,9200,-1200,3900
4833,6400,1700,4000,-8000,0,4100
4834,0,800,-3300,8200,0,5700
4835,-3600,6500,2000,-11000,-950,-7050
4836,9000,-3600,13000,11000,-950,28450
4837,100,7000,900,-13700,2900,-2800
4838,0,9300,-900,-3900,1950,6450
4839,-3000,-3400,-800,13000,0,5800
4840,-3600,10100,-10100,-800,0,-4400
4841,12100,3700,800,200,0,16800
4842,-8500,-600,13000,1000,0,4900
4843,8500,400,-2800,8400,0,14500
4844,-6500,9700,-5600,2200,0,-200
4845,3400,-2800,4600,10400,0,15600
4846,11300,-11900,5700,-1000,0,4100
4847,-2800,-8600,3900,13400,-2400,3500
4848,-2800,-6300,-700,2000,0,-7800
4849,-900,3700,4800,10000,-950,16650
4850,1000,6600,1100,-16800,0,-8100
4851,100,-6300,1000,8300,750,3850
4852,0,16500,1700,-12800,-950,4450
4853,0,6600,-2900,-1700,2900,4900
4854,100,800,1700,-11600,-1200,-10200
4855,-3600,-6400,4800,11000,0,5800
4856,12000,-5800,2800,2000,0,11000
4857,-3000,11300,-2100,14200,-950,19450
4858,0,6500,-9900,-1000,0,-4400
4859,-3000,-2700,1000,12100,1950,9350
4860,0,8400,13000,-3000,-950,17450
4861,200,7400,-1100,-4700,2900,4700
4862,0,-5800,100,2200,-1200,-4700
4863,-800,-2600,1000,9000,0,6600
4864,-2700,6500,-1800,4000,0,6000
4865,9000,-8300,4800,1000,0,6500
4866,0,6700,-2600,-1000,0,3100
4867,-3000,-3400,1100,1400,-1200,-5100
4868,-5800,4500,4800,4000,0,7500
4869,8500,9400,-11700,-3000,-950,2250
4870,100,-8400,-200,14200,-950,4750
4871,-3600,-5500,14000,-4700,1700,1900
4872,-700,3700,2000,-3900,1950,3050
4873,10100,-5700,-4400,13200,-1200,12000
4874,-1800,-8000,1200,-2000,0,-10600
4875,-3800,6400,2900,-10000,-950,-5450
4876,11200,8500,1100,7200,-950,27050
4877,200,4500,100,-3900,2900,3800
4878,-3000,-1700,2800,-10700,1950,-10650
4879,-5500,-3600,3900,9000,0,3800
4880,11300,7800,-3400,-16800,0,-1100
4881,-2800,-9200,5800,11200,0,5000
4882,0,-9200,3900,-2000,0,-7300
4883,-2800,16700,1800,1200,0,16900
4884,-3700,6500,-800,-10000,0,-8000
4885,9100,-5400,-1100,14200,0,16800
4886,-2800,3600,3900,-11000,0,-6300
4887,-3000,3600,-5300,15200,-1200,9300
4888,11200,0,0,-2000,0,9200
4889,-900,9300,11100,2000,0,21500
4890,-2600,-2700,1000,8000,0,3700
4891,1000,-5700,-1100,1200,0,-4600
4892,-2800,9200,-9900,11000,0,7500
4893,-3800,-2600,2900,-2800,0,-6300
4894,6300,9300,2100,13200,-1200,29700
4895,-3600,400,-1700,-1000,0,-5900
4896,9100,-5300,200,11000,-950,14050
4897,-2700,200,8500,-800,-1200,4000
4898,-2700,-5600,4800,8100,1950,6550
4899,5500,-6200,4500,-4600,-950,-1750
4900,-3000,10200,-6900,3500,2900,6700
4901,8400,3800,3000,200,-1200,14200
4902,-5600,-5400,800,1200,0,-9000
4903,-700,1100,-8900,10000,-950,550
4904,9100,-5400,-1000,1400,0,4100
4905,-2900,4000,300,9100,1950,12450
4906,300,900,-8000,-3800,-2150,-12750
4907,-2800,-5600,3900,7100,2900,5500
4908,5500,-3200,13100,-1800,0,13600
4909,-12200,-2700,4900,14000,0,4000
4910,11200,1000,15000,0,0,27200
4911,9400,2700,3000,0,0,15100
4912,-3700,4300,4800,200,0,5600
4913,-1800,9300,2900,-15800,0,-5400
4914,8200,-3600,-10100,22400,-1200,15700
4915,200,-2600,0,-2000,0,-4400
4916,100,15500,-11800,15000,-950,17850
4917,-5700,-2800,13000,1000,-950,4550
4918,-700,-6200,3900,3300,2900,3200
4919,9300,-3600,15800,9300,750,31550
4920,-2900,12100,-3100,-800,0,5300
4921,0,0,-1800,12200,-1200,9200
4922,0,3500,3800,1000,0,8300
4923,-3700,3800,-100,3400,-2150,1250
4924,6500,-2700,2000,-1000,-950,3850
4925,200,-700,-1800,7100,2900,7700
4926,-3000,4400,3800,-11900,1950,-4750
4927,11300,-600,-3700,10000,0,17000
4928,-6300,-5600,3000,13000,0,4100
4929,-1600,-2600,-3700,-1000,0,-8900
4930,11400,2900,5800,3200,0,23300
4931,-3900,-5400,-100,3200,0,-6200
4932,1100,4000,-700,-3800,0,600
4933,-2900,8800,-2800,-2400,-1200,-500
4934,100,1700,3600,200,0,5600
4935,8500,-9200,2000,3000,-950,3350
4936,-5800,-5500,3900,13000,-950,4650
4937,-3700,21700,-4400,-13700,1700,1600
4938,6900,900,-10100,10300,1950,9950
4939,-2700,-2700,800,-5600,0,-10200
4940,5600,6500,2700,2200,0,17000
4941,100,900,400,13200,-1200,13400
4942,-5600,100,3900,-4800,0,-6400
4943,7400,800,2000,5000,-950,14250
4944,1000,-8300,10300,1000,0,4000
4945,-3600,1200,5900,-5700,1950,-250
4946,5300,-6300,3000,1000,0,3000
4947,-8400,4400,7600,1100,1950,6650
4948,9000,3700,2000,-8000,0,6700
4949,-800,-6100,200,7000,0,300
4950,9000,4400,2600,-6800,0,9200
4951,-2800,6500,-11800,12000,0,3900
4952,-2800,-3600,2900,-3000,0,-6500
4953,8300,7200,10500,4400,0,30400
4954,-5700,6400,1900,4000,0,6600
4955,11200,-5200,200,-2000,0,4200
4956,100,-6500,-1800,15000,0,6800
4957,-2800,4300,-7000,-800,0,-6300
4958,-2800,6500,-7100,10000,0,6600
4959,-3700,-3300,12100,200,0,5300
4960,6200,7300,1100,0,0,14600
4961,-3600,-2700,12500,1400,0,7600
4962,9100,-5600,1000,12000,0,16500
4963,200,6400,900,-12600,-1200,-6300
4964,0,3500,-7100,7400,-1200,2600
4965,200,-5500,-2700,14200,-1200,5000
4966,-5800,-3400,10100,1400,-1200,1100
4967,-800,-8300,3600,11400,-2150,3750
4968,9200,-6400,4800,-2900,1950,6650
4969,-2800,8500,800,11200,-1900,15800
4970,0,-2700,1000,-6700,1700,-6700
4971,-3700,11300,-4600,12100,1950,17050
4972,9200,7300,7600,-7600,-1900,14600
4973,100,100,-1900,-5700,1700,-5700
4974,-2800,12000,-4700,13700,-1650,16550
4975,-3500,-5300,4900,-5800,-950,-10650
4976,9000,-5300,-700,10100,1950,15050
4977,-3600,-6300,6700,-4800,-950,-8950
4978,-1800,-5800,2900,9500,-450,4350
4979,-3600,9500,-1700,-14700,750,-9750
4980,12100,5400,1900,14000,-950,32450
4981,-3800,10100,-1900,1100,1950,7450
4982,-1700,100,-900,-6700,750,-8450
4983,-3800,-5600,-10300,23400,-950,2750
4984,9100,-9200,6600,500,-450,6550
4985,-800,10000,11000,-15900,1950,6250
4986,1000,6300,-2100,300,1950,7450
4987,0,-2700,-1100,11400,-2150,5450
4988,-3600,-5400,1200,-5900,1950,-11750
4989,9000,6400,3500,500,1950,21350
4990,0,-6400,2900,-3000,0,-6500
4991,0,10000,0,-4900,1950,7050
4992,-2800,100,-2900,3400,-2400,-4600
4993,-1800,-5700,100,13000,0,5600
4994,2000,-2800,100,-3800,-1200,-5700
4995,0,700,3800,6200,-2150,8550
4996,-3000,-600,-1800,1000,-950,-5350
4997,11400,10100,-6500,-1900,1950,15050
4998,100,-11300,6600,8300,1950,5650
4999,-2900,-6300,100,0,-950,-10050
5000,200,-5600,5700,2300,2900,5500
5001,-2900,18600,-2100,-9700,1950,5850
5002,0,-6100,-700,10200,-1200,2200
5003,-3600,4400,4800,-13000,0,-7400
5004,9100,6500,1000,4000,0,20600
5005,-3800,-6300,2000,1000,-950,-8050
5006,200,10100,-3100,-1800,0,5400
5007,1000,3700,-100,-15700,1950,-9150
5008,0,-8200,-1600,8100,1950,250
5009,200,-6300,400,9600,0,3900
5010,-3800,7300,1100,-9800,0,-5200
5011,9000,3600,2000,13200,-10200,17600
5012,-3600,-6200,2900,-2000,0,-8900
5013,1000,4700,200,1000,12000,18900
5014,-3800,6400,-9900,2200,-1200,-6300
5015,11100,-8300,6700,6200,0,15700
5016,-2500,6300,12000,-10000,0,5800
5017,1000,-6400,2900,9200,-1200,5500
5018,-800,200,-4900,-1800,0,-7300
5019,-5500,18800,-700,1400,-2150,11850
5020,9400,-5500,-200,-800,0,2900
5021,-2800,-5500,3900,7300,750,3650
5022,-9300,6700,1200,3200,-2150,-350
5023,12000,1100,-9100,-3700,1950,2250
5024,100,-8300,2900,8000,0,2700
5025,-2800,900,0,-10700,1950,-10650
5026,11200,-6100,11300,10000,-950,25450
5027,-3600,4500,2900,-14900,2900,-8200
5028,1100,800,2900,0,0,4800
5029,0,-9000,1800,7400,-10200,-10000
5030,-2800,4600,3000,1200,-1200,4800
5031,-3600,6400,-100,-9000,12000,5700
5032,6400,-3600,4800,11000,0,18600
5033,0,4200,1900,-9000,-950,-3850
5034,-3800,9200,0,5000,-950,9450
5035,12000,-600,-1800,8300,1700,19600
5036,-2700,7600,-700,-12000,-950,-8750
5037,-3000,-2600,-800,10300,1700,5600
5038,-2800,-2600,2100,-3800,0,-7100
5039,4500,-3300,200,14000,0,15400
5040,-5600,-5500,-6300,10400,-2150,-9150
5041,12000,5800,200,11000,-950,28050
5042,-3000,-2700,14000,-2500,1700,7500
5043,-3900,5700,2900,9100,1950,15750
5044,12300,-2600,-1800,10000,0,17900
5045,-6600,4000,-10000,2400,-2150,-12350
5046,-2700,3900,200,6100,1950,9450
5047,11500,6600,10200,-12400,-3350,12550
5048,-5700,-3500,2700,7500,2900,3900
5049,1000,-5500,-4700,1200,-950,-8950
5050,100,2800,7600,6200,-950,15750
5051,0,1500,3000,-700,2900,6700
5052,-2600,-2100,4800,-14900,1950,-12850
5053,11300,-3500,1700,5800,-1200,14100
5054,-3000,4400,3800,-7000,0,-1800
5055,100,-3700,-900,9200,-2150,2550
5056,100,-800,-4900,-800,0,-6400
5057,-2800,13400,8500,-1500,750,18350
5058,100,6400,-2800,-7600,-3350,-7250
5059,200,9500,-14800,5300,2900,3100
5060,-6600,-2600,-700,2000,-950,-8850
5061,9000,-5500,17800,6600,-2150,25750
5062,100,-8300,1700,8300,1950,3750
5063,-3700,3700,3800,-15700,1950,-9950
5064,3400,-600,1100,14200,-2150,15950
5065,8400,7500,-700,-14900,1950,2250
5066,-2800,9400,200,-15500,750,-7950
5067,100,-8400,-200,13200,-950,3750
5068,8400,6500,-8900,-3900,2900,5000
5069,-2800,-5400,600,8500,1950,2850
5070,-5800,-3600,16800,-1800,0,5600
5071,-800,7200,3800,-3800,0,6400
5072,10400,-3600,-1800,14400,-2400,17000
5073,2100,7300,-3700,-15000,0,-9300
5074,0,-5500,4800,7200,-950,5550
5075,-900,6500,-8300,-1400,-1200,-5300
5076,1000,200,-2700,-6900,1950,-6450
5077,100,-8400,5600,21200,-1900,16600
5078,-5800,9200,-9000,-900,1950,-4550
5079,100,-2700,3700,14500,2900,18500
5080,-1700,-2900,-2800,13000,-950,4650
5081,-4600,6600,-2200,-1100,-8500,-9800
5082,11200,-5500,15900,4400,-1200,24800
5083,1000,-3600,1000,-2000,12000,8400
5084,0,-2600,13100,8600,-1200,17900
5085,-3000,-6200,200,1000,-950,-8950
5086,100,19300,1100,-3800,-950,15750
5087,-9300,6400,7600,-1700,2900,5900
5088,9000,100,-900,-3900,1950,6250
5089,-800,300,-12900,22200,0,8800
5090,9200,-2700,-3700,0,0,2800
5091,-3700,200,15000,4600,-1200,14900
5092,1000,-8400,1800,-600,0,-6200
5093,-2800,9300,-8000,7200,-950,4750
5094,8500,-5500,3800,-3000,0,3800
5095,100,-6500,9300,12100,1950,16950
5096,-2800,10000,3800,-4700,1950,8250
5097,0,9200,1600,-15600,0,-4800
5098,8200,0,-900,3000,0,10300
5099,-3000,-2700,100,13000,0,7400
5100,0,100,1000,6200,0,7300
5101,-3000,-5400,800,3200,0,-4400
5102,-8500,200,-800,14000,0,4900
5103,11200,3600,1700,-10800,0,5700
5104,-4600,-5500,2900,12000,0,4800
5105,9100,-3600,1000,0,0,6500
5106,1000,4800,-1700,1200,-1200,4100
5107,-9400,-3500,1800,3200,0,-7900
5108,12200,4300,-900,2000,0,17600
5109,100,6500,-8100,-2800,0,-4300
5110,0,-5500,2000,9000,0,5500
5111,0,-6100,13200,-3600,-1200,2300
5112,-3000,-5500,800,15200,0,7500
5113,100,15600,2000,-11800,-950,4950
5114,-2700,-3400,-2000,10200,0,2100
5115,8200,4900,-1600,-11900,1950,1550
5116,-5800,-5500,3900,14000,-950,5650
5117,11200,6600,-2600,-14900,2900,3200
5118,-5800,-400,1200,8400,0,3400
5119,100,-6100,2100,8800,-3600,1300
5120,-6100,7300,3900,-5000,0,100
5121,11100,700,-7100,14200,-2150,16750
5122,-2000,-8900,2100,1000,0,-7800
5123,100,1600,14700,-4700,1950,13650
5124,-4700,9300,2900,-14600,-1900,-9000
5125,7300,-600,-2000,11500,1700,17900
5126,-900,4500,1100,-15900,1950,-9250
5127,1300,-9400,-7400,18300,1950,4750
5128,-3000,7300,100,-8800,-1200,-5600
5129,8400,6700,-100,200,0,15200
5130,-3800,100,-900,24200,-950,18650
5131,-4700,-6200,1100,-1000,-950,-11750
5132,11300,-8300,13700,6500,1700,24900
5133,-3000,-9200,3300,2500,1950,-4450
5134,-3000,16600,200,4000,0,17800
5135,-3500,3700,4800,-13000,0,-8000
5136,9100,-6100,200,14200,-1200,16200
5137,0,7100,-1800,-8000,0,-2700
5138,-4300,-3500,1000,10000,0,3200
5139,12100,-6300,-700,-1800,-950,2350
5140,1000,13600,5700,-5900,1950,16350
5141,0,3500,-2000,5400,-2150,4750
5142,-2900,-6100,100,-1700,1700,-8900
5143,-2800,4500,3900,1400,-2400,4600
5144,-3700,6600,-8900,-1800,-950,-8750
5145,9300,3900,-7900,9000,-950,13350
5146,100,200,8300,-4900,1950,5650
5147,0,-2100,-7000,10100,1950,2950
5148,-5800,-2800,16500,-600,-950,6350
5149,11200,6600,-800,-3900,2900,16000
5150,-2800,-2700,-2900,300,1950,-6150
5151,0,-6400,13700,10400,-1200,16500
5152,-2800,-8400,6700,-3000,0,-7500
5153,-4700,11300,-3000,16200,0,19800
5154,13000,-6400,3800,9000,0,19400
5155,-3000,22200,-1800,-7000,0,10400
5156,-2900,-5400,1100,13000,0,5800
5157,-1800,-700,-3900,-1800,0,-8200
5158,-4600,4900,300,2000,0,2600
5159,6200,-3500,2700,-600,0,4800
5160,11300,4400,1900,1000,0,18600
5161,-2700,-8600,4800,2000,0,-4500
5162,100,6600,100,-3000,0,3800
5163,0,-3600,-2000,-800,0,-6400
5164,-2800,4300,5700,200,0,7400
5165,-3800,9600,-4500,-9000,0,-7700
5166,9300,-2800,1900,11000,0,19400
5167,-2800,-5800,2900,1400,-2400,-6700
5168,-2900,-6200,-1100,12200,0,2000
5169,8400,4400,2400,-9600,-950,4650
5170,-3000,3600,800,6200,0,7600
5171,0,-700,1900,-6700,1950,-3550
5172,0,-2500,-1700,10200,-2150,3850
5173,-3800,-5400,1100,11100,2900,5900
5174,9200,8500,2000,-2000,0,17700
5175,0,-5400,2100,8400,-2150,2950
5176,-900,-6100,-3500,2000,-950,-9450
5177,100,16300,2000,-3700,2900,17600
5178,1000,-8800,1200,-4900,1950,-9550
5179,0,-9300,2000,14200,-1200,5700
5180,-3000,13800,3000,-9000,0,4800
5181,0,-3600,1000,11000,-950,7450
5182,-3600,-3800,2600,400,0,-4400
5183,9200,19300,-1900,-900,1950,27650
5184,100,3800,-1000,2400,-2150,3150
5185,100,-9300,3800,-5700,2900,-8200
5186,-3000,7200,-800,3000,0,6400
5187,0,1000,4800,-12000,0,-6200
5188,100,-800,-3100,13200,0,9400
5189,-9400,7300,3000,-10000,0,-9100
5190,11100,-500,-800,8200,0,18000
5191,-5600,4500,2900,-7000,0,-5200
5192,9100,-2800,1900,10200,0,18400
5193,200,-2600,-800,-4000,0,-7200
5194,0,800,2000,5000,0,7800
5195,0,100,-1800,10000,0,8300
5196,-4700,3800,200,-9000,0,-9700
5197,10100,-6300,1000,14400,-2400,16800
5198,0,4700,2100,-14800,0,-8000
5199,-2900,-3400,100,12000,-950,4850
5200,100,4500,100,-600,-11400,-7300
5201,0,-6300,800,6300,1950,2750
5202,0,4700,3000,-11600,-3100,-7000
5203,-3500,3600,-11800,10100,14900,13300
5204,9500,-9100,5800,4300,750,11250
5205,0,4400,4800,-13600,-2150,-6550
5206,0,9400,200,8100,1950,19650
5207,-2700,9200,-11200,-2800,0,-7500
5208,-4700,-5600,14900,11300,750,16650
5209,10000,-3500,1000,-1900,1950,7550
5210,-900,-2700,8400,13000,-950,16850
5211,1100,-5400,-1800,-2000,0,-8100
5212,-1800,-11400,5700,10100,1950,4550
5213,-800,15800,1100,-15900,1950,2150
5214,-3600,-6200,2000,11000,0,3200
5215,-2800,4400,2900,-9600,-2400,-7500
5216,12000,6500,-19200,21200,0,20500
5217,-2900,-700,-2800,3000,0,-3400
5218,-2800,-5500,14700,10400,-2150,14650
5219,8500,-3500,2000,-2000,0,5000
5220,-2700,22300,-3000,-1700,1950,16850
5221,-800,-8600,13900,14200,-2150,16550
5222,-1800,-2500,-700,-5900,2900,-8000
5223,-3800,3600,1100,4200,-1200,3900
5224,6200,900,-2400,-2000,-950,1750
5225,-800,200,-2700,11000,-950,6750
5226,7200,6700,-1000,-13500,2900,2300
5227,-2600,-9200,12600,8500,1950,11250
5228,-700,4500,2900,-2000,0,4700
5229,11400,-9100,-1700,2000,0,2600
5230,-4500,-5600,1900,8200,0,0
5231,-7500,18800,-700,-7800,-1200,1600
5232,12300,-1900,-5200,11000,0,16200
5233,-3000,-5600,1700,1600,-3350,-8650
5234,-4400,3700,3900,-2000,-950,250
5235,7200,-3300,10100,-2500,1950,13450
5236,-900,-1400,7600,-2700,1950,4550
5237,-2000,-700,-1800,1000,-950,-4450
5238,11200,-6200,2000,7100,2900,17000
5239,-2800,16500,0,300,750,14750
5240,100,3700,-9900,-1000,0,-7100
5241,-3000,-6300,2900,14000,0,7600
5242,-3800,100,7200,1200,0,4700
5243,11200,6700,2000,-4600,0,15300
5244,-4800,9300,100,1000,0,5600
5245,-2900,-1700,3900,3000,0,2300
5246,11300,-9200,3800,-1800,-1200,2900
5247,-3900,4500,1100,5400,-2400,4700
5248,-8300,-600,1000,-3000,-950,-11850
5249,9200,-3500,2000,11200,-1200,17700
5250,200,19100,-2800,-2900,1950,15550
5251,-6400,-6100,1100,3200,-2150,-10350
5252,12100,1500,200,100,1950,15850
5253,200,-6200,2900,-5600,-3100,-11800
5254,100,4400,3800,-6700,2900,4500
5255,0,6600,-1100,-13700,1950,-6250
5256,0,-3500,-4100,10400,-950,1850
5257,-5700,7300,-8500,7700,1950,2750
5258,11400,-8400,1900,-5900,2900,1900
5259,0,-6300,16800,9200,0,19700
5260,-3000,-6400,3800,1000,0,-4600
5261,0,22100,-900,-600,-2400,18200
5262,-2900,3700,-9000,3200,-1200,-6200
5263,-5800,0,-200,14200,0,8200
5264,-1700,-3500,13000,-2800,-2150,2850
5265,10000,100,-4000,16200,-950,21350
5266,-2800,6500,1000,-2500,-450,1750
5267,8500,-2700,1100,3100,1950,11950
5268,-3000,9400,1100,-12200,-3350,-8050
5269,-900,-5500,4800,5300,1950,5650
5270,300,-2700,-3100,-6700,1950,-10250
5271,-3600,3700,2000,2200,-3100,1200
5272,3500,-3500,3900,-1700,1700,3900
5273,12300,7400,-11800,6100,1950,15950
5274,100,-5300,-800,-2000,-1900,-9900
5275,-5800,100,14000,8300,2900,19500
5276,-2800,6500,3900,-6700,1950,2850
5277,8200,-2800,100,0,-950,4550
5278,-900,-8500,2600,13300,2900,9400
5279,1000,9200,-900,-17900,1950,-6650
5280,0,-6300,2900,9000,0,5600
5281,0,-3600,-2700,3000,0,-3300
5282,-8600,-2500,2100,14000,0,5000
5283,11300,19200,100,-14000,0,16600
5284,-2800,-2600,800,11200,0,6600
5285,300,1100,-3600,-8800,-1200,-12200
5286,0,-5600,1100,10000,0,5500
5287,-3600,6400,-5200,9200,-950,5850
5288,11200,-3300,1800,-7400,0,2300
5289,1000,1600,16800,-4900,1950,16450
5290,-3000,-3600,1900,11200,-11150,-4650
5291,-3000,10100,-10900,10300,1700,8200
5292,-1700,400,-6700,-2800,0,-10800
5293,-1800,-5600,14900,13000,12000,32500
5294,9100,-9000,2000,14000,0,16100
5295,-2700,7400,-1700,-12000,0,-9000
5296,-2700,-6200,1800,10200,0,3100
5297,8500,-6200,-100,-800,0,1400
5298,-2800,14000,-6900,10000,0,14300
5299,0,3900,-700,-10600,-2400,-9800
5300,-6600,-6200,15000,11000,0,13200
5301,11200,7400,-1000,-14600,-950,2050
5302,-9300,-3200,1000,12600,-2150,-1050
5303,13100,-8400,100,9100,2900,16800
5304,-5500,18500,3900,-5700,-9200,2000
5305,-3500,6600,-700,1000,-950,2450
5306,12100,-8200,5800,-9700,14900,14900
5307,-800,1000,-8000,19300,-8250,3250
5308,1000,-8400,-100,11200,0,3700
5309,-7200,9300,1100,-3600,600,200
5310,13000,-9200,14700,10400,0,28900
5311,0,4400,3600,-12600,12000,7400
5312,-3500,6700,-3600,-800,-1200,-2400
5313,-3700,-6100,1100,-2800,0,-11500
5314,-1800,4500,3600,-600,0,5700
5315,6500,3400,4800,-8800,-2150,3750
5316,-3600,-3500,1100,10000,-950,3050
5317,9100,4600,1000,2100,2900,19700
5318,-2800,-9400,4800,-1900,1950,-7350
5319,100,200,-1800,9000,0,7500
5320,-6500,18600,-11000,2200,0,3300
5321,9100,-5500,-200,13200,0,16600
5322,100,6500,13000,-13800,0,5800
5323,0,-6300,1100,12000,0,6800
5324,0,-2500,1100,6200,0,4800
5325,100,5400,2900,9400,-10200,7600
5326,-6400,7500,-1800,3000,0,2300
5327,9000,-6300,1100,0,12000,15800
5328,-2800,-8300,6700,11000,0,6600
5329,11200,9500,-4500,-10000,0,6200
5330,0,900,3000,13000,0,16900
5331,-2800,6500,-100,-10800,0,-7200
5332,0,-11200,3000,13000,0,4800
5333,-2800,6400,2000,-10800,-1200,-6400
5334,-3800,9300,-6200,9400,0,8700
5335,9000,200,-3600,1000,-950,5650
5336,0,3700,15800,-3000,0,16500
5337,100,300,-5500,-4900,1950,-8050
5338,-2900,-8300,1700,15200,-950,4750
5339,-3600,-9200,5800,4300,1700,-1000
5340,9000,4600,-100,-3400,-2400,7700
5341,-2900,4000,200,2000,0,3300
5342,-2700,3600,3800,-13000,-950,-9250
5343,8300,-2700,-100,12600,-2150,15950
5344,-2900,3700,1900,-10700,1700,-6300
5345,-3900,6400,100,3000,-950,4650
5346,300,-2600,100,-4900,1950,-5150
5347,6200,-3500,2900,13000,-950,17650
5348,0,-2700,-5700,10300,2900,4800
5349,100,3800,4900,-6500,750,3050
5350,0,-9200,0,11400,0,2200
5351,-2800,-2700,4800,-6800,0,-7500
5352,-500,18500,-10000,6200,-950,13250
5353,11100,-3500,2900,-3400,-2400,4700
5354,100,7300,100,-4700,750,3550
5355,300,6600,9000,-15700,1000,1200
5356,1000,-8600,2900,13000,0,8300
5357,-3800,6600,-9000,-5700,1950,-9950
5358,-1800,200,200,6200,-950,3850
5359,100,-2000,3000,-10900,2900,-6900
5360,-2900,-5500,14000,11000,0,16600
5361,-3600,9600,-22800,21200,0,4400
5362,8200,3600,14000,-8000,0,17800
5363,1200,-2800,3700,5200,0,7300
5364,-2700,6400,3900,-2000,0,5600
5365,-4700,200,-2700,14000,0,6800
5366,3800,100,1900,-800,-1200,3800
5367,12000,-5500,13100,9000,0,28600
5368,-3800,-5400,1000,15000,0,6800
5369,1100,6400,-10000,-4000,-950,-7450
5370,-800,-5400,-4500,14000,-950,2350
5371,1100,-9100,15900,-5900,2900,4900
5372,5700,-5500,1100,11100,1950,14350
5373,-2800,6700,-700,-13000,0,-9800
5374,0,15800,-7000,-3600,-1200,4000
5375,-6600,-5600,3900,15000,0,6700
5376,12100,9500,13000,-19400,-1200,14000
5377,-6500,-3300,-2900,14200,0,1500
5378,12000,-1300,3000,3200,-10200,6700
5379,-5800,-6100,0,13200,-950,350
5380,100,1900,1100,1000,11050,15150
5381,-2700,3500,100,-11700,1700,-9100
5382,7300,-5900,-2500,10300,750,9950
5383,100,2200,-600,-11800,-1200,-11300
5384,-2000,-9200,5700,11000,-950,4550
5385,-2800,600,-4200,9400,-10200,-7200
5386,4700,6600,1000,11100,1950,25350
5387,100,1000,3000,-13000,11050,2150
5388,1100,-9100,10100,-2700,2900,2300
5389,-10900,10100,3000,-2000,0,200
5390,11200,3700,2700,-13600,-1200,2800
5391,10400,-6200,2000,9200,0,15400
5392,-1800,7400,200,-12000,-950,-7150
5393,-10300,6600,-7000,12200,-1200,300
5394,13000,1000,3000,-3900,1950,15050
5395,0,-8300,14700,-800,-950,4650
5396,-3000,3700,2000,1100,2900,6700
5397,-2800,-800,-100,-800,0,-4500
5398,8500,10400,-5600,-800,0,12500
5399,-3000,-8800,300,1000,0,-10500
5400,-3700,3600,4700,-1400,-1200,2000
5401,-3500,6400,4800,-3000,0,4700
5402,13100,-3500,2000,5200,0,16800
5403,-3800,9200,-9100,-800,-950,-5450
5404,1100,12200,1000,500,1950,16750
5405,-3800,-2800,13000,0,0,6400
5406,9000,-2700,-1100,11300,1950,18450
5407,0,3700,-7100,7200,-10200,-6400
5408,-3000,-700,-2700,15400,-2400,6600
5409,-900,7300,14900,-13800,12000,19500
5410,1000,-5500,2900,9000,0,7400
5411,-3600,0,-12200,22200,-950,5450
5412,12200,6300,-4600,-12900,1950,2950
5413,0,-5400,6700,3400,-950,3750
5414,-3000,-2800,11800,-1700,2900,7200
5415,0,3800,1100,1200,-1200,4900
5416,200,-8100,2100,-1800,-1200,-8800
5417,-3000,6400,1000,3000,0,7400
5418,-6600,-800,1900,2000,-950,-4450
5419,12100,10100,-2800,2000,0,21400
5420,-6600,-2800,3800,-2900,1950,-6550
5421,9000,0,0,14000,-950,22050
5422,100,100,-1800,-5900,2900,-4600
5423,-6700,-2800,3800,14400,-2400,6300
5424,9200,9300,-2800,4000,0,19700
5425,-2700,-2800,2800,-1000,-950,-4650
5426,-3800,100,-900,1000,0,-3600
5427,11200,-2700,-900,7100,1950,16650
5428,1000,-2400,-1600,-4800,-950,-8750
5429,0,6200,100,-15700,2900,-6500
5430,-5700,-2400,-1000,400,0,-8700
5431,-6300,0,-5500,16400,0,4600
5432,12000,-8400,-100,3400,-1200,5700
5433,0,-6400,16800,8200,0,18600
5434,-6400,-2700,3900,-2000,0,-7200
5435,11300,3600,-13700,1000,0,2200
5436,-2000,5900,-700,1000,0,4200
5437,0,1900,15000,200,-1200,15900
5438,100,800,4800,-12000,0,-6300
5439,-3000,-3600,1900,14000,0,9300
5440,-900,7400,-2000,2400,-2150,4750
5441,1100,3800,-2000,-12800,-950,-10850
5442,-2800,-6100,1200,7100,2900,2300
5443,-3700,1900,1200,-10900,1950,-9550
5444,9200,-1900,4000,3000,0,14300
5445,0,900,4800,-11000,0,-5300
5446,-3800,0,-1800,13000,0,7400
5447,12000,6500,2600,-13200,-2400,5500
5448,-3800,-3600,-900,13000,0,4700
5449,1000,7200,2800,-14800,-950,-4750
5450,-2900,-3300,-1800,13000,-950,4050
5451,0,-5400,-700,7100,2900,3900
5452,0,8400,2900,-5500,750,6550
5453,-6300,10200,-100,-2800,0,1000
5454,9000,-2600,-2200,1800,-2150,3850
5455,-3600,-2700,200,11000,-950,3950
5456,9200,-2000,-4200,-1900,2900,4000
5457,-2700,-2800,1900,8100,1950,6450
5458,-4600,-6300,13900,1200,-1200,3000
5459,6500,9300,-13700,12200,-1200,13100
5460,-1800,3900,4000,-2000,0,4100
5461,-3500,-6400,100,14000,-950,3250
5462,6400,7700,8400,4200,-2150,24550
5463,11200,3900,-1600,-13900,2900,2500
5464,-3000,-11900,6700,12100,1000,4900
5465,-5700,-2800,100,1000,0,-7400
5466,-800,3000,4900,4300,1950,13350
5467,7400,-9200,3800,1000,-950,2050
5468,-1000,6600,-400,8500,2900,16600
5469,0,1300,-1800,-9600,-1200,-11300
5470,-3800,-6300,1100,14000,0,5000
5471,9100,16500,2900,-12600,-1200,14700
5472,-2800,6700,-7000,8200,0,5100
5473,-6400,-3400,3000,-1000,0,-7800
5474,9000,4600,11000,2200,-950,25850
5475,-4500,6400,-17300,9200,-950,-7150
5476,7400,-9100,3800,11100,2900,16100
5477,-800,4700,9100,-14700,1950,250
5478,-2500,-500,200,6200,0,3400
5479,12000,4300,-800,-9000,0,6500
5480,0,3700,18700,4600,-10200,16800
5481,0,900,3000,-10000,0,-6100
5482,-3000,-6300,-7300,23200,12000,18600
5483,0,10400,-4500,0,0,5900
5484,-2900,800,4900,3000,0,5800
5485,-2800,-2700,2900,11000,0,8400
5486,11300,6600,-11800,-1800,-1200,3100
5487,0,-9100,15900,12000,0,18800
5488,0,4500,-1700,-11000,0,-8200
5489,200,-6400,14900,-2800,-1200,4700
5490,-3000,3700,1700,5200,0,7600
5491,-2900,-2700,-900,12000,-950,4550
5492,-6300,11500,-800,-2000,-950,1450
5493,12000,1800,-1600,2300,1700,16200
5494,-3800,-9200,4800,-2900,1950,-9150
5495,1000,4700,-800,0,0,4900
5496,-6500,-9200,4800,3000,0,-7900
5497,5300,-3100,300,11200,0,13700
5498,-5300,22100,-800,-12000,0,4000
5499,8500,700,4500,-12600,0,1100
5500,9000,-2800,2900,10200,0,19300
5501,0,6700,-800,-1000,0,4900
5502,-3000,6700,-11600,200,0,-7700
5503,0,-8600,4500,11400,0,7300
5504,-700,-2500,-4900,-2800,0,-10900
5505,-2800,-1900,16900,2000,0,14200
5506,12000,-9100,-1000,200,0,2100
5507,-5600,7200,3900,1000,0,6500
5508,-2800,-6200,1000,-800,0,-8800
5509,11200,-12100,3900,13000,0,16000
5510,-2700,6400,2600,12400,-1200,17500
5511,-2800,6800,-4600,-8000,0,-8600
5512,-2800,11400,-700,-3600,-2150,2150
5513,8300,1800,5800,-800,0,15100
5514,-5800,3800,-7900,-700,750,-9850
5515,-800,-3400,-1700,11000,-950,4150
5516,6200,7400,3900,-13700,1950,5750
5517,-3000,3700,13100,3000,0,16800
5518,11300,-2900,-4400,3500,-8250,-750
5519,-6700,4500,3900,4000,-950,4750
5520,-6500,900,4900,-13900,14900,300
5521,13100,-5300,-1700,10000,0,16100
5522,-9400,6600,300,3600,0,1100
5523,2700,6500,-8000,2000,0,3200
5524,12000,-8200,4900,6200,0,14900
5525,-4800,-3500,800,400,0,-7100
5526,2000,4400,13100,-1000,0,18500
5527,-3600,3700,5700,-13000,0,-7200
5528,6200,-700,100,12200,-1200,16600
5529,0,7300,-9000,-800,-1200,-3700
5530,-800,200,-1800,10000,0,7600
5531,1000,-5700,13100,-1800,-950,5650
5532,-2900,6700,-800,1200,0,4200
5533,8400,-5500,5800,4300,1950,14950
5534,100,-3700,-1900,2000,-950,-4450
5535,-2900,7400,200,-3700,2900,3900
5536,-3600,400,-3500,-1000,0,-7700
5537,12000,1000,5800,-1800,0,17000
5538,-3700,-5500,-11400,10400,0,-10200
5539,1000,3700,1100,-2000,0,3800
5540,200,-12100,2000,1000,0,-8900
5541,-3000,-2700,14000,10200,0,18500
5542,-7200,18500,3800,1200,-1200,15100
5543,13200,-3400,-1800,-3000,0,5000
5544,-5800,7300,2000,3000,0,6500
5545,11300,-6300,100,-3000,0,2100
5546,0,-8400,2900,14000,0,8500
5547,-5800,8600,-700,3200,-1200,4100
5548,100,4400,4700,-1000,0,8200
5549,-3600,9600,-6500,5000,-950,3550
5550,9200,-5400,-1600,2000,-950,3250
5551,0,-13800,6800,6100,2900,2000
5552,-7500,6500,-1000,-8500,750,-9750
5553,10300,-9100,3800,10000,0,15000
5554,-3600,4500,3900,-11800,-1200,-8200
5555,-2800,-6300,2900,10000,0,3800
5556,9000,4400,2900,-7600,-3350,5350
5557,0,-500,-3600,10000,0,5900
5558,-2900,-6400,1900,-900,1000,-7300
5559,-4800,5700,1700,11300,1950,15850
5560,10400,7400,-8900,9000,0,17900
5561,100,5800,200,-3900,1950,4150
5562,100,-5700,12700,-4500,1950,4550
5563,-2800,6400,2900,-14000,0,-7500
5564,0,11500,-3600,11000,0,18900
5565,-600,4600,100,-13000,0,-8900
5566,100,-3500,-800,9000,0,4800
5567,200,-8200,2100,-3800,0,-9700
5568,-2900,15700,-9800,14200,-1200,16000
5569,12300,-6400,3800,-5000,0,4700
5570,-3000,7700,10400,1200,0,16300
5571,-3800,3700,1000,-9000,0,-8100
5572,-1700,3700,-8100,10000,0,3900
5573,8400,-8500,3900,16200,-1200,18800
5574,-5600,3800,2000,-11800,-1200,-12800
5575,11200,-5400,13100,12200,-2150,28950
5576,-3000,-6300,2000,2000,-950,-6250
5577,-6500,-3600,1900,10100,1950,3850
5578,12000,9300,100,-4900,1950,18450
5579,-2900,1100,900,-6800,-950,-8650
5580,-3000,-8100,2100,-2900,2900,-9000
5581,-7400,18800,-12600,9100,1950,9850
5582,9300,-3600,1700,200,0,7600
5583,-8300,10400,10400,2000,0,14500
5584,6400,6500,2900,-14800,0,1000
5585,-1600,-2700,-1300,5600,0,0
5586,6300,-2800,3600,11000,-12600,5500
5587,-2500,-6200,3000,7000,0,1300
5588,12000,1900,3000,-9600,-3350,3950
5589,-2800,500,-13700,19200,12000,15200
5590,-6700,-6400,4800,-900,1000,-8200
5591,300,8700,-3500,-3000,-950,1550
5592,8300,7200,15900,-15500,1700,17600
5593,-4800,-5600,5700,-4900,1950,-7650
5594,11300,6600,-1200,10400,-11150,15950
5595,-4700,-6000,-3500,-900,2900,-12200
5596,-1600,4500,2000,-800,10800,14900
5597,9200,-6300,3900,-2000,0,4800
5598,-2900,4500,3800,2200,0,7600
5599,-5800,6600,1100,-9000,-950,-8050
5600,11200,6800,-12600,10000,-950,14450
5601,-2800,-5500,3900,-2900,2900,-4400
5602,-2700,-2600,2000,4500,750,1950
5603,8400,-3600,14000,11000,0,29800
5604,-3000,7400,2000,-1600,-10200,-5400
5605,-3000,-2800,2900,10200,0,7300
5606,11400,9400,-13800,-800,-1200,5000
5607,-3900,-2700,-2000,13200,12000,16600
5608,1000,-5400,11200,200,-2150,4850
5609,-3600,-3500,4800,6400,0,4100
5610,-3700,-2500,-3500,1000,-950,-9650
5611,7200,6500,-3600,-10300,2900,2700
5612,-6400,9600,1200,10500,-450,14450
5613,9200,-8200,100,9400,-11400,-900
5614,-4400,-3400,10000,400,-2150,450
5615,10000,1800,3000,-8000,0,6800
5616,-3000,3600,-8000,11100,13950,17650
5617,0,-6300,4800,-4800,-1900,-8200
5618,-6600,10100,-7100,-5700,2900,-6400
5619,7300,6600,6900,-8500,1950,14250
5620,1100,-5600,4800,3200,-950,2550
5621,200,-8600,13900,8300,-7300,6500
5622,-2900,3600,2800,4000,0,7500
5623,200,9200,0,-15000,12000,6400
5624,9100,-700,-1900,14000,0,20500
5625,-3000,300,-4800,13200,0,5700
5626,200,-5600,-1200,400,-1200,-7400
5627,0,6700,-700,12000,0,18000
5628,-2900,1000,4900,-12800,-950,-10750
5629,8600,-2600,1000,-5800,0,1200
5630,-6600,3800,900,2300,1950,2350
5631,6200,-3600,-7300,10200,-950,4550
5632,-2800,4500,3900,-1900,2900,6600
5633,8600,-6200,13700,-800,0,15300
5634,-3000,4700,-700,1000,0,2000
5635,100,-6000,-1700,-1000,0,-8600
5636,-6500,4700,200,5000,0,3400
5637,9100,3700,-8900,13000,0,16900
5638,-9200,-800,4800,-2000,0,-7200
5639,5500,7500,13200,2000,0,28200
5640,5700,9700,-9700,-6800,0,-1100
5641,200,-2800,2000,6200,0,5600
5642,5300,-2700,4600,-2400,0,4800
5643,-5500,-5600,16700,0,0,5600
5644,12000,-3500,-200,9200,0,17500
5645,-3900,4500,2000,-10000,0,-7400
5646,-2800,100,-5100,14400,0,6600
5647,8200,1000,-8900,1200,-1200,300
5648,1200,-9000,3900,9400,-2400,3100
5649,-5800,4500,15900,-9000,0,5600
5650,-800,3800,-12900,2200,-950,-8650
5651,9200,-6400,2700,11200,-950,15750
5652,-3000,4500,3900,-13700,2900,-5400
5653,-900,-3500,12100,-3900,1950,5750
5654,-1700,-3500,1000,10000,0,5800
5655,7300,19300,1000,-8800,-1200,17600
5656,-2000,-3500,100,1000,0,-4400
5657,-1600,7200,0,0,0,5600
5658,2000,-5500,2900,9000,-950,7450
5659,-2900,-700,-900,1200,-2150,-5450
5660,8300,7300,100,100,2900,18700
5661,-900,-2500,-1700,-4900,1950,-8050
5662,-2800,-9200,3800,11000,0,2800
5663,200,-2600,-800,-3000,0,-6200
5664,-2800,3700,2900,1000,0,4800
5665,12000,3500,2000,2000,0,19500
5666,-1800,9600,-4500,-1000,0,2300
5667,-3700,3700,-400,-9400,-1200,-11000
5668,-6600,-5200,-1000,15200,0,2400
5669,12200,-3200,-5400,-1000,0,2600
5670,0,-7900,1900,8400,-950,1450
5671,100,-200,2600,1200,-950,2750
5672,200,-13900,-100,-700,2900,-11600
5673,-700,3600,0,-3900,1950,950
5674,-2800,10500,1200,-8000,0,900
5675,1100,-8200,900,9200,0,3000
5676,200,-2000,-1100,-8800,0,-11700
5677,-9300,4000,-7900,14000,0,800
5678,9000,-8900,2100,2000,0,4200
5679,-800,4400,11900,1200,0,16700
5680,9100,-9200,5700,1200,-1200,5600
5681,-3600,-2600,100,11000,0,4900
5682,200,1100,-2500,-9800,-1200,-12200
5683,-2000,13000,2100,-9000,0,4100
5684,11300,-9200,3800,9000,-950,13950
5685,-7600,7300,2000,-5400,-3600,-7300
5686,-3800,6600,-8900,7300,1950,3150
5687,-3500,3800,-7900,-2000,-1900,-11500
5688,5400,-3300,11000,10300,2900,26300
5689,12000,7500,-700,-17700,1950,3050
5690,-3800,-9000,5800,8200,0,1200
5691,-4700,7500,9200,-2300,750,10450
5692,8600,-2200,4700,-8800,-1200,1100
5693,100,-9100,-5400,20400,-1200,4800
5694,-900,1700,-700,-8000,-950,-8850
5695,-2900,900,4800,3200,-2150,3850
5696,12400,-8200,13100,-6900,1950,12350
5697,0,-2100,3700,500,1950,4050
5698,-2900,-9100,2900,-1000,-950,-11050
5699,100,1800,-100,-2700,2900,2000
5700,-8500,6500,3900,300,750,2950
5701,8300,-3500,200,-2800,0,2200
5702,-800,1700,1700,-1800,0,800
5703,-2700,-11800,3900,-1000,-950,-12550
5704,12100,-8300,2900,8500,-450,14750
5705,-3700,13000,4900,-11000,-950,2250
5706,1100,-6100,-1700,6100,1950,1350
5707,0,-6400,2900,-2000,0,-5500
5708,0,3700,3900,8100,1950,17650
5709,-6600,6400,-6400,1200,-950,-6350
5710,9000,-600,-3600,10100,2900,17800
5711,-2700,19400,11600,400,0,28700
5712,-4700,3600,2000,-9000,0,-8100
5713,13100,-3500,2800,8400,-1200,19600
5714,0,1500,1100,-10000,0,-7400
5715,0,6800,-9800,17400,-10200,4200
5716,-3000,6500,-8900,400,-1200,-6200
5717,-3000,-5600,3800,12000,0,7200
5718,0,9300,1100,-1800,10800,19400
5719,-6600,-700,100,15000,-950,6850
5720,9100,7300,12000,-9000,-950,18450
5721,100,3600,1900,-13700,1700,-6400
5722,-4600,-3500,-1100,10500,750,2050
5723,10000,4600,12200,3000,-950,28850
5724,-2800,6400,2900,-10000,0,-3500
5725,-3000,-3400,-200,10500,750,4650
5726,11200,-2700,-800,-800,-2150,4750
5727,-3000,18700,-7900,5700,750,14250
5728,-3000,-2700,-7300,8600,-1200,-5600
5729,0,-3600,1000,10000,-950,6450
5730,-3800,9300,13000,-13700,1950,6750
5731,11100,9000,0,11100,1950,33150
5732,1000,9300,-12000,-1800,-950,-4450
5733,-5700,6400,5800,9300,1700,17500
5734,-3000,0,-2400,11500,1950,8050
5735,-600,-3300,8400,-2000,0,2500
5736,9100,-5500,2000,12000,-950,16650
5737,0,10000,15900,-8000,-950,16950
5738,-2800,-3400,-1900,8300,2900,3100
5739,0,1400,-8300,-700,1950,-5650
5740,0,-6300,3800,11200,-1200,7500
5741,-3600,6500,14000,-11000,0,5900
5742,7300,10200,-2800,3000,0,17700
5743,2000,6600,-800,-13000,0,-5200
5744,-900,-8400,3900,11200,-1200,4600
5745,100,700,-8300,1200,0,-6300
5746,1100,-2700,-5800,12200,-950,3850
5747,0,3800,-700,-12000,0,-8900
5748,-5600,-3400,15900,11000,-950,16950
5749,11200,-8200,2100,-4900,1950,2150
5750,-2900,1000,1100,100,2900,2200
5751,0,2900,3600,9400,-10200,5700
5752,-2700,4500,-1700,1000,0,1100
5753,0,800,9400,-13800,12000,8400
5754,-3800,9200,-10000,14000,0,9400
5755,12000,0,-1200,8400,-10200,9000
5756,0,9300,-900,0,0,8400
5757,-3800,200,8300,2000,12000,18700
5758,1100,-5800,1900,8200,0,5400
5759,0,-2800,2900,8200,0,8300
5760,-6600,-3600,3800,3000,0,-3400
5761,9000,-600,-1800,0,0,6600
5762,0,22100,-1800,-11000,0,9300
5763,-2800,-5800,3800,14000,0,9200
5764,-2900,200,-2800,2200,-1200,-4500
5765,-700,-5600,1900,9000,0,4600
5766,9000,-2600,-800,4200,-1200,8600
5767,-2900,-6000,-3500,1000,0,-11400
5768,0,1000,-6100,-1000,-950,-7050
5769,100,9500,-3600,-1000,0,5000
5770,-3900,6600,2100,-17500,1950,-10750
5771,12200,900,6800,-3000,0,16900
5772,-2800,-5200,-3900,12300,1950,2350
5773,-2800,4000,-11100,-1600,0,-11500
5774,-3600,-6400,15900,-1800,-1200,2900
5775,-2800,4400,4800,-800,0,5600
5776,9300,6500,1200,-800,-1200,15000
5777,0,-5500,4800,6200,0,5500
5778,-6600,800,7600,-9000,0,-7200
5779,12000,-6300,11200,15200,-2150,29950
5780,100,6400,-900,-11800,-2150,-8350
5781,-3000,7300,1000,1100,2900,9300
5782,5400,-3400,2000,11100,1950,17050
5783,-3000,7300,-1700,-8800,-2150,-8350
5784,0,-5300,3900,9400,-2150,5850
5785,-4700,-3400,-2600,-2900,2900,-10700
5786,6300,-2800,4700,7500,750,16450
5787,1000,-2800,3800,-3800,-950,-2750
5788,-2900,21200,0,2000,-950,19350
5789,11300,300,-3900,6300,2900,16900
5790,-5600,-2600,100,-900,1950,-7050
5791,0,-2500,-700,8200,0,5000
5792,-4500,-5400,3000,-3000,0,-9900
5793,7200,-3600,3900,11200,0,18700
5794,-3700,-6200,0,2000,0,-7900
5795,11400,6600,-900,9000,0,26100
5796,-2800,-5400,-900,2000,0,-7100
5797,-1800,18500,1100,1200,-1200,17800
5798,0,-6300,2000,-1800,-1200,-7300
5799,-6600,-5500,3900,13000,-950,3850
5800,9300,3700,-7300,-600,-1200,3900
5801,200,5700,-2100,-5700,1950,50
5802,0,4200,13700,-8400,-3100,6400
5803,-6400,6400,200,-11900,2900,-8800
5804,7600,-5300,1000,6100,1950,11350
5805,2000,6500,-900,1000,0,8600
5806,-3000,-9200,4800,-2900,1950,-8350
5807,-3500,4500,-6300,9400,-1200,2900
5808,9100,3700,1000,-8000,0,5800
5809,0,-3000,8700,15400,-950,20150
5810,0,-3600,-800,-3000,0,-7400
5811,-3700,-5400,5700,8300,1950,6850
5812,9000,21400,-3600,-10900,1950,17850
5813,100,-5300,2000,14800,-12600,-1000
5814,-6600,-3400,-100,15200,0,5100
5815,9000,4400,1100,-9000,11050,16550
5816,-5400,-600,700,7600,-1200,1100
5817,4500,10100,1100,-13700,1950,3950
5818,1100,-8400,3900,9200,-950,4850
5819,-6400,-2600,2100,-6900,2900,-10900
5820,5400,-3400,1100,25200,-10200,18100
5821,6200,-2800,2600,1200,0,7200
5822,200,18500,-900,-14000,12000,15800
5823,-5500,-5600,2000,2000,0,-7100
5824,8200,-3400,-1700,14200,-1200,16100
5825,-2700,-5400,2900,-2000,0,-7200
5826,8300,8600,-3600,2000,-950,14350
5827,-7600,4600,3000,-8800,-2150,-10950
5828,13200,-11800,4600,6300,2900,15200
5829,-3000,4400,3900,-12700,1950,-5450
5830,-1600,3600,-10900,11000,0,2100
5831,2000,-3400,1100,-6800,0,-7100
5832,100,1500,13000,5000,0,19600
5833,-3900,9400,-2600,-12800,0,-9900
5834,-2500,3700,-6200,8000,0,3000
5835,9100,-6300,800,3200,0,6800
5836,-5700,7300,4900,13200,-1200,18500
5837,-500,-8500,-1900,12000,0,1100
5838,9400,6900,8500,-10800,-1200,12800
5839,-8300,3400,6600,-11000,-950,-10250
5840,-500,-3500,-1900,11400,-3350,2150
5841,9100,4500,3000,-14700,2900,4800
5842,-3000,-5600,2000,11300,-200,4500
5843,5500,6700,600,-400,0,12400
5844,100,-3600,-2000,-3700,1950,-7250
5845,-3800,1800,3000,4000,-1900,3100
5846,9100,-3300,1800,-9100,1700,200
5847,-5600,-2800,4800,8100,1950,6450
5848,8400,-600,-1700,-3900,1950,4150
5849,-2900,16800,100,3000,0,17000
5850,-2800,100,-1100,10200,0,6400
5851,7300,-5400,200,2000,0,4100
5852,-1800,-3500,3900,6200,0,4800
5853,-6600,4800,300,-7000,0,-8500
5854,7200,-3600,2000,11200,0,16800
5855,-3300,1500,4700,-11000,0,-8100
5856,14000,-6100,200,10000,0,18100
5857,-3000,7400,-1000,-11600,0,-8200
5858,100,-9000,-100,9200,0,200
5859,-2900,-9100,2900,1000,0,-8100
5860,-3000,16700,-1600,4200,-1200,15100
5861,11200,3800,5800,-5600,0,15200
5862,-10400,-3500,3900,2000,0,-8000
5863,1300,4300,1000,1000,-950,6650
5864,9300,9300,-900,-12000,0,5700
5865,-3900,-5100,-2500,10100,1950,550
5866,-1900,-2000,4700,-11000,-950,-11150
5867,10400,-9200,-9700,19900,1700,13100
5868,-1800,7300,-1800,2000,0,5700
5869,-9500,6700,3700,-10600,0,-9700
5870,9600,-800,10100,8000,0,26900
5871,-3400,4600,1700,-11600,0,-8700
5872,8100,-800,100,9400,-1200,15600
5873,1200,1800,2900,-13000,0,-7100
5874,-2900,-11100,4900,13000,0,3900
5875,200,3700,900,0,-950,3850
5876,-3600,-600,-6500,1000,0,-9700
5877,12100,4500,800,-4500,1950,14850
5878,-900,3700,-9200,-4700,1950,-9150
5879,-2000,-9100,6700,10200,0,5800
5880,-2800,7200,12900,-11800,0,5500
5881,-2800,-3600,2000,10000,0,5600
5882,-3800,-5500,5700,200,0,-3400
5883,9000,21300,-900,3000,0,32400
5884,0,-6300,2000,-2000,0,-6300
5885,-3700,10200,-2800,5200,-1200,7700
5886,12100,-5600,-2600,1200,-1200,3900
5887,100,-8200,5800,6200,0,3900
5888,-2900,3600,1900,-7000,-950,-5350
5889,-2800,9400,100,1000,0,7700
5890,-2800,-2600,200,-4900,1950,-8150
5891,8400,-3600,2600,11200,0,18600
5892,100,-5700,-4200,9500,1950,1650
5893,0,6500,800,-400,-2400,4500
5894,200,600,-9000,12000,0,3800
5895,100,-9200,3800,1400,-1200,-5100
5896,0,4300,11200,1000,-950,15550
5897,-2700,-3500,3800,-5800,-950,-9150
5898,-3800,-3000,-5300,13300,1700,2900
5899,12000,3800,3000,-4900,1950,15850
5900,-3700,-6300,3900,11000,-950,3950
5901,-2000,-9200,3900,1200,-1200,-7300
5902,100,19500,-1700,-4900,1950,14950
5903,-2800,6700,300,-11400,-2150,-9350
5904,-11000,8500,700,10300,2900,11400
5905,10400,4500,3000,-2000,-950,14950
5906,12100,3600,1900,-10000,0,7600
5907,-2900,-6200,-12200,20500,1950,1150
5908,0,-5300,200,-2000,0,-7100
5909,-6600,-6400,16800,12100,1950,17850
5910,11200,6700,-1000,10200,0,27100
5911,-4800,6600,200,-11000,0,-9000
5912,-1700,2900,5800,7200,0,14200
5913,10000,4400,2900,-8000,0,9300
5914,-2900,6500,900,2000,0,6500
5915,0,-600,-2700,-800,-1200,-5300
5916,0,4400,2900,-9800,-1200,-3700
5917,0,-5200,-700,10000,0,4100
5918,0,-9300,2000,15000,-950,6750
5919,-3000,15600,-6200,2000,-950,7450
5920,11300,0,0,6100,2900,20300
5921,-2700,9300,-12800,-1900,1950,-6150
5922,-3900,-2400,-800,23200,0,16100
5923,100,-2400,-1600,-5800,0,-9700
5924,-1700,-11200,15800,15000,0,17900
5925,-800,3700,1100,-12000,0,-8000
5926,8400,-6400,14600,11400,-1200,26800
5927,-4800,-6300,1800,1200,0,-8100
5928,8400,13600,3000,4000,0,29000
5929,-900,800,2700,-11800,0,-9200
5930,-2000,-3600,2800,13000,0,10200
5931,0,10200,-3900,-800,0,5500
5932,0,3700,800,-9800,0,-5300
5933,-7500,-6300,3900,14000,0,4100
5934,13100,7300,0,-13000,0,7400
5935,100,-6400,-1800,14200,-1200,4900
5936,0,-5400,200,-1000,0,-6200
5937,-3900,15600,3900,1200,-950,15850
5938,1100,-6300,2800,-2800,-1200,-6400
5939,0,7200,-3900,2300,1950,7550
5940,-3600,3600,-1300,-9600,-950,-11850
5941,12000,-5500,-1000,7300,2900,15700
5942,-5600,-800,3700,-1400,-1200,-5300
5943,-3000,-8300,3900,12000,0,4600
5944,11200,5800,-1900,10600,-3350,22350
5945,-3000,1600,4500,-6800,0,-3700
5946,-900,-600,100,3300,1950,3850
5947,100,-9200,3600,-800,-1900,-8200
5948,1000,16300,1000,-900,2900,20300
5949,-5800,9400,-10800,-1900,1950,-7150
5950,11200,-6000,-700,10000,-950,13550
5951,-3800,4400,15900,-14700,2900,4700
5952,-4800,-2600,2000,11000,0,5600
5953,-3600,6600,1100,-9600,-2400,-7900
5954,12000,200,-3900,11200,0,19500
5955,-7300,-3500,200,-800,-2150,-13550
5956,10400,7500,-800,0,0,17100
5957,-900,-11400,3600,12300,1950,5550
5958,-2700,700,-8900,1000,-950,-10850
5959,1000,-9000,2100,7300,1700,3100
5960,0,1700,16500,-10800,0,7400
5961,-7400,6400,2900,0,-950,950
5962,13000,-800,-1900,-2000,0,8300
5963,-2900,-5400,-1100,12500,750,3850
5964,100,-6400,2000,8000,-950,2750
5965,100,2600,4700,-3900,2900,6400
5966,100,7200,-2800,4000,0,8500
5967,0,3700,-100,-10800,0,-7200
5968,0,5700,2000,10000,0,17700
5969,-6500,7400,2000,-9800,-1200,-8100
5970,12000,-3500,100,10000,0,18600
5971,-2800,10000,700,-13800,-950,-6850
5972,-3700,-3600,0,17600,-3600,6700
5973,1700,10200,-800,-10900,1950,2150
5974,13200,-2100,-6200,7000,-1900,10000
5975,-8600,200,3900,-2500,1700,-5300
5976,10500,-11100,-800,11100,1950,11650
5977,-1800,3600,-6100,8000,-1900,1800
5978,-5700,-5400,3900,-3700,2900,-8000
5979,-3500,800,-6200,8300,750,150
5980,9300,-6300,15900,-4600,-1200,13100
5981,0,1600,2000,100,1950,5650
5982,-3000,3800,3100,1000,-950,3950
5983,-1600,-6200,-800,9000,0,400
5984,9100,4600,-100,2700,-450,15850
5985,-5500,6600,0,1200,-950,1350
5986,11200,3800,100,-2900,2900,15100
5987,-1700,-9200,13100,1200,-2150,1250
5988,-3000,4400,2000,3000,0,6400
5989,-900,-1800,-5400,-3500,750,-10850
5990,-8200,6300,-5200,8100,1950,2950
5991,7600,-2700,1000,12000,0,17900
5992,13200,-3600,8300,-2000,-950,14950
5993,0,-6400,2000,11000,-950,5650
5994,-5800,9500,14000,-1900,2900,18700
5995,0,3700,-100,-2500,750,1850
5996,-3800,5600,2900,4400,-2400,6700
5997,9200,7400,800,1200,0,18600
5998,300,6700,-5600,-11000,-950,-10550
5999,-2900,-5600,2900,10200,0,4600
6000,-6600,3700,3600,-10700,1950,-8050
6001,11200,-9100,3900,10000,-950,15050
6002,-2000,4600,-2900,1300,2900,3900
6003,0,-11700,5900,-3800,0,-9600
6004,-3800,-3300,2100,7400,0,2400
6005,12100,4400,-800,-10000,0,5700
6006,-2900,15700,2000,1000,0,15800
6007,-2600,-6200,200,-2000,0,-10600
6008,-3000,-5600,2600,15200,0,9200
6009,8400,-3500,1700,10200,0,16800
6010,100,2600,2900,1000,0,6600
6011,100,10100,-1900,0,0,8300
6012,0,21200,-3000,-11800,0,6400
6013,-2700,-2200,-1900,10600,-1200,2600
6014,-6500,6600,-8900,0,0,-8800
6015,8400,-2500,-800,10200,-1200,14100
6016,-1800,-5500,13200,-1800,-950,3150
6017,5400,-3400,200,14200,-2150,14250
6018,-4500,1600,6700,-13900,2900,-7200
6019,10400,-9200,0,12100,1000,14300
6020,-3600,-9400,2900,200,-2150,-12050
6021,-2500,7300,-1200,-1700,2900,4800
6022,12000,12800,200,-11900,1950,15050
6023,0,-8100,900,11400,-1200,3000
6024,0,3700,200,200,-1200,2900
6025,-5600,-600,3000,-2800,-950,-6950
6026,-7500,-9000,5800,13000,0,2300
6027,13100,16500,3000,-19500,750,13850
6028,-3000,6500,-1100,6400,-2150,6650
6029,100,-3500,1000,1500,-8250,-9150
6030,-6300,10000,-4300,7200,0,6600
6031,12000,-6400,100,8500,-9450,4750
6032,-2800,10000,9200,3000,11050,30450
6033,-3000,-5500,1700,-1700,1950,-6550
6034,11200,-6200,800,12200,0,18000
6035,-5700,-2800,1900,10100,13950,17450
6036,-3500,6400,1900,-12000,-950,-8150
6037,9300,12100,-1800,7300,1700,28600
6038,100,-3000,-300,400,0,-2800
6039,-5800,-6400,4800,13000,0,5600
6040,-4500,7300,800,-10600,-1200,-8200
6041,12200,-3300,-3000,12400,-1200,17100
6042,-1800,300,-4500,-1000,0,-7000
6043,-2800,6400,4800,12200,-2150,18450
6044,7600,9200,-10500,-3400,-950,1950
6045,-4800,-5400,4600,-3300,1700,-7200
6046,-600,-5500,-2000,-6700,1000,-13800
6047,12000,-8300,15900,12000,-950,30650
6048,-800,1000,2900,-14900,2900,-8900
6049,1000,-700,-4800,-4700,1950,-7250
6050,-5800,-5300,4900,11400,-1200,4000
6051,-3000,13000,-8400,1400,0,3000
6052,5600,6400,-6100,9000,0,14900
6053,-3300,6600,-11200,200,-950,-8650
6054,9000,100,10200,13000,-950,31350
6055,-2600,-5300,2100,-6900,2900,-9800
6056,-900,1000,1700,-2500,1950,1250
6057,1100,-5300,-11000,8400,-1200,-8000
6058,100,1200,1300,-2000,0,600
6059,-5500,-3800,2000,1200,-1200,-7300
6060,4700,-2800,3900,-2000,0,3800
6061,6500,3700,15800,-10800,-950,14250
6062,-3000,6500,2000,1000,0,6500
6063,11200,-12000,18400,7300,1950,26850
6064,0,-3700,-1800,2000,-950,-4450
6065,100,6600,100,8100,2900,17800
6066,-700,3700,12900,-11000,0,4900
6067,100,-3500,-3600,0,0,-7000
6068,-1800,13700,3700,200,0,15800
6069,0,800,3900,-11000,0,-6300
6070,-3000,-700,1900,-800,0,-2600
6071,-3900,7400,-11700,12000,0,3800
6072,200,-3500,-2000,10200,0,4900
6073,12100,-12000,15900,1000,0,17000
6074,-3000,22200,-800,400,-1200,17600
6075,0,3700,4800,-13800,0,-5300
6076,0,-2700,1000,10000,0,8300
6077,-3000,9200,-1800,-8600,-2400,-6600
6078,200,-5500,3800,9000,0,7500
6079,-2800,-300,-4400,-2000,-950,-10450
6080,-3800,-5300,-1000,14400,-2150,2150
6081,12100,3700,3000,-4900,2900,16800
6082,-3000,4000,1200,-700,1000,2500
6083,0,-8600,4800,-1800,-950,-6550
6084,100,6600,-10200,3500,2900,2900
6085,-5600,6200,-8200,300,1950,-5350
6086,-600,-5500,0,8200,-1200,900
6087,9200,6400,12800,-10600,-1200,16600
6088,-3600,-3400,-1000,12400,0,4400
6089,9200,4500,15900,-1000,-950,27650
6090,-3000,-8400,4800,1000,0,-5600
6091,-3000,9300,-900,-9700,750,-3550
6092,-800,-3400,-1700,11000,-950,4150
6093,8200,7400,-900,1100,2900,18700
6094,1200,-8300,2900,-800,-1200,-6200
6095,-3700,-6100,2100,12000,0,4300
6096,300,10100,-4500,-13000,-950,-8050
6097,-2600,3900,-4200,6200,-950,2350
6098,9300,-2500,-700,-4700,1700,3100
6099,-5800,3600,19600,-4700,1950,14650
6100,11400,-3000,-1900,2400,-2400,6500
6101,200,3700,-8100,10000,0,5800
6102,-3000,100,-1800,2000,-950,-3650
6103,-900,3900,12200,0,0,15200
6104,100,-8300,-700,-1900,1950,-8850
6105,-1800,800,3900,4400,-3350,3950
6106,-800,-6400,1000,-4700,1700,-9200
6107,-3700,-2700,2000,9200,-950,3850
6108,13000,6500,1900,200,-2150,19450
6109,-900,11400,-2700,-7900,1950,1850
6110,1100,1500,800,1500,750,5650
6111,-2800,-5500,5800,-3800,-950,-7250
6112,-900,9400,-12900,5300,1950,2850
6113,1000,-8600,700,1300,1950,-3650
6114,0,-2600,11200,10000,-950,17650
6115,-3800,-3500,100,-5500,1700,-11000
6116,-2700,1300,200,1300,750,850
6117,9200,2700,2100,1000,0,15000
6118,200,1700,5700,-4800,-950,1850
6119,-5600,6400,-300,5400,-1200,4700
6120,8400,-6300,-700,-900,1950,2450
6121,0,7200,2900,-2800,-950,6350
6122,0,800,5700,-14900,2900,-5500
6123,0,-600,-1800,11000,0,8600
6124,-3800,200,-4600,1000,0,-7200
6125,-1900,-8100,2000,12000,0,4000
6126,8200,5800,-1000,3200,0,16200
6127,200,4500,100,200,-1200,3800
6128,-9300,6400,7600,-12000,0,-7300
6129,5500,-3500,2000,13000,-950,16050
6130,200,7800,-4400,-13000,0,-9400
6131,9000,-6200,1100,12100,1950,17950
6132,-6600,10000,1900,-10800,-950,-6450
6133,9500,-2700,2900,2500,1700,13900
6134,-2800,-2600,-1800,-2800,0,-10000
6135,-2900,3800,-10800,13200,-1200,2100
6136,-1600,-8300,3800,9200,-1200,1900
6137,10000,900,-7900,2000,-950,4050
6138,-2800,-3100,15100,2400,-950,10650
6139,100,-5600,1000,-3500,500,-7500
6140,-9400,-6200,5500,22900,-450,12350
6141,8400,8800,-3500,-1000,-950,11750
6142,-3500,7200,4800,-2800,0,5700
6143,10100,13100,5000,-3900,1950,26250
6144,-6300,6900,-11600,11000,-1900,-1900
6145,5500,-2600,-2900,500,1700,2200
6146,8300,-8300,18700,7100,1950,27750
6147,-4500,6400,3800,-13000,-950,-8250
6148,5400,-3400,11900,10300,1950,26150
6149,-3800,1600,3900,-10900,1950,-7250
6150,-5800,6400,-6200,14000,0,8400
6151,11200,0,0,6100,1950,19250
6152,1100,6300,-13100,2200,0,-3500
6153,-2900,-5500,12200,12000,0,15800
6154,11300,-5500,3800,-3000,0,6600
6155,-800,9300,10100,0,0,18600
6156,-1800,0,-200,-4800,0,-6800
6157,-3000,-2700,-800,16200,-1200,8500
6158,-900,3800,2900,-13000,0,-7200
6159,1100,-2700,-1800,10000,0,6600
6160,-3700,-8200,3900,2000,0,-6000
6161,8300,3700,-700,2000,0,13300
6162,1000,-8800,1200,-2000,0,-8600
6163,-3000,1800,-7000,15000,0,6800
6164,-3000,-500,-3500,-2800,0,-9800
6165,8400,4500,18700,400,-1200,30800
6166,-6600,3700,3900,3000,0,4000
6167,12000,-800,0,6400,-12350,5250
6168,-2900,100,-1900,14000,-950,8350
6169,-3000,16300,-14300,-900,14900,13000
6170,-4800,-5500,1100,-1900,1950,-9150
6171,300,3700,4100,-6800,0,1300
6172,7300,-5500,2400,1400,0,5600
6173,-3000,-1700,16900,-8800,-1200,2200
6174,-4500,9400,-800,-11000,0,-6900
6175,12100,-5400,200,10200,-2150,14950
6176,-2000,-6400,4800,-1600,-1200,-6400
6177,0,-6400,3800,8100,1950,7450
6178,0,9100,-900,15000,-1900,21300
6179,-3000,-700,-1800,-2700,1700,-6500
6180,-700,9200,-6400,500,1950,4550
6181,9100,100,-2100,3400,-1200,9300
6182,-3900,9300,12100,-3900,1950,15550
6183,1100,-2800,-1200,8400,-11150,-5650
6184,-3700,-6300,1000,2000,-950,-7950
6185,9100,-6100,1100,-1900,14900,17100
6186,-800,19400,-1700,-14900,1950,3950
6187,-1800,-8400,5800,-2000,0,-6400
6188,200,6400,800,9200,-10200,6400
6189,100,-3600,1000,-2000,0,-4500
6190,-4700,7400,100,5000,12000,19800
6191,6300,6500,2000,-11000,0,3800
6192,-1800,0,-900,10000,0,7300
6193,8400,-2400,-6000,2600,-1200,1400
6194,-8500,-5400,4800,14000,0,4900
6195,9500,3700,1100,-12000,0,2300
6196,-1900,-5300,-2600,2000,0,-7800
6197,-5600,1000,4900,2000,0,2300
6198,9200,-800,3800,-3800,0,8400
6199,-7500,-2500,200,14200,-1200,3200
6200,10000,5600,2900,0,0,18500
6201,100,-5400,-200,-800,0,-6300
6202,200,9300,-3700,12000,-950,16850
6203,-3800,800,5700,-9000,-950,-7250
6204,8400,6500,-8000,-4900,2900,4900
6205,-5600,-2600,2000,11100,1950,6850
6206,9100,6600,-700,0,0,15000
6207,0,-5600,3800,-2000,0,-3800
6208,-3900,-3400,9700,2400,0,4800
6209,-1900,-5500,1100,12000,0,5700
6210,-800,-6300,2000,-2000,0,-7100
6211,12000,19400,200,-12800,0,18800
6212,-3000,-3500,3800,-1800,0,-4500
6213,0,500,-7500,10200,0,3200
6214,-600,700,900,1200,-1200,1000
6215,1000,-3400,1100,-4800,0,-6100
6216,-4600,7400,3000,-1800,0,4000
6217,-4400,3700,-100,-8800,0,-9600
6218,12000,-5400,-9100,19200,0,16700
6219,-3000,6400,800,-10600,0,-6400
6220,-2900,-6300,13000,13200,-1200,15800
6221,11200,1700,2100,-11000,0,4000
6222,-3000,9200,2000,-600,-950,6650
6223,-6500,3900,3900,-800,-950,-450
6224,9000,-8200,3000,-2900,2900,3800
6225,-6400,6400,-4300,8100,1950,5750
6226,9200,200,-3700,1000,0,6700
6227,-5600,9400,1100,-1000,0,3900
6228,10300,-8400,13100,1000,0,16000
6229,1100,-8300,500,10400,0,3700
6230,-9400,6400,3800,-8000,0,-7200
6231,12400,-6200,200,6000,0,12400
6232,-3900,4400,3800,-7600,-2400,-5700
6233,100,6200,-11200,14400,-1200,8300
6234,1100,300,-5400,9000,-950,4050
6235,-3000,6500,4800,-13600,-950,-6250
6236,0,200,12100,4300,2900,19500
6237,0,-5400,2100,-6300,-450,-10050
6238,-6400,-2600,3000,10000,0,4000
6239,12000,3700,2900,0,-950,17650
6240,0,0,0,-1000,0,-1000
6241,-3000,9200,0,-900,1950,7250
6242,200,-2900,-900,-1000,-950,-5550
6243,-800,-5300,-800,8100,2900,4100
6244,-9300,-2700,3000,1000,0,-8000
6245,10000,-3600,1900,-1000,0,7300
6246,-1700,-2600,-3600,14200,-1200,5100
6247,13100,9400,-4500,-3000,0,15000
6248,-12200,-700,6700,12200,-950,5050
6249,11100,1800,3000,-13000,-950,1950
6250,-2800,-5600,3800,10100,2900,8400
6251,1000,-600,-3900,-4700,1950,-6250
6252,100,-3500,1000,6200,0,3800
6253,0,16700,-1600,400,-10200,5300
6254,-6600,-5500,3000,2000,0,-7100
6255,9300,-3600,4700,5200,12000,27600
6256,-9400,100,2000,4200,-1200,-4300
6257,9000,16100,-1600,3000,0,26500
6258,-700,100,-5800,-2800,0,-9200
6259,9100,-8400,4200,14800,-1200,18500
6260,-3000,6700,-3500,-10000,0,-9800
6261,-800,-6000,-3100,-2400,0,-12300
6262,-5500,-2800,10400,4600,-950,5750
6263,6200,5600,3900,-1900,1950,15750
6264,8400,4400,4800,-1000,-950,15650
6265,0,-2700,1000,-2700,1700,-2700
6266,-2900,-3200,-5400,14000,0,2500
6267,-6300,-2800,3800,7200,-10200,-8300
6268,2600,18500,4800,5000,0,30900
6269,9000,-2700,-1400,1400,0,6300
6270,-2700,-700,-1100,-2800,12000,4700
6271,4600,-2700,100,11000,0,13000
6272,-2000,-8300,-600,4800,-1200,-7300
6273,8600,6700,100,-2000,0,13400
6274,-3700,-9300,3000,3000,0,-7000
6275,-1800,3600,2900,-12000,-950,-8250
6276,-1600,2600,5600,-5300,-450,850
6277,10000,0,-900,14000,0,23100
6278,-2800,6500,2900,-14900,1950,-6350
6279,0,12100,-1800,-2000,-950,7350
6280,-800,3800,2000,8200,-11150,2050
6281,-1800,100,-800,-3700,1700,-4500
6282,-6500,0,1800,9100,1950,6350
6283,7300,-2600,-2900,3200,12000,17000
6284,10100,-6300,3800,-2800,0,4800
6285,-800,4700,-2200,-400,-1200,100
6286,1000,-2500,-2600,-2000,0,-6100
6287,-5800,3700,2700,4200,-950,3850
6288,-700,-6200,-1900,-3800,0,-12600
6289,6200,-8400,7600,12300,750,18450
6290,-3800,18700,-700,-10800,-950,2450
6291,8100,-9200,4500,10300,2900,16600
6292,-1700,7300,3900,-14800,0,-5300
6293,200,-3400,-6500,12000,0,2300
6294,0,7300,800,-2600,0,5500
6295,-2700,1100,-700,-7000,0,-9300
6296,-3600,-5300,-5100,14400,0,400
6297,9200,-3600,2700,-4600,0,3700
6298,-4600,3600,3900,200,0,3100
6299,9300,6600,1100,-400,-2400,14200
6300,-1800,9400,-1700,-1000,0,4900
6301,-4700,-8400,3900,2000,-950,-8150
6302,9300,-6400,4800,11200,-2150,16750
6303,-1800,4500,3900,-16900,2900,-7400
6304,-7200,6900,-15700,12500,-200,-3700
6305,10200,3600,-5300,-1000,0,7500
6306,-3800,-5500,13100,10100,1950,15850
6307,9000,1000,-6000,200,-950,3250
6308,-2800,-6200,3700,3500,2900,1100
6309,-3800,1800,12600,-7600,0,3000
6310,8100,-1800,4000,3000,0,13300
6311,1000,-6300,14000,10000,0,18700
6312,-2800,4600,3000,-12000,0,-7200
6313,-2800,4000,-1700,4200,-1200,2500
6314,-3500,-6300,2000,-1000,0,-8800
6315,9000,7300,-100,2400,-950,17650
6316,-2900,3700,1900,-12900,1950,-8250
6317,11400,-6300,1100,10200,-2150,14250
6318,100,4500,3800,-15700,1700,-5600
6319,100,3600,-12900,13400,-1200,3000
6320,0,900,-6100,11000,-950,4850
6321,-5800,-2700,1700,1200,0,-5600
6322,0,6400,8400,1100,1950,17850
6323,0,-11900,6700,-3000,-950,-9150
6324,0,10000,12000,-1900,2900,23000
6325,0,-500,-15000,8400,0,-7100
6326,0,-6200,-1000,10200,0,3000
6327,-6700,16700,16000,-9600,-1200,15200
6328,12200,600,2000,2000,0,16800
6329,0,-3500,2600,-2600,-950,-4450
6330,100,4300,1000,2200,-950,6650
6331,0,-3300,-2600,-3900,2900,-6900
6332,-900,-8200,-2800,10300,1950,350
6333,1100,15900,200,-2800,0,14400
6334,0,900,-6100,-1000,0,-6200
6335,0,-8300,-300,12400,0,3800
6336,-3700,800,20500,-10000,0,7600
6337,1100,-6300,2900,10200,-1200,6700
6338,-900,-2600,-800,0,0,-4300
6339,1100,8500,-1800,8000,0,15800
6340,0,-6200,200,13200,-1200,6000
6341,-3000,4600,3900,-10800,0,-5300
6342,11300,18600,-900,2000,-950,30050
6343,-2900,-9200,4800,0,0,-7300
6344,0,7500,-1700,-1900,1950,5850
6345,-5800,-6100,2100,3000,0,-6800
6346,8400,3700,-10100,7300,1950,11250
6347,100,6900,-3500,-1800,-1200,500
6348,-2900,-6300,2900,9200,0,2900
6349,0,-9100,15000,400,-2400,3900
6350,-9400,7400,3900,5000,0,6900
6351,9100,13000,-8000,1000,-950,14150
6352,-800,-9100,3900,10000,0,4000
6353,12000,7500,-2600,-1700,750,15950
6354,200,3600,14800,-12800,-2150,3650
6355,100,-9400,-200,12300,1950,4750
6356,-6600,-3200,-1700,1000,0,-10500
6357,-1700,-2700,100,7100,1950,4750
6358,11200,13100,-7000,0,-950,16350
6359,-9300,8500,2000,9100,2900,13200
6360,12000,1800,4900,-15800,0,2900
6361,-700,1300,10400,-1000,0,10000
6362,1100,-6200,-800,9200,-1200,2100
6363,-2900,4400,-8600,2600,-1200,-5700
6364,200,1000,2000,2200,-2150,3250
6365,-5800,3700,5900,2000,-950,4850
6366,11300,-5600,800,6300,1950,14750
6367,-3000,3800,1100,-9900,1950,-6050
6368,100,-6100,11000,10200,-950,14250
6369,-2800,10200,-700,-18700,2900,-9100
6370,-3800,6600,3900,-4500,1950,4150
6371,8100,-11700,4000,2200,-1200,1400
6372,-5400,-2700,2900,8000,0,2800
6373,6500,3800,1200,2000,0,13500
6374,0,5500,1900,2000,0,9400
6375,0,200,-2700,10000,0,7500
6376,-3800,3600,2000,-9000,0,-7200
6377,12000,5700,-400,12600,0,29900
6378,200,7200,-1900,-11600,-2400,-8500
6379,-5500,-5800,1700,15200,0,5600
6380,-3000,9200,3800,-1600,0,8400
6381,-800,-5600,3800,-2000,-950,-5550
6382,12100,-3800,0,14200,-1200,21300
6383,100,10100,-1900,-12700,750,-3650
6384,-2800,-2600,1100,12000,-950,6750
6385,200,-2500,-3700,-3900,1950,-7950
6386,200,-9100,2900,7100,1950,3050
6387,-1800,-6100,-700,200,-1200,-9600
6388,-7200,19200,5500,-5500,750,12750
6389,11100,3600,-1700,-6800,-2150,4050
6390,1000,-8200,900,10200,0,3900
6391,-2700,3700,1700,-12500,750,-9050
6392,-2800,-6500,800,15200,-1900,4800
6393,-3600,-8200,4000,6300,1700,200
6394,9000,15700,2900,-9900,1950,19650
6395,0,6300,-9900,10200,-950,5650
6396,-3600,-2500,-100,-4700,1950,-8950
6397,9100,6600,-15000,13600,-2150,12150
6398,-5400,0,14500,4700,-7300,6500
6399,11300,800,3900,-2900,13950,27050
6400,0,-5500,15600,-3600,0,6500
6401,-2900,9300,-1800,3000,0,7600
6402,-2800,-2600,1100,10000,0,5700
6403,-3700,3700,-6100,-800,-1200,-8100
6404,12200,-2800,0,-3000,0,6400
6405,-3000,-6400,15800,14000,-950,19450
6406,0,-3000,0,13000,0,10000
6407,-1800,11400,-1800,-5900,1950,3850
6408,2100,10100,-2700,-1000,-950,7550
6409,-5800,0,4700,-4700,2900,-2900
6410,-600,300,-3600,10200,-1200,5100
6411,6400,-5500,1900,1000,0,3800
6412,100,-8200,3000,7000,0,1900
6413,-3800,-3600,1000,4400,-2400,-4400
6414,9100,7200,1900,3000,0,21200
6415,0,9200,0,-1000,-950,7250
6416,0,-2900,-1800,3000,-950,-2650
6417,-3900,-5400,2000,11100,2900,6700
6418,1000,-3300,-2900,-4800,-950,-10950
6419,-3500,300,-4800,-1700,2900,-6800
6420,9200,9500,3000,-6600,0,15100
6421,0,-5600,2000,-2000,0,-5600
6422,-2900,3800,-800,4000,0,4100
6423,-900,-9000,3900,-2000,0,-8000
6424,-4600,7300,1800,-600,-1200,2700
6425,8400,6500,-1800,-6800,-1200,5100
6426,-6400,-12200,11400,11200,0,4000
6427,12000,10100,-900,0,-950,20250
6428,0,3500,-10800,3000,-950,-5250
6429,-3000,-2800,2800,11300,1700,10000
6430,-3900,-800,12000,200,-2150,5350
6431,200,-2600,-800,6100,2900,5800
6432,9100,9200,900,3200,-2150,20250
6433,-3000,6600,-10800,9100,1950,3850
6434,8500,-5400,3000,-2000,-950,3150
6435,-3000,-5500,2000,100,1950,-4450
6436,-3000,9500,-700,-1900,1950,5850
6437,100,100,-1800,-3000,0,-4600
6438,-3800,-8200,15000,300,750,4050
6439,8100,3700,-9800,13000,0,15000
6440,-5600,-2500,2900,-1800,0,-7000
6441,12200,3700,13100,-14000,0,15000
6442,200,-5400,1000,-2000,0,-6200
6443,-3800,3900,-1900,3200,0,1400
6444,1100,-9200,3800,-4000,0,-8300
6445,-2800,-6300,3000,12000,0,5900
6446,0,16600,2000,1000,0,19600
6447,-3800,-500,-4500,3000,0,-5800
6448,9200,7200,3000,-3400,-1200,14800
6449,-900,4100,1200,-14800,0,-10400
6450,-5700,-2600,200,14200,-1200,4900
6451,-8400,-3600,3900,0,-950,-9050
6452,22400,-2500,-2000,8400,0,26300
6453,-2000,-5400,2900,-3500,750,-7250
6454,0,15700,800,-2500,750,14750
6455,100,-5700,-1800,3000,0,-4400
6456,-3000,6500,-5200,6400,-950,3750
6457,-5600,6500,-9900,0,-950,-9950
6458,-800,-2700,12800,6500,1950,17750
6459,9100,-8200,900,-1500,1700,2000
6460,-5800,6400,5800,14000,0,20400
6461,8400,-5400,3000,11000,-950,16050
6462,-900,6400,3000,-1000,0,7500
6463,300,3600,-100,-11000,-950,-8150
6464,-1800,-2600,-2700,-2900,2900,-7100
6465,-1700,6500,14900,-6700,1950,14950
6466,9300,-5500,800,-1800,0,2800
6467,1000,3700,-7100,12200,-1200,8600
6468,-2900,-2700,-900,1000,0,-5500
6469,-4500,9300,-800,1200,-1200,4000
6470,13200,-2800,13800,-3800,0,20400
6471,-3000,-5400,2000,12000,-950,4650
6472,0,-3400,-4100,-2400,-2150,-12050
6473,0,-800,2200,-900,2900,3400
6474,100,-3500,2900,-10500,1950,-9050
6475,-2800,-5500,1500,11400,0,4600
6476,-3900,900,-7000,1000,0,-9000
6477,9600,8500,900,10000,0,29000
6478,-3000,7300,11200,-8000,0,7500
6479,-2900,900,3900,3000,0,4900
6480,8500,-3300,-100,-1600,-1200,2300
6481,200,1400,-900,4000,0,4700
6482,-5800,-3600,5700,11200,-950,6550
6483,11200,-3400,100,-1000,0,6900
6484,100,13500,800,3200,-950,16650
6485,-3800,-700,-4000,-1700,1950,-8250
6486,1100,4400,-9300,6300,2900,5400
6487,-9100,-6300,14800,2000,0,1400
6488,12200,7300,-4100,-1600,0,13800
6489,-2700,-3400,2900,-2600,-1200,-7000
6490,-3700,-5300,-1600,13000,0,2400
6491,9300,2700,6700,-5800,0,12900
6492,-5500,-2600,3000,11400,-2400,3900
6493,8200,3800,200,-9000,0,3200
6494,-8600,11200,5700,600,-3350,5550
6495,11200,10100,-1800,1000,0,20500
6496,-3000,-5300,1100,-4900,1000,-11100
6497,-3000,100,-3000,14200,-950,7350
6498,-800,-9100,3000,-5900,2900,-9900
6499,12000,-11200,3900,-900,1950,5750
6500,-2900,18600,-1700,3000,-950,16050
6501,0,0,1000,-7500,1700,-4800
6502,-900,3800,-8300,12200,0,6800
6503,1000,1000,-11600,-1000,0,-10600
6504,0,-10900,-600,2200,-2150,-11450
6505,0,800,16800,1200,-2150,16650
6506,0,700,-100,-9700,2900,-6200
6507,-3700,-2700,16800,5300,1000,16700
6508,-2700,6500,-900,1000,0,3900
6509,5600,-3800,2800,300,750,5650
6510,1000,7400,-800,0,-950,6650
6511,0,800,-8900,-1900,2900,-7100
6512,-10300,-500,200,14000,0,3400
6513,13000,-2600,12100,-3800,0,18700
6514,-4500,3400,2000,2000,0,2900
6515,7400,6800,200,200,-1200,13400
6516,-2900,3600,1900,4000,0,6600
6517,-1700,-6300,2000,-2000,0,-8000
6518,13000,4300,2900,-800,-950,18450
6519,100,-700,-3600,-1000,-950,-6150
6520,-800,100,4700,700,1700,6400
6521,1100,0,-2800,-6900,1950,-6650
6522,200,6500,2800,10000,0,19500
6523,-3000,-3600,1000,200,-1200,-6600
6524,-2800,10100,-10100,10200,0,7400
6525,-3600,-8300,2100,3000,0,-6800
6526,9100,-3400,-800,11000,-950,14950
6527,100,4500,13900,-1500,-450,16550
6528,-3900,3900,200,-9000,-950,-9750
6529,100,-3200,-2600,8300,750,3350
6530,-2600,10200,-1700,-15000,0,-9100
6531,9200,-11200,5900,10400,-2150,12150
6532,0,3700,2000,-13900,2900,-5300
6533,-6300,-800,1000,7100,1000,2000
6534,9000,1200,-7000,14000,0,17200
6535,-2600,10100,-10800,-5900,1950,-7250
6536,0,-2800,14900,8200,-950,19350
6537,-3900,-3400,1000,-3900,2900,-7300
6538,-2600,10300,9100,2400,-1200,18000
6539,2700,100,100,0,0,2900
6540,7200,-7800,-1800,14400,-1200,10800
6541,2100,-9000,-2200,-2600,0,-11700
6542,-4400,4700,-1000,2600,-3350,-1450
6543,7300,3800,-7000,-3000,-950,150
6544,-3600,-2400,-1900,10300,2900,5300
6545,12300,-3600,9300,-5900,1000,13100
6546,200,-6300,8600,-400,-950,1150
6547,-2900,6500,2900,-4700,2900,4700
6548,0,6700,-12600,-3700,750,-8850
6549,-8300,11400,4900,3400,0,11400
6550,8600,4500,2100,-800,-10200,4200
6551,100,-5200,-2000,9400,12000,14300
6552,-6400,-3400,3000,9000,0,2200
6553,3900,4700,-900,-600,-10200,-3100
6554,11000,-8900,16000,-2800,0,15300
6555,0,4500,200,0,12000,16700
6556,-3000,3600,4800,-10600,-1200,-6400
6557,-3900,-8300,4500,14200,0,6500
6558,12200,-11900,2100,-1000,0,1400
6559,-700,3700,-9000,6200,-950,-750
6560,1100,6700,100,-3600,-2150,2150
6561,-6400,-9100,2900,9100,2900,-600
6562,1000,-6400,12800,5500,-8250,4650
6563,-3800,6700,0,600,-1200,2300
6564,6200,-6300,4600,-1600,0,2900
6565,100,15600,-8000,-2000,11050,16750
6566,-3800,-5500,2900,1200,-1200,-6400
6567,11100,13200,-6000,4300,1950,24550
6568,1000,-9300,14000,1200,-2150,4750
6569,-3600,-8400,800,-1700,2900,-10000
6570,-2000,-6000,9200,1200,0,2400
6571,0,8600,1100,8200,-950,16950
6572,200,1800,2000,-12000,-950,-8950
6573,-3000,6100,-3400,-2900,2900,-300
6574,8400,-5500,5800,15500,-8250,15950
6575,-3900,-9000,2700,2200,0,-8000
6576,-1700,5900,200,-3000,12000,13400
6577,10300,4400,2900,-12000,0,5600
6578,100,2800,-1100,15200,0,17000
6579,-4800,-6100,-1900,2200,0,-10600
6580,-2900,4600,2100,200,0,4000
6581,11200,15700,3900,-13800,0,17000
6582,-3500,800,900,1200,0,-600
6583,1000,-11200,1100,1000,0,-8100
6584,-2600,4000,100,0,0,1500
6585,-3800,3600,-10100,3200,0,-7100
6586,8400,-5600,5700,8200,0,16700
6587,1000,-2100,15900,2000,0,16800
6588,-9400,-800,2900,0,0,-7300
6589,12000,-8200,4800,10000,0,18600
6590,-5600,21400,1100,-10800,-1200,4900
6591,-1700,-6400,2900,12000,0,6800
6592,12100,10400,-4500,-13000,0,5000
6593,-1700,9200,900,-2800,0,5600
6594,-2800,-6300,3900,400,-2400,-7200
6595,100,7300,0,0,0,7400
6596,7500,3700,-10100,200,-950,350
6597,1000,-6100,200,11000,0,6100
6598,-3900,4500,13100,-10900,1950,4750
6599,100,6500,1000,-6500,750,1850
6600,1100,-2800,3700,-3600,-1200,-2800
6601,-3800,6400,-1200,4200,0,5600
6602,1000,6600,-11800,9000,-950,3850
6603,-8600,-2700,3900,1000,-950,-7350
6604,7400,6500,9000,1300,2900,27100
6605,200,-3400,2000,-9500,1950,-8750
6606,8200,1700,2900,2000,0,14800
6607,-1700,6400,700,-11600,-1200,-7400
6608,-7500,-6200,900,15400,-1200,1400
6609,13000,-2000,1800,-9800,-950,2050
6610,-2800,7300,1800,-2600,0,3700
6611,-6500,-3400,2000,-1900,1950,-7850
6612,12000,-9400,2900,13000,-950,17550
6613,0,19300,1000,-14700,1700,7300
6614,-3800,9300,-3700,4000,0,5800
6615,100,-9100,2000,13000,-950,5050
6616,1000,4600,200,-11000,0,-5200
6617,-5600,6700,100,-3700,1950,-550
6618,8400,0,-1800,-1800,-950,3850
6619,-3600,900,-1400,3300,2900,2100
6620,10200,-2900,-9200,8400,0,6500
6621,-1000,9300,9000,2200,0,19500
6622,-800,-5400,-2000,-800,0,-9000
6623,1000,-12100,14700,13200,0,16800
6624,200,-1300,1900,4000,0,4800
6625,-900,800,-5200,-800,-1200,-7300
6626,-2000,-3500,1000,13000,0,8500
6627,-2900,-2800,13000,1000,0,8300
6628,-1700,6600,100,0,0,5000
6629,10100,15800,-10800,1000,0,16100
6630,-3000,-5300,1100,14000,0,6800
6631,0,3800,200,-11000,0,-7000
6632,0,-9000,12300,11200,0,14500
6633,-3700,10200,-700,-3800,0,2000
6634,12200,-11900,5500,-800,0,5000
6635,-2900,-3500,-1800,13000,0,4800
6636,-2900,9500,2700,-4400,0,4900
6637,-2800,3700,-7000,12200,-1200,4900
6638,8400,5600,800,-800,0,14000
6639,-2800,-2600,200,10200,-1200,3800
6640,100,-9200,17700,10400,-2150,16850
6641,-2900,22200,-2800,-9000,-950,6550
6642,11200,3900,-700,-2900,1950,13450
6643,-8600,-2800,6700,-2500,750,-6450
6644,-3800,-600,-3000,10500,750,3850
6645,11100,-2600,-2000,-1800,-950,3750
6646,-8300,9400,2100,10300,1700,15200
6647,6200,6400,2900,13200,-11150,17550
6648,-500,-5400,-3100,-800,-950,-10750
6649,6400,-3300,-1800,10300,13700,25300
6650,-10100,-5400,2900,-1900,1950,-12550
6651,10000,-3500,1100,10200,0,17800
6652,11200,16600,1100,-13000,-950,14950
6653,-6700,-3300,200,14000,-950,3250
6654,-1900,1700,3000,-13900,2900,-8200
6655,-700,-8000,300,7100,1950,650
6656,12100,-6400,200,-800,0,5100
6657,-3000,-3600,-1100,22400,-10200,4500
6658,-2800,16500,6700,-14800,0,5600
6659,-6500,-6400,3800,14000,0,4900
6660,9100,-3500,2900,-4800,12000,15700
6661,100,19300,1000,-1600,-1200,17600
6662,-3800,6500,2000,200,0,4900
6663,9200,-3600,3800,-1800,-1200,6400
6664,0,10100,-900,1000,0,10200
6665,100,0,-11200,7200,0,-3900
6666,0,0,-3900,10200,-950,5350
6667,0,-2600,13700,-3400,-2150,5550
6668,-5600,-2900,800,10300,2900,5500
6669,-3800,-9200,4800,9300,-8250,-7150
6670,12000,7400,100,-11000,0,8500
6671,-3000,-3300,-1700,14000,12000,18000
6672,-10100,400,-2700,1000,0,-11400
6673,9400,9300,2000,200,-1200,19700
6674,9100,-8200,1100,1000,0,3000
6675,-2700,6400,-800,-10800,-950,-8850
6676,0,-6400,5700,-4800,0,-5500
6677,-5400,1700,0,1500,750,-1450
6678,7400,6400,-6200,-2800,-950,3850
6679,-1700,-3300,-3600,7100,2900,1400
6680,11200,4600,11900,1200,0,28900
6681,-2700,-3200,-700,-5600,-1200,-13400
6682,-9300,7600,200,3200,-1200,500
6683,9000,3700,-10100,12600,-11400,3800
6684,0,-5500,1800,7400,-950,2750
6685,-3800,-6400,15600,1400,11050,17850
6686,12100,-4200,-3300,9100,1000,14700
6687,-800,3800,100,-16900,2900,-10900
6688,-4800,-6200,14700,-1500,1950,4150
6689,0,-8100,2100,10000,-950,3050
6690,100,1100,1100,-14900,2900,-9700
6691,-3800,6800,-2800,15200,0,15400
6692,12000,-2100,3900,-9000,0,4800
6693,-3500,-6300,1500,9400,0,1100
6694,-1700,4400,2800,2200,-1200,6500
6695,-6600,6500,2000,-10000,0,-8100
6696,11100,-3500,1100,7400,-1200,14900
6697,-4700,4400,2600,-6800,0,-4500
6698,-3600,3800,-2000,3200,-950,450
6699,9300,-6000,200,-1000,0,2500
6700,-6600,4600,2100,-900,1950,1150
6701,12000,-6300,2700,-1600,-950,5850
6702,-2800,-6100,1200,8100,2900,3300
6703,-900,1600,3900,-13000,0,-8400
6704,8300,13100,3000,2000,0,26400
6705,1000,-6300,2000,11200,-1200,6700
6706,0,7200,700,-10800,0,-2900
6707,200,6600,-15700,11400,-1200,1300
6708,-900,-9100,1800,-800,0,-9000
6709,-2000,7200,12100,3000,0,20300
6710,0,3800,-4200,-7600,-950,-8950
6711,-5800,-3400,2000,12100,1950,6850
6712,-4400,10100,11100,-11000,0,5800
6713,13000,3700,1100,-3900,1950,15850
6714,-3000,-6300,2900,1000,0,-5400
6715,-700,7200,-100,1000,0,7400
6716,-2700,3800,100,-10000,0,-8800
6717,12000,-9300,-100,14400,-1200,15800
6718,100,4500,1000,1000,0,6600
6719,100,-9200,3800,-1000,0,-6300
6720,100,-2700,100,19200,-10200,6500
6721,100,15700,700,-10800,0,5700
6722,-3000,6400,100,4000,0,7500
6723,100,-700,900,-5600,10800,5500
6724,-5500,10100,2000,200,-1200,5600
6725,-1700,-3600,1000,-1800,-2150,-8250
6726,13000,200,-900,9400,-1200,20500
6727,-3000,9400,-800,11100,1950,18650
6728,-3800,-5300,-1600,0,-1900,-12600
6729,-1600,-3500,1700,3500,2900,3000
6730,11200,4700,900,-17500,1950,1250
6731,-2800,-600,2000,9400,-2150,5850
6732,-10000,10200,1100,-13900,2900,-9700
6733,13000,-2600,100,6200,-950,15750
6734,-3800,-5500,-800,2000,0,-8100
6735,-1800,-12100,6700,10100,1950,4850
6736,11200,-6200,3000,-3800,-950,3250
6737,-5800,19400,1800,-2500,2900,15800
6738,-3000,6400,1000,4000,0,8400
6739,10300,-2700,1000,-2000,0,6600
6740,-1800,9600,-6500,-8000,0,-6700
6741,-3900,-5600,2900,13000,0,6400
6742,1200,-11900,500,400,0,-9800
6743,0,-5400,200,10000,0,4800
6744,-900,3000,1800,-1800,0,2100
6745,-5600,6500,3900,2400,-1200,6000
6746,9000,-5400,-1900,-800,0,900
6747,-3600,6400,2900,1400,-2400,4700
6748,12000,-100,7600,12400,-1200,30700
6749,-3000,10000,0,-9000,-950,-2950
6750,-700,9200,-1000,-11000,0,-3500
6751,-2000,-2600,-1700,9100,1000,3800
6752,0,0,-200,9400,-950,8250
6753,100,1100,2000,-13900,2900,-7800
6754,0,-5400,-100,7300,1950,3750
6755,100,-6200,-800,-3000,-950,-10850
6756,-6600,-6100,1200,10300,1700,500
6757,700,19300,4800,-7800,-1200,15800
6758,11200,6500,1100,-1600,-1200,16000
6759,-3500,-2800,4700,-800,-2150,-4550
6760,12100,-500,-3700,10000,-950,16950
6761,0,-2500,-1700,-2900,1950,-5150
6762,-3700,9400,-700,7100,1950,14050
6763,-1800,-8500,3900,12200,-2150,3650
6764,-3600,-600,-5000,-2500,2900,-8800
6765,6500,4600,4900,-2700,1950,15250
6766,0,800,-5200,-2000,0,-6400
6767,-4500,-5500,1800,11200,0,3000
6768,12200,1100,-100,-12600,-1200,-600
6769,-1900,-3400,11300,9200,0,15200
6770,0,-8300,4600,-3400,-1200,-8300
6771,-3000,1000,3900,3000,-950,3950
6772,-7100,8500,-800,-2500,-450,-2350
6773,10200,-5600,2000,10000,-950,15650
6774,-3500,18400,3700,-700,1700,19600
6775,9200,-5700,2000,1000,-950,5550
6776,200,6500,-1800,0,-950,3950
6777,100,-6300,1900,-3900,1000,-7200
6778,-3800,200,-900,7300,2900,5700
6779,1100,6500,-1800,-14700,750,-8150
6780,-9400,9600,3100,12200,-950,14550
6781,6200,-6300,3000,-2900,2900,2900
6782,11200,4600,1100,2000,0,18900
6783,0,-3500,2900,-3800,0,-4400
6784,100,7400,-1700,-800,-1200,3800
6785,-6700,-2700,3600,-400,-1200,-7400
6786,8500,-3500,-400,11600,-1200,15000
6787,1100,100,-7100,1400,-950,-5450
6788,-3700,3700,6700,12000,-950,17750
6789,-2500,9700,-5400,-16700,1950,-12950
6790,9200,-5500,3900,8100,1950,17650
6791,-2800,-6400,4800,11000,-950,5650
6792,7600,4300,-2000,-11700,2900,1100
6793,-1800,-6400,-5500,18500,750,5550
6794,0,-6400,4500,-1400,-1200,-4500
6795,0,22100,9300,2000,0,33400
6796,0,3800,-8000,-3000,-950,-8150
6797,-900,-5400,2000,12200,-1200,6700
6798,1000,-700,10200,8300,750,19550
6799,-6400,7700,-2700,-8800,-950,-11150
6800,12000,-5600,1700,9300,1950,19350
6801,-900,900,-3300,-3800,0,-7100
6802,1100,-2700,-1800,8100,1950,6650
6803,-3000,6700,1100,-11800,-950,-7950
6804,-2700,-3500,13100,7100,2900,16900
6805,-4700,4500,2000,-9000,0,-7200
6806,12100,-3300,2000,6200,0,17000
6807,1100,4700,-2700,-10800,-1200,-8900
6808,-2700,-5400,3000,12200,-1200,5900
6809,-2700,3900,-7900,-2000,0,-8700
6810,200,-3300,-1700,4200,-950,-1550
6811,-3700,2000,12300,-9000,0,1600
6812,11100,-9300,2000,10100,1950,15850
6813,1000,1900,2100,-15900,1950,-8950
6814,-2900,-8800,1200,14000,0,3500
6815,-3900,4600,-100,-7800,0,-7200
6816,-2500,3600,2900,-2000,0,2000
6817,9000,-3400,-1000,600,-1200,4000
6818,-5800,-2500,200,13000,0,4900
6819,11200,3700,3400,-5000,-1200,12100
6820,100,5700,-200,200,0,5800
6821,300,-1200,-100,1200,0,200
6822,0,-6200,1800,-4600,-950,-9950
6823,100,-2000,-8900,15000,-950,3250
6824,0,3600,-100,-700,2900,5700
6825,-2600,3700,1000,-3900,1950,150
6826,-900,-8700,11400,1200,-1200,1800
6827,-5600,-8200,4800,12000,0,3000
6828,-2600,15800,2100,-14000,0,1300
6829,8300,-3800,1700,12400,0,18600
6830,-4700,4500,1700,-9800,0,-8300
6831,11200,6600,-100,-1600,0,16100
6832,-5500,-4300,800,200,0,-8800
6833,7500,8300,200,-1000,0,15000
6834,1100,-3700,-2000,-2400,0,-7000
6835,-2900,3600,4700,200,0,5600
6836,100,8500,100,-4800,0,3900
6837,0,-11000,4900,10000,0,3900
6838,-6700,6500,1500,1600,0,2900
6839,-700,9300,1100,-5800,0,3900
6840,13100,700,-9900,13000,0,16900
6841,-5700,3700,4900,-12600,-1200,-10900
6842,-6400,3700,10600,8200,0,16100
6843,12200,-2600,-1100,-4800,0,3700
6844,-3600,6500,-3700,4200,-2150,1250
6845,5300,-6400,18400,800,-3350,14750
6846,1000,-5500,-200,7300,2900,5500
6847,-3700,3700,100,-10900,1000,-9800
6848,12000,5600,2900,10200,-1200,29500
6849,0,100,1900,-6700,1950,-2750
6850,-4800,6400,1000,1300,750,4650
6851,-1000,9300,-200,-600,-2150,5350
6852,100,6400,0,0,-950,5550
6853,200,-5500,-4200,-500,1000,-9000
6854,-2900,6600,-11800,9100,2900,3900
6855,-3600,-5600,-6300,6500,750,-8250
6856,8300,-6200,15000,12000,-950,28150
6857,100,4500,200,-5900,2900,1800
6858,-5500,-3300,800,-600,0,-8600
6859,9000,1700,14500,1600,0,26800
6860,100,3600,2000,-13000,0,-7300
6861,-800,-9100,1000,13000,0,4100
6862,-2000,-2500,-13700,10200,0,-8000
6863,-800,10200,4600,1200,0,15200
6864,9000,-6300,1100,3200,-1200,5800
6865,-5800,-2700,15900,11200,0,18600
6866,-800,3800,-8900,10000,0,4100
6867,9000,5700,2900,3000,-950,19650
6868,0,10400,-4500,0,-950,4950
6869,-2600,6400,3900,-5900,2900,4700
6870,0,-11100,-1500,12700,1950,2050
6871,5400,-6100,13200,2000,0,14500
6872,-800,-9200,3800,12000,0,5800
6873,-2000,19300,2000,-12800,0,6500
6874,8400,-3600,2000,12000,0,18800
6875,0,-9200,5700,-2000,0,-5500
6876,0,22100,-900,2000,0,23200
6877,-2900,9300,-2800,-8000,0,-4400
6878,0,-2700,-1700,9000,0,4600
6879,-2800,-3400,3800,-3400,-1200,-7000
6880,-9200,10300,-1800,3200,-1200,1300
6881,12100,-8400,-5400,19200,0,17500
6882,-3700,-5600,1000,2000,-950,-7250
6883,12100,9300,12900,-2600,-2150,29550
6884,-2800,-3600,2900,-3700,1700,-5500
6885,100,10100,-900,-1900,1950,9350
6886,-2900,-2600,-800,-1000,0,-7300
6887,0,200,-800,9400,-2150,6650
6888,0,-8600,4800,-800,-950,-5550
6889,-900,-6400,100,8100,2900,3800
6890,1000,4400,1700,-12700,1950,-3650
6891,-2900,9200,-1000,4000,0,9300
6892,7700,-800,1000,-5000,0,2900
6893,-2000,7500,-800,4000,0,8700
6894,-2800,-2600,-1000,-1800,0,-8200
6895,-800,-5500,1100,9000,0,3800
6896,9000,-5400,2000,3000,0,8600
6897,-3000,3700,-7100,14000,0,7600
6898,0,-500,-3600,-2000,0,-6100
6899,-2800,1400,16800,5000,0,20400
6900,-6400,-3400,-2700,2000,0,-10500
6901,15000,1800,3900,-3000,0,17700
6902,-3000,3900,-10700,3000,0,-6800
6903,100,-11400,4700,13000,0,6400
6904,100,-3600,-1200,200,0,-4500
6905,-12000,9200,14800,4000,0,16000
6906,11200,-3600,-3600,1000,0,5000
6907,12000,16700,3000,-800,0,30900
6908,-8600,-800,2900,2200,-1200,-5500
6909,8600,10000,-100,2200,-1200,19500
6910,0,-5500,2000,11000,-950,6550
6911,-2800,100,100,-2000,0,-4600
6912,100,3500,-200,5200,-950,7650
6913,-2900,-5600,1900,-2900,2900,-6600
6914,11300,-5600,1900,10500,-450,17650
6915,-900,9300,-2100,-10800,0,-4500
6916,1200,-6200,-900,11200,-2150,3150
6917,0,7300,-800,-10000,-950,-4450
6918,0,-5600,4800,5300,2900,7400
6919,100,-3500,1900,-6700,1000,-7200
6920,-5700,300,-3500,11200,-1200,1100
6921,200,13000,1900,300,750,16150
6922,-2700,-9300,3900,1000,-950,-8050
6923,8400,10000,-9200,5300,1950,16450
6924,-900,3800,1100,-9800,-1200,-7000
6925,-2900,-2400,-1900,8500,1950,3250
6926,-5300,-3000,14900,-2800,-950,2850
6927,11300,9700,-3600,-6500,1700,12600
6928,-1800,-8400,6700,-3000,0,-6500
6929,-3900,-2700,-5900,13400,-950,-50
6930,12200,900,5400,-14600,0,3900
6931,-5800,3600,3600,2300,1950,5650
6932,100,-6200,2000,-3000,-950,-8050
6933,-5500,10100,-8200,7300,2900,6600
6934,8200,9200,-1100,-10400,-1200,4700
6935,100,100,1900,6200,0,8300
6936,100,-8400,12100,14200,-1200,16800
6937,-5700,-2700,1000,1000,0,-6400
6938,-9400,9400,1100,4200,-1200,4100
6939,11200,-2400,-2600,-1000,-950,4250
6940,9100,-8300,3000,14000,-950,16850
6941,0,3900,-9800,-4900,2900,-7900
6942,-800,-2600,200,4500,750,2050
6943,-1900,3700,-9900,0,0,-8100
6944,8600,-6400,16700,9000,-950,26950
6945,200,4400,-200,-10800,0,-6400
6946,-6300,9200,8400,3500,1950,16750
6947,9000,200,-1800,15000,-950,21450
6948,-3000,100,-1800,-1700,1700,-4700
6949,-6400,-2500,14100,-3000,0,2200
6950,12100,-5600,1900,22200,-10200,20400
6951,0,-3300,-800,10000,0,5900
6952,0,-3600,1000,-1000,12000,8400
6953,-2800,12400,-5300,10200,0,14500
6954,-6500,-8300,6400,-2600,0,-11000
6955,12000,15700,-8000,10000,0,29700
6956,0,-11400,5700,3000,0,-2700
6957,-2800,9400,-3800,2000,0,4800
6958,100,-6200,12100,12200,-1200,17000
6959,-3700,4600,-800,-7000,0,-6900
6960,12000,-2100,3900,4000,-950,16850
6961,-800,-6200,2000,-3800,-950,-9750
6962,-1600,10100,-1800,-2900,2900,6700
6963,-2800,-3500,3900,-9500,750,-11150
6964,-3600,-2700,500,13400,0,7600
6965,12000,15700,2000,200,-1200,28700
6966,-6600,-2700,-2300,3400,0,-8200
6967,-4600,6300,2000,2000,0,5700
6968,11300,-2800,1900,-3800,-950,5650
6969,-7300,-700,-200,8500,1950,2250
6970,7200,7200,700,-9800,-950,4350
6971,0,-8100,2100,18300,-7300,5000
6972,0,-3500,100,-1000,0,-4400
6973,-9300,0,2000,12200,10800,15700
6974,8400,-2600,1700,-800,0,6700
6975,9100,8400,-900,14000,0,30600
6976,-5800,-5400,3900,14200,-1200,5700
6977,-800,9200,2900,-4800,0,6500
6978,12000,9400,-3900,-9800,0,7700
6979,100,-2800,3800,-3800,-950,-3650
6980,-900,0,0,11000,-950,9150
6981,1000,300,-3900,-5700,1950,-6350
6982,-3000,100,-2700,-700,1700,-4600
6983,-5600,-2200,1300,8200,0,1700
6984,-1600,-11200,-400,2400,0,-10800
6985,13000,6600,-800,-14000,0,4800
6986,-2800,-8700,-1700,16200,-1200,1800
6987,-2800,4500,3000,-9800,-1200,-6300
6988,-3600,3700,3000,1000,-950,3150
6989,12100,-6300,100,-1000,0,4900
6990,-5800,4500,3000,1100,1950,4750
6991,0,-9000,4600,9400,-950,4050
6992,0,-9000,2100,-4700,1700,-9900
6993,-3600,19400,200,3400,-2400,17000
6994,9300,4200,-600,-11000,0,1900
6995,0,-3500,1100,9200,-950,5850
6996,-2800,10000,4800,-15600,-950,-4550
6997,-2800,3800,4900,3700,-9450,150
6998,-4500,-6400,5700,-1700,750,-6150
6999,10000,-2600,-2000,11200,-950,15650
7000,100,6500,-10900,8100,13950,17750
7001,100,3600,1100,-2700,1950,4050
7002,-3600,-5500,15900,8000,-950,13850
7003,12000,6600,-800,-13700,1700,5800
7004,-3000,-3600,1700,9700,750,5550
7005,-2900,7300,1900,-10000,0,-3700
7006,0,9500,-13600,11000,-950,5950
7007,0,-5500,2000,200,-1200,-4500
7008,0,-9000,15000,7100,1950,15050
7009,-2700,7300,1100,-13000,-950,-8250
7010,-6500,-600,-1400,7700,2900,2100
7011,12000,4400,800,2200,0,19400
7012,0,-8200,-700,1000,0,-7900
7013,-6500,-6400,3600,14400,-1200,3900
7014,11100,-6200,3000,-4800,0,3100
7015,1100,16500,-900,1000,-950,16750
7016,0,3800,3900,-13600,-1200,-7100
7017,-3800,-6300,100,12100,1950,4050
7018,-6300,7500,-800,-11000,-950,-11550
7019,13000,3700,1100,-3900,2900,16800
7020,-800,-8800,2100,10000,0,2500
7021,1000,-2600,-800,-3000,0,-5400
7022,0,1100,1200,0,0,2300
7023,-6700,8600,1100,2000,0,5000
7024,8500,-5300,1100,10000,0,14300
7025,-8400,6400,3900,-9000,0,-7100
7026,12100,6500,-100,10200,0,28700
7027,0,-9100,5700,-2000,0,-5400
7028,-3000,10000,-900,5000,0,11100
7029,-7500,6500,2900,4000,0,5900
7030,13200,9300,-13800,-3000,0,5700
7031,-2700,-2400,-1700,12000,0,5200
7032,-3000,-5300,-1600,2000,0,-7900
7033,-3600,-2700,15900,7200,0,16800
7034,8100,3700,4800,-11600,-1200,3800
7035,-600,-8200,-1400,11400,0,1200
7036,-1700,-3400,-700,-3000,0,-8800
7037,11400,-6100,4000,4400,-950,12750
7038,1100,4600,100,-1000,-950,3850
7039,100,10300,-7000,-6900,2900,-600
7040,-3000,-8400,2700,14500,750,6550
7041,-4800,4000,1200,-12800,0,-12400
7042,-1500,-6300,14000,8000,0,14200
7043,12300,1600,-200,-11600,0,2100
7044,-3700,1000,1000,4000,0,2300
7045,1000,9400,-3600,-3000,0,3800
7046,-3000,-8200,3700,600,-1200,-8100
7047,-3800,-1900,4800,-8000,0,-8900
7048,9500,-3500,100,10000,-950,15150
7049,-6600,6400,2900,-9000,0,-6300
7050,12100,4400,1100,-2700,1950,16850
7051,0,6400,100,-11000,-950,-5450
7052,0,6500,-6400,1700,2900,4700
7053,-3000,-5500,800,14400,-1200,5500
7054,-900,3800,2000,-13000,0,-8100
7055,-2900,-6200,13100,12600,-12600,4000
7056,-1800,4300,2000,2000,0,6500
7057,11200,9400,-3900,2200,-950,17950
7058,-5800,-800,2000,-800,11050,5650
7059,-3000,-5600,4700,11300,1700,9100
7060,10500,-600,-2700,-6900,1950,2250
7061,-3300,16400,-2100,2200,-950,12250
7062,-1900,-8400,3800,1000,0,-5500
7063,-5400,-3500,3900,8100,1950,5050
7064,9200,7300,-900,-11000,-950,3650
7065,-8600,9300,3900,-2700,2900,4800
7066,11200,100,-1800,13200,-1200,21500
7067,-3600,-2700,2900,-3800,-1200,-8400
7068,12100,-2800,-2700,12000,0,18600
7069,-2800,-2500,200,-1000,0,-6100
7070,-3900,-9200,4800,14000,-950,4750
7071,-2000,7400,100,-9000,0,-3500
7072,-800,3700,2000,-700,750,4950
7073,5300,400,-2600,-2900,1950,2150
7074,-2900,6600,-800,3400,-2400,3900
7075,12200,-8200,2100,-3000,0,3100
7076,0,-9200,3600,12200,-950,5650
7077,-3000,4400,3800,-8000,0,-2800
7078,100,9400,-4900,-700,1950,5850
7079,100,-1800,-700,-11900,1950,-12350
7080,100,-5600,-5400,15400,0,4500
7081,-3000,-6300,2900,4200,-1200,-3400
7082,-4700,8500,-800,13000,0,16000
7083,12100,7400,13000,0,-950,31550
7084,-2900,6600,-10800,1000,0,-6100
7085,1000,-5700,-1700,10100,1950,5650
7086,-2900,-6400,16700,-3700,1950,5650
7087,0,7200,2800,200,-1200,9000
7088,-3700,-800,-1900,2000,0,-4400
7089,12100,-5600,3800,10000,0,20300
7090,-2900,11400,-1800,1000,0,7700
7091,0,10000,-1800,2200,-1200,9200
7092,0,-8300,-1300,-600,0,-10200
7093,-900,-8300,2700,10200,0,3700
7094,1000,3800,1100,-11800,-2150,-8050
7095,-900,-6300,3900,7200,-950,2950
7096,-2900,3700,2000,-12900,2900,-7200
7097,100,7400,-3600,300,750,4950
7098,-1700,6600,-8900,4200,-10200,-10000
7099,8600,-3500,-2100,13400,-2150,14250
7100,-900,1700,12200,-8000,0,5000
7101,-1700,-5400,2000,6100,13950,14950
7102,0,3500,-10100,11400,-950,3850
7103,-2800,800,2800,-10700,1700,-8200
7104,7600,-5300,11300,11000,0,24600
7105,-6500,3800,3900,-9000,-950,-8750
7106,13000,900,-6100,9200,-1200,15800
7107,-2900,-6100,-2600,-900,1950,-10550
7108,-5800,1800,17800,3000,0,16800
7109,11200,6600,-9800,3300,1950,13250
7110,-2800,-9100,700,1200,0,-10000
7111,-6400,-2800,13000,12200,-1200,14800
7112,12000,13200,-3300,-7400,0,14500
7113,-2700,-3400,2000,8200,-950,3150
7114,-3000,1700,3000,-9000,-950,-8250
7115,-3700,3600,6700,-4700,2900,4800
7116,200,-3400,2000,-7700,1950,-6950
7117,6300,10200,-3000,2200,0,15700
7118,-4400,3600,4800,-12000,0,-8000
7119,13000,-9400,2000,12000,0,17600
7120,0,7200,2800,-11800,-1200,-3000
7121,200,-700,-900,9000,0,7600
7122,-2900,100,-1900,2200,-1200,-3700
7123,-6500,-2600,-800,13000,0,3100
7124,12200,9300,-3000,-1600,-2150,14750
7125,100,900,1100,2200,0,4300
7126,-5800,-8100,4900,-1900,1950,-8950
7127,-2700,9400,-2600,200,-1200,3100
7128,2700,-700,3800,7300,1950,15050
7129,11300,4600,-2900,-12600,-1200,-800
7130,-3000,-9100,5500,12400,-950,4850
7131,0,-1200,1200,-9800,-2150,-11950
7132,0,900,3600,-3500,1700,2700
7133,-2800,-5500,-2100,-700,1950,-9150
7134,-3800,-1900,2400,5400,-950,1150
7135,12200,-11700,3100,10000,-950,12650
7136,-3000,1000,2100,-9900,2900,-6900
7137,-3000,-5400,200,9300,750,1850
7138,0,3800,-6100,-3800,0,-6100
7139,0,2700,2900,15000,0,20600
7140,-900,7500,9400,-11000,-950,4050
7141,1000,900,4800,0,-950,5750
7142,-2800,-6600,2900,-900,2900,-4500
7143,-1700,0,0,12000,-950,9350
7144,13000,21300,-900,-2900,2900,33400
7145,300,-700,-1900,-5000,0,-7300
7146,0,4800,-4400,4000,0,4400
7147,-2900,6600,-1700,-9600,-1200,-8800
7148,200,-9000,3000,9000,0,3200
7149,0,1600,4800,-13000,0,-6600
7150,200,6400,-4600,2400,-1200,3200
7151,-8500,3800,-2300,-3800,0,-10800
7152,11200,-5600,2900,10000,-950,17550
7153,0,-12000,2700,3400,-2150,-8050
7154,100,-600,5100,5700,1700,12000
7155,0,16500,-5200,4300,1950,17550
7156,-6700,6800,-9700,-1800,0,-11400
7157,6400,-5500,15900,12600,-4550,24850
7158,-2700,6600,100,-14900,1950,-8950
7159,-800,-12000,16900,11200,0,15300
7160,9100,-6000,-1700,-1900,1000,500
7161,-2800,19200,2000,1000,-950,18450
7162,-9300,6500,-15400,18300,2900,3000
7163,12000,-6300,11000,-4500,750,12950
7164,-3800,4600,2000,6200,-1200,7800
7165,9200,6700,13100,-12000,-950,16050
7166,100,-3500,-900,20200,-10200,5700
7167,-900,4500,2700,-16300,750,-9250
7168,-4800,-600,-1800,14200,10800,17800
7169,11200,4600,-1000,-2700,1950,14050
7170,0,-2500,-1600,-2600,-2150,-8850
7171,-3900,6400,5700,-2400,-2150,3650
7172,-1800,-5400,1800,-5700,2900,-8200
7173,-6600,-6300,4800,10100,1000,3000
7174,9100,10100,-14200,-600,-950,3450
7175,0,6500,200,-7500,1700,900
7176,-3800,-8300,15600,1500,750,5750
7177,6200,-3500,2000,14200,-2150,16750
7178,0,0,2800,-5800,-950,-3950
7179,-900,100,-2100,9300,2900,9300
7180,-2600,6300,-10300,20500,1000,14900
7181,9200,-2700,2900,-2000,-950,6450
7182,-3900,6500,12100,-900,2900,16700
7183,-2000,-5500,800,-700,1950,-5450
7184,8200,6500,1000,4200,-1200,18700
7185,100,-3500,-900,-1000,0,-5300
7186,0,7400,-800,1000,0,7600
7187,0,-8100,2100,0,0,-6000
7188,-5700,-3600,1000,13000,0,4700
7189,-600,4400,3500,-14600,0,-7300
7190,12100,6400,0,200,-1200,17500
7191,100,-2400,-3600,-800,-1200,-7900
7192,-2800,-3600,2000,11000,-950,5650
7193,-4500,-2800,5700,-5800,0,-7400
7194,-1800,8900,-2600,10100,1950,16550
7195,12000,7300,-800,0,-950,17550
7196,-5600,-5500,5800,-5900,2900,-8300
7197,-3800,-3600,700,15200,0,8500
7198,11100,7400,-800,-14000,0,3700
7199,200,-5400,-1000,8400,-1200,1000
7200,-4700,3700,800,-5400,-2400,-8000
7201,-7500,-3400,1100,13000,-950,2250
7202,12200,7300,-7100,7200,0,19600
7203,1100,-9300,-1700,-1100,-200,-11200
7204,0,9400,8400,-1000,-950,15850
7205,200,-8500,700,-1500,2900,-6200
7206,-700,3800,1000,5100,1950,11150
7207,1000,1000,900,-13600,-2150,-12850
7208,-5700,200,-2000,9500,2900,4900
7209,6400,3600,800,-8800,0,2000
7210,-700,-9200,9500,5200,-950,3850
7211,-6400,7300,3900,-4900,1950,1850
7212,6700,6400,4800,-13000,0,4900
7213,-4500,-800,-1900,11100,1950,5850
7214,9200,4400,2800,-11800,-1200,3400
7215,-1900,300,-3700,13200,-1200,6700
7216,-800,-3500,-800,-4800,-1200,-11100
7217,9000,-8100,900,16200,-950,17050
7218,-3700,5600,4800,-2000,0,4700
7219,200,7200,1900,-7700,1950,3550
7220,1000,3700,-2700,3500,-450,5050
7221,0,-6200,-1000,-1800,0,-9000
7222,-3800,-1000,4900,4000,-950,3150
7223,8100,6600,-8900,-1800,-950,3050
7224,-2700,-2500,-700,7100,2900,4100
7225,-3500,3800,13000,-13700,1950,1550
7226,10100,-9000,2900,11200,-1200,14000
7227,0,4600,-700,-10600,-2400,-9100
7228,-5800,6500,1100,4200,-2150,3850
7229,11200,6700,900,-4200,-1200,13400
7230,0,-10900,4900,-3900,1000,-8900
7231,-5600,9300,-11100,10400,-950,2050
7232,-6600,-3600,3900,-4700,2900,-8100
7233,12000,-2700,3800,15700,-10400,18400
7234,-9400,200,13100,1000,0,4900
7235,12000,12400,-5400,7100,13950,40050
7236,-2800,-8400,6700,-1000,-950,-6450
7237,0,-6400,3800,7100,2900,7400
7238,200,-3700,-2900,-3900,1950,-8350
7239,-2700,9300,-1100,11400,-1200,15700
7240,11200,-8600,2000,15000,0,19600
7241,-3000,16000,1100,-10000,-950,3150
7242,0,-3300,-1700,12200,-1200,6000
7243,0,-1300,3900,-9900,1950,-5350
7244,-2900,-6200,-1100,13400,-2150,1050
7245,-6200,-700,100,-6900,2900,-10800
7246,12000,10800,2100,6200,-1200,29900
7247,0,6500,1100,-15800,-950,-9150
7248,-6500,-3600,5400,12200,-950,6550
7249,300,7400,-6400,-12900,2900,-8700
7250,9200,-6200,3000,7300,750,14050
7251,-900,4400,3900,-15800,0,-8400
7252,-1900,3700,-11500,15400,-950,4750
7253,100,-2400,-2600,5200,0,300
7254,7300,6500,13100,-12700,1950,16150
7255,-1800,-9400,6600,11200,-950,5650
7256,-2800,-2800,2000,-6900,2900,-7600
7257,-3500,8400,1900,11000,0,17800
7258,8100,-5300,2000,1000,0,5800
7259,-1800,9300,-8000,5600,-2400,2700
7260,-3700,6500,-200,3200,0,5800
7261,6200,100,12100,13000,0,31400
7262,-1700,6600,-1800,-2000,-950,150
7263,-5200,-2700,2900,-2800,-1200,-9000
7264,10200,-2800,-1000,8500,750,15650
7265,0,-8200,3000,-2000,-950,-8150
7266,0,3800,-8900,18300,-8250,4950
7267,-3900,-6200,-1000,2200,0,-8900
7268,500,4600,11900,-2800,-950,13250
7269,11100,3500,100,-10900,13950,17750
7270,-4600,-3600,3900,6100,2900,4700
7271,-2600,-2700,1000,-3800,0,-8100
7272,-3800,-6300,2000,12000,0,3900
7273,12100,6500,3800,7200,0,29600
7274,-8400,6400,2000,-6800,-1200,-8000
7275,11000,9200,1800,12000,0,34000
7276,0,9300,-2100,-10800,0,-3600
7277,-3700,-5300,-2500,11000,0,-500
7278,-4700,-2600,-1300,2400,0,-6200
7279,8400,-3500,2000,10000,0,16900
7280,-3800,-2800,-400,12600,0,5600
7281,12200,6600,3000,-6800,0,15000
7282,-2600,900,3900,0,0,2200
7283,-5800,-6400,-5700,10600,-1200,-8500
7284,11400,10200,-3900,200,0,17900
7285,100,-2100,3000,-8000,-950,-7950
7286,-5800,-2900,10500,9200,-950,10050
7287,0,-5500,2000,-3700,1700,-5500
7288,0,3600,2000,-900,1950,6650
7289,-3500,3000,-10900,22200,0,10800
7290,9000,-8300,4800,2000,0,7500
7291,0,6500,-8900,-3800,0,-6200
7292,-3000,15900,3100,14000,0,30000
7293,-700,-5200,-1700,9000,0,1400
7294,-1800,6600,10900,-8800,0,6900
7295,-3800,-9100,3900,12000,0,3000
7296,9300,-2800,1100,-1800,-1200,4600
7297,-7500,18600,15000,2200,0,28300
7298,6400,-6200,2900,0,0,3100
7299,9600,4600,2100,-2000,-950,13350
7300,-9500,-3300,2100,3000,-950,-8650
7301,-3600,100,-900,6300,2900,4800
7302,6900,9300,1900,-6900,1950,13150
7303,9000,-6200,200,13000,0,16000
7304,-2700,4400,2900,-10800,0,-6200
7305,11200,-5400,200,11000,0,17000
7306,100,800,2900,0,0,3800
7307,-800,6500,0,-11800,-1200,-7300
7308,-1800,-3500,2000,10000,0,6700
7309,-3000,4400,3800,-6800,-1200,-2800
7310,-2800,-600,-3800,12000,0,4800
7311,8400,-2500,-700,-800,-1200,3200
7312,-2900,6500,1100,11000,-950,14750
7313,100,1000,800,-8800,-950,-7850
7314,-3900,-3400,200,8300,2900,4100
7315,300,1700,4800,-5900,1950,2850
7316,9100,-6400,1600,3200,0,7500
7317,-2900,7300,-1800,4000,0,6600
7318,-3400,6400,900,-12000,0,-8100
7319,9000,-2700,2900,11200,0,20400
7320,-3000,6600,-11700,1000,0,-7100
7321,-6600,-8300,6700,14200,-1200,4800
7322,12000,-700,11100,-2000,0,20400
7323,-6600,10200,-2700,5000,-950,4950
7324,12300,-2700,1000,-4800,0,5800
7325,100,-8400,4700,8100,1950,6450
7326,0,9400,-3600,1000,-950,5850
7327,-3700,-800,2900,-8500,1700,-8400
7328,-1900,4500,3800,3400,-2400,7400
7329,-3000,200,-1800,11200,-10200,-3600
7330,11200,-2800,100,11200,-2150,17550
7331,-900,-3400,-800,200,12000,7100
7332,-2000,4600,-800,100,1000,2900
7333,-700,-5400,-1800,-1000,-950,-9850
7334,-2900,4100,300,-1700,2900,2700
7335,-1900,-8900,-1000,-2700,1950,-12550
7336,11200,4700,1200,-800,-950,15350
7337,0,6400,2000,-3700,2900,7600
7338,-800,-9000,1100,-6000,0,-14700
7339,1200,1700,-6400,9400,-1200,4700
7340,-2800,6500,200,-10000,0,-6100
7341,-2800,-11900,17700,11000,0,14000
7342,-2500,7400,-900,-11000,0,-7000
7343,8600,6400,-1200,200,0,14000
7344,-2700,-9100,5700,-1800,-1200,-9100
7345,-3500,1700,1000,4000,0,3200
7346,9000,-3300,-3500,12000,0,14200
7347,0,-6200,3900,-4800,-950,-8050
7348,-3900,13700,3900,4000,-950,16750
7349,-1800,800,2000,-10900,2900,-7000
7350,-3600,-6300,0,10100,1950,2150
7351,12100,-2700,100,-4600,-1200,3700
7352,-3000,15900,-700,3000,0,15200
7353,-3600,600,-4500,-2600,0,-10100
7354,12300,-11200,5300,8600,-1200,13800
7355,100,6500,-1800,1000,0,5800
7356,-3000,-11000,16900,0,-950,1950
7357,-2700,-600,-2700,11000,0,5000
7358,100,3600,6700,-22300,750,-11150
7359,-2800,8500,900,200,-2150,4650
7360,10400,4400,1900,-1700,1700,16700
7361,-1800,9400,-1700,-13000,-950,-8050
7362,0,-3500,1900,10000,-950,7450
7363,-2800,-2400,-700,8100,2900,5100
7364,-3000,18600,-1700,-11900,1950,3950
7365,-800,-5600,1700,10200,0,5500
7366,9200,-6400,5700,-1000,0,7500
7367,0,300,-2700,10200,-1200,6600
7368,100,6600,-3600,-12000,0,-8900
7369,-3900,3600,5700,14000,-950,18450
7370,1000,-2000,-7000,0,0,-8000
7371,-3500,0,900,7100,1950,6450
7372,8300,6500,8900,-6800,-950,15950
7373,-2000,-6100,-800,11100,2900,5100
7374,-3600,4400,3800,0,0,4600
7375,9200,6800,-6900,-8600,0,500
7376,100,-8000,900,8400,0,1400
7377,-900,6600,-3500,-13000,0,-10800
7378,-2900,-6300,7400,6800,0,5000
7379,100,-5100,-700,-4800,0,-10500
7380,-3500,3800,2100,-2000,0,400
7381,-5700,6600,3000,1000,0,4900
7382,15600,3800,4000,3000,0,26400
7383,0,6400,2900,-2600,-1200,5500
7384,-6600,-2800,3900,200,0,-5300
7385,11100,3600,2000,1000,0,17700
7386,1000,-8100,3900,-4000,0,-7200
7387,-5800,-3300,-700,14000,0,4200
7388,11200,9800,3600,-8800,0,15800
7389,0,-2600,100,400,-2400,-4500
7390,-3000,9200,-900,5000,0,10300
7391,-2900,-6300,1900,14000,-950,5750
7392,100,7300,-900,-12000,-950,-6450
7393,-800,-5700,-900,12100,2900,7600
7394,-2600,9400,-700,-16700,1950,-8650
7395,12000,-5300,1800,8400,0,16900
7396,-2800,-6100,2100,-4000,0,-10800
7397,200,-900,-600,1000,0,-300
7398,-5700,3700,2900,-5600,-2400,-7100
7399,-3600,-700,200,7200,0,3100
7400,12000,-5100,3100,-7600,-950,1450
7401,-3000,6500,-1700,4000,-950,4850
7402,100,0,9500,-10700,2900,1800
7403,-3000,-2600,2000,8500,750,5650
7404,11300,-3500,-900,9000,0,15900
7405,-4800,9500,-2600,3400,-2400,3100
7406,-900,1100,3900,9400,-11150,2350
7407,-3700,9300,1100,-800,-2150,3750
7408,-2700,9400,-800,-5100,11550,12350
7409,9000,-2700,3900,-7500,1950,4650
7410,100,-5400,100,12000,-950,5850
7411,0,-9300,1100,-2900,1950,-9150
7412,0,1700,5700,-1900,1950,7450
7413,-900,9300,-10900,-1000,-950,-4450
7414,-2000,-800,-1800,8100,2900,6400
7415,-1700,-5600,16700,-2700,750,7450
7416,10100,11200,-1200,11200,0,31300
7417,0,100,-900,-1000,-950,-2750
7418,-3700,9300,2000,10000,-950,16650
7419,1000,100,-3900,9500,1700,8400
7420,-3900,-5500,3800,-900,1950,-4550
7421,300,6600,-13700,9000,0,2200
7422,12000,-8500,200,3200,-1200,5700
7423,-3000,-3500,17700,7400,0,18600
7424,-2800,7300,1700,-8600,-1200,-3600
7425,-600,-9400,-100,13000,-950,1950
7426,1000,-2700,-800,-1000,-950,-4450
7427,0,12900,3600,-2700,2900,16700
7428,0,-700,-2700,-1700,750,-4350
7429,-2800,7400,-7300,8400,0,5700
7430,11200,3600,-8300,11400,-2150,15750
7431,-3000,-2700,13000,12200,-11150,8350
7432,-3700,-800,1000,7100,2900,6500
7433,1000,7400,7800,-14300,750,2650
7434,-7300,-2400,0,13200,12000,15500
7435,13100,-8300,2000,-3000,0,3800
7436,0,-6400,-9100,20400,-2150,2750
7437,-3000,1600,8500,-10600,-2150,-5650
7438,100,-3700,9900,8300,2900,17500
7439,0,3600,-8300,-1500,-200,-6400
7440,-3000,12100,-900,13000,0,21200
7441,8500,9500,-2600,-600,-3350,11450
7442,-1700,-11400,16700,-900,1950,4650
7443,-1000,-3400,-3900,10300,1950,3950
7444,-2600,-8300,2900,-2000,-950,-10950
7445,7300,5700,500,12700,1700,27900
7446,-5600,-5200,-700,-1700,750,-12450
7447,400,900,2000,-4000,-950,-1650
7448,8100,15700,-8900,3000,0,17900
7449,1100,-8300,-2700,8100,1950,150
7450,0,3800,3400,-16000,-2150,-10950
7451,300,-9300,10100,12500,500,14100
7452,-3000,-1100,6700,4000,-950,5650
7453,0,6800,-3700,-14600,0,-11500
7454,-3800,-6200,3900,8300,1000,3200
7455,9200,1600,3000,-7800,-2150,3850
7456,-3600,-3600,800,6300,2900,2800
7457,-5600,-6300,3000,-1900,1950,-8850
7458,9200,4700,-7200,12400,-2150,16950
7459,0,21300,200,-19500,2900,4900
7460,100,-9000,3800,11000,-950,4950
7461,-3900,4500,13100,-7800,-1200,4700
7462,8500,6600,1100,6300,-8250,14250
7463,1000,-3300,1100,8200,-950,6050
7464,200,10200,-6500,-4700,4700,3900
7465,-800,3900,2100,-2800,0,2400
7466,-4800,6500,-3500,-6400,12000,3800
7467,-3600,-2600,-700,12200,-1200,4100
7468,5400,6500,3800,-13800,0,1900
7469,10400,-8400,11900,12400,-2150,24150
7470,-800,-3600,2900,-4800,0,-6300
7471,-3700,1400,5700,100,1950,5450
7472,-2000,9300,-900,3200,-2150,7450
7473,-800,-700,-900,-4900,2900,-4400
7474,6200,7500,-700,15200,-11150,17050
7475,0,-5500,200,-1800,0,-7100
7476,-800,-5500,500,5700,13950,13850
7477,-1700,9500,-3800,-13600,-950,-10550
7478,3000,-7900,-2100,2500,2900,-1600
7479,0,-9000,3000,1200,-1200,-6000
7480,-5800,-5300,1200,12000,0,2100
7481,5400,18500,-700,-10000,0,13200
7482,-1600,-9000,4800,8200,0,2400
7483,13000,1800,4000,-2800,0,16000
7484,-3000,-6400,1100,1000,0,-7300
7485,100,-6400,11300,2600,0,7600
7486,-700,19200,-2800,-9000,0,6700
7487,100,6500,-12700,8000,0,1900
7488,-6400,-3400,1700,400,0,-7700
7489,13000,-1200,14100,3000,0,28900
7490,100,3900,-11000,-3800,0,-10800
7491,-3000,-8800,1200,14000,0,3400
7492,-2900,4400,2000,-11000,0,-7500
7493,0,-9200,14700,12200,0,17700
7494,-5600,-5900,2100,-600,-1200,-11200
7495,8600,22000,900,-2000,0,29500
7496,-900,6600,-2600,-10800,-1200,-8900
7497,-6600,3800,-5200,11200,-950,2250
7498,13200,-5500,3000,-8800,-950,950
7499,-3000,-3600,-1100,12300,2900,7500
7500,-700,-6200,14800,-7700,1950,2150
7501,-1800,22200,-1700,-3000,0,15700
7502,5400,3700,2700,4200,0,16000
7503,-3900,-5600,3600,-200,-2400,-8500
7504,200,-2800,1900,10000,0,9300
7505,9000,9200,-10200,2400,-2150,8250
7506,-4800,300,-3600,13000,-950,3950
7507,-1600,-2600,1100,-4900,1950,-6050
7508,12100,-8500,13000,11100,1950,29650
7509,0,3800,200,0,0,4000
7510,-3000,-9100,3600,300,1950,-6250
7511,-2900,7500,-2600,3000,-950,4050
7512,100,-2000,7600,-16700,1700,-9300
7513,100,9300,-900,1000,0,9500
7514,-3000,-5400,1100,2000,0,-5300
7515,-800,-500,-4500,10000,0,4200
7516,9300,-6300,-1900,2200,-1200,2100
7517,0,19300,2900,-2600,-1200,18400
7518,100,1000,-6100,-4000,-950,-9950
7519,-2800,-2700,-100,12200,0,6600
7520,-3000,900,-6100,11100,1950,4850
7521,-800,-3500,11200,-800,-2150,3950
7522,12000,1400,6600,-4700,2900,18200
7523,-3000,-500,9300,2200,-1200,6800
7524,0,10200,-3600,1200,-2150,5650
7525,-2900,-5500,800,-600,-950,-9150
7526,-4400,1000,-5200,8100,1950,1450
7527,9400,-2500,-2900,-6700,1950,-750
7528,-4800,3700,11900,5200,-950,15050
7529,-3600,900,-13500,5300,2900,-8000
7530,12000,-10700,1300,9300,750,12650
7531,-2900,4000,-9800,8400,-1200,-1500
7532,100,-8900,12200,-1800,-1200,400
7533,-3700,-5500,-8200,24200,-950,5850
7534,9000,12900,14100,-11000,0,25000
7535,-2800,-3400,1500,6700,1950,3950
7536,-900,-11200,14100,2200,-2150,2050
7537,1200,12900,3900,-7900,2900,13000
7538,100,-6300,13000,-1800,-1200,3800
7539,-3500,4600,-800,6200,-2150,4350
7540,6400,9500,-700,-1000,-950,13250
7541,-3600,6600,-7000,-9700,1950,-11750
7542,9100,-5300,-1000,12500,750,16050
7543,-2800,-3400,-2900,-800,-950,-10850
7544,-7300,-2800,8500,14500,2900,15800
7545,10200,15600,-10300,-700,1950,16750
7546,-6400,6600,-1100,1200,0,300
7547,12000,800,4400,-600,0,16600
7548,100,-11200,2100,14200,-1200,4000
7549,-2700,-3800,12100,9200,0,14800
7550,-2700,-6400,7600,-6600,-2150,-10250
7551,-3800,19400,12800,-8400,-1200,18800
7552,9100,6900,-6600,500,750,10650
7553,-8100,-3600,1700,8200,-1900,-3700
7554,10200,2100,-700,-9500,500,2600
7555,-4600,6800,200,-5500,750,-2350
7556,10400,-9100,800,200,-1900,400
7557,-8400,-6200,-5300,19300,2900,2300
7558,9100,16500,100,-11900,1000,14800
7559,0,-9000,15000,11000,0,17000
7560,-3700,-8800,1200,-2900,1950,-12250
7561,12000,13600,1100,3000,-950,28750
7562,0,3600,-7100,-3900,2900,-4500
7563,100,-8400,1100,8300,1950,3050
7564,-2800,-3800,12100,2000,0,7500
7565,100,-8900,3000,5200,0,-600
7566,100,16600,-800,-10800,-1200,3900
7567,-3000,3900,-11800,14400,-1200,2300
7568,0,-9200,5700,10000,0,6500
7569,-900,1700,15900,-11000,-950,4750
7570,100,-3500,1700,4500,1950,4750
7571,1100,-3500,100,-5800,-950,-9050
7572,2700,9200,7600,5300,2900,27700
7573,-3000,-3400,100,2000,0,-4300
7574,11300,15900,-21000,20200,0,26400
7575,-900,-2700,-4500,2000,0,-6100
7576,-4700,18400,1900,1200,0,16800
7577,0,-9200,15300,11400,0,17500
7578,-9300,10300,-1700,-9000,0,-9700
7579,6300,3900,3000,1400,-1200,13400
7580,-1700,3600,4900,-1800,-1200,3800
7581,13100,-8300,2100,9200,-1200,14900
7582,-5800,3600,-4600,1200,0,-5600
7583,11200,-800,9900,12400,-2150,30550
7584,-6700,7200,3800,-11900,1950,-5650
7585,-2000,-600,-1800,13000,-1900,6700
7586,8500,10200,10200,-14900,2900,16900
7587,-2800,-2500,-2700,10100,1950,4050
7588,200,-5400,-1700,-3000,0,-9900
7589,0,-9200,6700,4300,1950,3750
7590,-3500,4400,1900,2000,0,4800
7591,6200,6600,2900,-9000,0,6700
7592,100,-300,-6300,10000,0,3500
7593,-6600,7600,1200,-10800,0,-8600
7594,3700,-2700,4600,9200,0,14800
7595,11200,-5400,1100,200,-1200,5900
7596,-900,-6300,-8100,16600,0,1300
7597,-2900,4700,-1700,3200,-1200,2100
7598,1000,3700,-400,-9600,0,-5300
7599,-3700,-9200,17700,8200,-950,12050
7600,11100,-5400,-100,200,0,5800
7601,-2000,18600,-12600,10100,1950,16050
7602,-6600,-6400,4700,1000,-950,-8250
7603,9400,4700,200,-1900,2900,15300
7604,-6400,3800,3100,2200,-1200,1500
7605,3500,-6200,3900,12000,0,13200
7606,-700,-5600,14900,600,-3600,5600
7607,9000,3900,-10700,14000,0,16200
7608,100,100,5800,9000,-950,14050
7609,-6500,7300,13900,-6800,-1200,6700
7610,6500,6300,1100,100,1950,15950
7611,0,-6200,800,-1400,-4300,-11100
7612,-3800,7500,-12800,10300,2900,4100
7613,12000,1200,300,-13700,750,550
7614,0,-8100,13200,11200,-3100,13200
7615,-5800,6600,3900,-3500,-7300,-6100
7616,100,3800,-10700,7100,1000,1300
7617,100,-8300,4700,8000,-950,3550
7618,-3700,6600,10000,-12300,13700,14300
7619,9200,-3400,1100,8100,1950,16950
7620,100,1900,-1000,-13800,-1900,-14700
7621,-13100,-700,1500,13500,2900,4100
7622,7200,-2700,3000,-6700,1950,2750
7623,5000,15800,3900,-2000,0,22700
7624,3500,100,1000,100,1950,6650
7625,11200,-9200,1200,11200,0,14400
7626,-800,-8300,4700,9000,0,4600
7627,-1800,8500,-1900,1200,-1200,4800
7628,-4800,-6300,200,14000,0,3100
7629,-700,13800,3800,-13000,0,3900
7630,5400,3800,-8200,15200,0,16200
7631,-3800,6900,-13500,1000,0,-9400
7632,200,-8200,2100,9000,0,3100
7633,12100,-9300,12100,2000,0,16900
7634,-8500,7300,2900,4000,0,5700
7635,8400,3700,15900,-13000,0,15000
7636,100,-6100,-1700,11000,0,3300
7637,-3000,4500,4800,-10800,0,-4500
7638,-3500,6500,-10800,10000,0,2200
7639,8300,6500,5700,-13800,0,6700
7640,-1900,100,6100,14200,0,18500
7641,0,800,-4300,-3000,0,-6500
7642,-900,-11200,3000,15000,0,5900
7643,-1900,9500,-2600,-1000,0,4000
7644,11300,-3500,1800,5600,0,15200
7645,-6600,4500,-6100,1000,0,-7200
7646,-2800,-6300,14000,11000,0,15900
7647,11200,-5400,2000,-2000,0,5800
7648,-4700,18400,13700,3200,0,30600
7649,-2900,200,-2800,13200,-1200,6500
7650,11200,6500,-10800,-1000,0,5900
7651,-3000,-5200,200,15000,0,7000
7652,-5800,-2700,13100,1000,-950,4650
7653,11200,800,3900,-15900,1950,1950
7654,-2900,-6300,3800,2200,-2150,-5350
7655,-800,7100,-900,-700,1700,6400
7656,-1800,6500,-100,-10400,-2400,-8200
7657,-3800,-5400,2000,14000,-950,5850
7658,12000,3800,-9800,10000,0,16000
7659,0,-5500,2900,-2000,-950,-5550
7660,-2900,9600,-4600,100,1950,4150
7661,100,-5400,11200,-3700,750,2950
7662,0,-5700,2000,11200,-950,6550
7663,-3000,-3400,1100,-4500,1700,-8100
7664,-3900,3700,-10000,-1700,1950,-9950
7665,-2500,9300,3900,1600,-11400,900
7666,11200,3900,1600,6600,-950,22350
7667,-7600,-2800,3800,3400,-3350,-6550
7668,11200,3600,-6200,6300,14900,29800
7669,-3700,-2800,1800,-1900,1000,-5600
7670,1000,6200,-11800,1000,-950,-4550
7671,0,-2500,3800,2700,1700,5700
7672,0,-9300,2000,-900,1950,-6250
7673,-900,7300,11200,-11000,-950,5650
7674,100,6400,2800,-3000,0,6300
7675,1100,400,5600,-3900,1950,5150
7676,-3500,-2700,3800,7200,-950,3850
7677,12000,-8100,-8100,5300,2900,4000
7678,-2800,-600,8400,-1800,0,3200
7679,0,-6500,2000,18400,-10200,3700
7680,-2700,13700,19600,-12800,0,17800
7681,-3600,3600,200,-8000,0,-7800
7682,12000,-5300,-9100,17200,12000,26800
7683,-3000,6600,-2600,6200,-1200,6000
7684,-2900,-6300,14900,-1800,0,3900
7685,-2800,-8300,6700,-2000,0,-6400
7686,-3600,6500,-10900,14000,0,6000
7687,9000,8500,1000,2000,0,20500
7688,-900,7500,-2600,-12800,-1200,-10000
7689,-3600,-8400,17700,1000,0,6700
7690,11300,9500,-15100,9400,0,15100
7691,-800,-3400,1100,-5000,-950,-9050
7692,0,4600,200,-10000,0,-5200
7693,-2800,-11400,18700,9100,1950,15550
7694,0,3600,1700,-13700,1950,-6450
7695,-3700,-400,-5500,15200,-1200,4400
7696,9100,4400,1900,-8800,-1200,5400
7697,100,3800,-100,-1600,0,2200
7698,100,-6100,-1700,10000,-950,1350
7699,-2700,4500,3800,-13000,0,-7400
7700,0,900,-300,-2500,1950,50
7701,-3800,-8900,3000,3000,-950,-7650
7702,9000,10000,100,-2700,2900,19300
7703,-800,3700,5500,-18400,0,-10000
7704,-1800,-5800,4800,11200,0,8400
7705,-3000,9300,-1800,200,-10200,-5500
7706,10500,-6000,-700,6200,-1200,8800
7707,1100,1400,1700,-7800,12000,8400
7708,-3900,-6300,2900,14000,0,6700
7709,-1800,7400,100,1000,0,6700
7710,100,9300,-2700,-13000,0,-6300
7711,-2900,-5500,800,12400,-1200,3600
7712,8400,-3400,2000,-3000,0,4000
7713,-2900,-5600,2900,13200,-2150,5450
7714,-3600,-3700,2900,600,-2400,-6200
7715,12000,22200,-2700,-1700,750,30550
7716,-5800,100,2000,-1800,-1900,-7400
7717,-800,200,-1800,4300,2900,4800
7718,-1700,-2900,-200,7700,-200,2700
7719,7800,6500,-9900,-3000,0,1400
7720,-1800,-2700,3900,3300,1950,4650
7721,7300,-5600,16700,2000,-950,19450
7722,1100,6200,0,-1900,2900,8300
7723,0,100,-900,-3900,1950,-2750
7724,-3000,0,-1800,13000,0,8200
7725,-3000,-5500,1700,10600,-11400,-7600
7726,-3400,6600,1000,0,0,4200
7727,9000,100,-2700,2000,-950,7450
7728,-6400,-2700,6700,8400,10800,16800
7729,9100,100,-2800,100,1950,8450
7730,-2700,3700,-11200,13200,-950,2050
7731,0,-5300,200,7300,1700,3900
7732,100,-9400,11800,2200,0,4700
7733,-5700,-5400,2000,12200,-11150,-8050
7734,11200,13200,1200,-12000,0,13600
7735,-5800,-3300,1200,-2700,13950,3350
7736,-800,-1400,4800,2000,-950,3650
7737,9400,-400,-4500,-3700,1700,2500
7738,0,-9400,7600,9400,0,7600
7739,-2800,16500,3900,-15800,-1200,600
7740,0,6700,-14700,13400,-1200,4200
7741,100,-9100,2900,-1000,0,-7100
7742,-900,4700,12200,1000,-950,16050
7743,-2700,-1800,4800,-11000,-950,-11650
7744,9200,6600,-3000,2500,1700,17000
7745,-5800,-2800,1100,-700,750,-7450
7746,8400,3600,5700,200,-1200,16700
7747,-3000,-6400,3800,1000,-950,-5550
7748,200,7200,-2800,4200,-2150,6650
7749,200,-600,-2700,-7900,1950,-9050
7750,0,-6200,1100,8100,1950,4950
7751,0,13700,900,-9800,-950,3850
7752,100,-9000,3800,7100,2900,4900
7753,-4500,-3400,200,-4900,1950,-10650
7754,10100,10800,6700,2000,0,29600
7755,0,9400,-12900,-1800,0,-5300
7756,-6600,-3500,1700,14200,0,5800
7757,8200,10100,-2800,3000,0,18500
7758,-1800,-2800,14000,-2000,0,7400
7759,8300,-3500,2800,12200,0,19800
7760,0,10300,-3600,-12000,0,-5300
7761,100,-5200,-3800,11200,0,2300
7762,-2900,-5600,-7200,7400,0,-8300
7763,0,800,8500,-1600,-1200,6500
7764,-3700,-700,100,-1000,0,-5300
7765,-3700,4400,4600,14200,-950,18550
7766,10000,400,-4800,1200,-950,5850
7767,200,6400,3000,3300,2900,15800
7768,100,-11300,2900,300,750,-7250
7769,-2700,-3400,200,9000,0,3100
7770,-2500,4400,15500,-14800,0,2600
7771,-3700,6700,-13600,15000,0,4400
7772,9200,-8400,2100,1000,0,3900
7773,-7300,-3400,15900,10000,0,15200
7774,13000,-6600,-1100,14200,0,19500
7775,-6600,13800,-6100,-11600,-1200,-11700
7776,400,3800,1800,9200,0,15200
7777,12000,-5900,-2500,-800,-2150,650
7778,-2700,-3400,12800,-3600,0,3100
7779,-6600,9200,1700,-500,750,4550
7780,6500,-3000,-13600,6400,-2150,-5850
7781,-2600,-8400,5500,-4500,1700,-8300
7782,5600,8500,-1800,3200,-2150,13350
7783,-3900,-11000,19700,-2800,0,2000
7784,10400,18400,-2300,-15500,1000,12000
7785,2000,-12200,7600,11400,-2150,6650
7786,200,19300,0,-5900,2900,16500
7787,0,-3500,100,5300,-9200,-7300
7788,-6600,3700,-6100,14200,-2150,3050
7789,100,9300,-3600,-4900,14900,15800
7790,100,-6200,-100,-3500,750,-8950
7791,-2800,-5500,14000,14200,-2150,17750
7792,6200,18600,1100,-11900,1950,15950
7793,200,-6200,1100,-6000,-950,-11850
7794,-3800,1800,2100,3300,1700,5100
7795,9000,1000,-7000,-2900,1950,2050
7796,-3700,-3300,-100,10200,-950,2150
7797,1000,4600,8200,-8800,0,5000
7798,0,-9300,1100,12100,1950,5850
7799,0,-9200,200,13000,-950,3050
7800,0,4500,3900,-17700,2900,-6400
7801,-6600,12900,5500,-6800,0,5000
7802,12100,-6400,-1800,13000,0,16900
7803,-2800,4900,-600,-11000,0,-9500
7804,0,3600,-6100,9200,0,6700
7805,-3600,-5800,300,9000,0,-100
7806,9400,10500,5600,-11000,0,14500
7807,-6400,3700,-4200,12000,0,5100
7808,12000,-5200,300,-5800,0,1300
7809,-2800,-3400,13100,12000,0,18900
7810,-3000,15700,200,-9000,0,3900
7811,-3600,-6400,4800,9000,0,3800
7812,6300,4600,3000,4200,-1200,16900
7813,-4700,-6300,3000,200,0,-7800
7814,10000,-8400,6600,12200,-1200,19200
7815,100,21600,-13600,-3000,0,5100
7816,0,3500,-12900,15200,0,5800
7817,100,-8100,14000,-2000,-950,3050
7818,-2800,-3700,200,11200,-950,3950
7819,200,-6300,3800,-9700,2900,-9100
7820,-2400,700,14900,-2700,750,11250
7821,10300,1000,3000,-11000,0,3300
7822,1000,3600,-9300,8200,0,3500
7823,-3000,6600,800,2200,0,6600
7824,-3000,6700,-2700,12200,0,13200
7825,-3000,-9100,5500,400,0,-6200
7826,-800,7500,-2600,-12800,-1200,-9900
7827,9000,900,4700,14200,0,28800
7828,-3000,-9200,4800,1000,0,-6400
7829,-2800,9200,3800,-2800,-950,6450
7830,8300,10000,12000,-8000,-950,21350
7831,100,6300,-2800,1100,2900,7600
7832,0,-2800,3800,-7700,1950,-4750
7833,-3000,9400,-1800,4000,0,8600
7834,-6300,-3000,1900,2200,-1200,-6400
7835,12000,-2600,-2000,9200,0,16600
7836,100,-5800,100,3200,-1200,-3600
7837,0,6400,4700,-1800,0,9300
7838,100,-800,-1000,-4000,-950,-6650
7839,0,4700,-5600,4200,0,3300
7840,-2700,-8100,100,9100,1950,350
7841,0,-6200,-700,-3700,750,-9850
7842,0,-8300,3900,0,0,-4400
7843,-5600,15800,2000,2000,0,14200
7844,-1600,-6300,2000,9400,-2400,1100
7845,7200,7300,2000,-10800,0,5700
7846,5400,6700,-8200,12400,0,16300
7847,-2700,-3500,3000,-5800,-950,-9950
7848,-3700,-2700,10900,14200,-950,17750
7849,12000,-3600,2900,4300,2900,18500
7850,-3000,19400,1100,-13700,1950,5750
7851,-4700,-2700,3800,11400,-1200,6600
7852,13000,-3600,1000,-2000,0,8400
7853,0,-2700,1000,11000,-950,8350
7854,-3900,12200,-3900,2400,-1200,5600
7855,-2000,-8200,1800,10300,1950,3850
7856,-2800,-6300,3900,0,-950,-6150
7857,11300,4500,-200,-14700,2900,3800
7858,-800,6500,-1700,-10600,-2400,-9000
7859,100,1000,-5200,10000,0,5900
7860,100,-5800,1000,14000,0,9300
7861,1000,6600,12100,-13000,-950,5750
7862,-2700,-3400,1100,10000,-950,4050
7863,100,10300,-7600,-12500,1700,-8000
7864,0,-8300,6700,2300,1950,2650
7865,-14000,6700,-7200,1200,-950,-14250
7866,14000,-3200,-4700,9200,0,15300
7867,-2800,10100,3900,-20500,1950,-7350
7868,-4700,-5200,9200,15200,-950,13550
7869,9400,-5500,600,-7300,1700,-1100
7870,1200,1000,1100,-1000,0,2300
7871,-3000,-5900,-2800,1400,-1200,-11500
7872,4700,7300,3900,0,0,15900
7873,-3600,6500,200,-600,-2150,350
7874,10300,-8900,2700,-800,-950,2350
7875,-3000,-5500,1100,12300,1700,6600
7876,-900,800,2400,-15300,750,-12250
7877,1000,2900,3900,9200,-2150,14850
7878,-3700,1700,-9100,3200,0,-7900
7879,9100,-9000,2000,10100,1950,14150
7880,0,-5400,13100,11000,-1900,16800
7881,0,-6300,4800,-5700,2900,-4300
7882,-6500,8600,3000,5300,1950,12350
7883,12000,-2700,100,-1000,0,8400
7884,0,12700,2900,100,1950,17650
7885,-2800,-6500,1700,2200,0,-5400
7886,-5700,9600,-1700,14000,0,16200
7887,11200,3800,-9800,-1000,0,4200
7888,-2900,5600,100,13000,0,15800
7889,100,-1400,19500,200,0,18400
7890,-3800,9300,-11900,1000,0,-5400
7891,-1700,-700,-3900,7200,0,900
7892,5400,4600,14100,-7000,0,17100
7893,100,-3500,1900,8200,0,6700
7894,-6600,-3300,2100,-600,-1200,-9600
7895,12100,10900,2100,3000,0,28100
7896,-5800,-6200,2100,1000,0,-8900
7897,11300,-2800,1000,10000,0,19500
7898,100,5400,4700,-1800,0,8400
7899,0,-600,-2700,-800,-1200,-5300
7900,-900,-5700,100,9400,-11400,-8500
7901,1000,21300,900,-13800,0,9400
7902,-4700,-5500,1100,1000,-950,-9050
7903,2000,6600,2000,6100,13950,30650
7904,-5600,6600,-1800,-8000,-950,-9750
7905,8400,-3400,1100,-5900,2900,3100
7906,-6500,4600,2100,2000,0,2200
7907,9400,-5700,1900,1000,0,6600
7908,-6500,6800,1200,1000,0,2500
7909,-2700,6600,-14000,12400,-1200,1100
7910,6300,-5400,-100,4400,-1200,4000
7911,-3600,-5400,900,-600,-2150,-10850
7912,12100,-9300,13000,14000,0,29800
7913,-6600,3900,200,-10900,1950,-11450
7914,200,4400,-5200,6200,-1900,3700
7915,9000,900,3000,-11900,2900,3900
7916,-3000,-6300,16800,-5700,1950,3750
7917,100,-2700,-4100,10600,-2150,1750
7918,-3700,9800,-2900,-17300,2900,-11200
7919,9000,2800,1800,14200,0,27800
7920,-2700,-5300,200,-3000,0,-10800
7921,-6600,-6200,3700,11400,0,2300
7922,5500,19300,3900,-11000,0,17700
7923,200,3700,2000,-1800,0,4100
7924,12100,-8400,1100,0,0,4800
7925,-5700,-6000,0,12200,0,500
7926,-900,900,2700,1200,0,3900
7927,100,100,300,0,0,500
7928,1000,1700,4800,-1000,0,6500
7929,0,-6300,1100,-2000,0,-7200
7930,-2900,-6200,500,12600,0,4000
7931,10300,16400,2000,-11000,0,17700
7932,-4700,6400,3800,200,0,5700
7933,-3800,-3400,-1300,-1400,0,-9900
7934,9000,-8300,2700,14200,0,17600
7935,0,6700,-1700,-11800,-1200,-8000
7936,-2500,8500,-2100,9400,0,13300
7937,0,1700,4800,-11000,0,-4500
7938,0,900,2100,1200,-2150,2050
7939,-3600,-3400,2900,9000,0,4900
7940,8200,-6400,1000,-1900,1950,2850
7941,1000,16600,-100,1200,-950,17750
7942,-3000,3700,2000,-11900,2900,-6300
7943,0,3700,-7100,9000,0,5600
7944,100,-2900,-900,2200,-1200,-2700
7945,-3700,-3600,13000,12000,0,17700
7946,12000,-2300,-3500,-1000,0,5200
7947,100,15600,1000,2000,-950,17750
7948,-5800,-6200,5800,-4700,1950,-8950
7949,0,-2700,2000,7200,-950,5550
7950,-3800,9300,-2100,2300,2900,8600
7951,9000,9700,-15500,11200,0,14400
7952,-2700,-8500,2700,13200,0,4700
7953,-3700,-6300,3000,0,0,-7000
7954,2800,100,16700,-1800,0,17800
7955,9300,4000,-2600,3000,0,13700
7956,0,9400,-100,17600,-10200,16700
7957,-2800,6600,-8900,-1000,0,-6100
7958,0,-5300,1200,8400,10800,15100
7959,-4700,-9200,16800,2000,0,4900
7960,10000,4400,4800,-12800,0,6400
7961,0,-3400,-2900,13200,0,6900
7962,-3000,-3400,2900,-1800,0,-5300
7963,-6300,22100,100,-11000,0,4900
7964,4500,-5300,2100,15000,0,16300
7965,10500,-3300,-1800,-2000,0,3400
7966,-3700,-2400,-1600,11000,0,3300
7967,1000,-5600,2000,-800,-1200,-4600
7968,0,18800,-8800,-7600,0,2400
7969,0,-8300,3900,0,-950,-5350
7970,-9400,3600,18700,-9000,-950,2950
7971,11100,-3600,1900,4300,-7300,6400
7972,1000,10300,-2700,-500,-450,7650
7973,200,3600,-2700,-9000,12000,4100
7974,-800,-8400,4800,7000,-950,1650
7975,-2600,-3600,3800,200,-2150,-4350
7976,8200,9200,-1200,-700,2900,18400
7977,-2000,10000,0,-12900,1950,-2950
7978,100,0,-1000,12000,0,11100
7979,-3900,-2500,-3500,13000,0,3100
7980,8700,-2800,4600,-5800,0,4700
7981,1200,-8500,-900,13000,0,4800
7982,-3000,3800,1100,-9000,0,-7100
7983,-2800,-8000,3100,-1800,-1200,-10700
7984,-4500,6700,-14500,13000,0,700
7985,13100,1100,-2300,2400,-950,13350
7986,-2700,-6300,14900,-3000,0,2900
7987,-6600,4400,2700,2300,1950,4750
7988,9100,900,2000,-6800,-2150,3050
7989,-900,-6200,-1600,16300,-7300,300
7990,-5600,1700,9500,-10800,0,-5200
7991,8100,-3600,4700,11200,0,20400
7992,1000,10100,-2100,-13800,12000,7200
7993,-3800,-600,-3600,14200,-1200,5000
7994,9000,-6400,4800,12400,-1200,18600
7995,100,22200,-2100,-14600,-950,4650
7996,-10200,-2800,3800,15000,-950,4850
7997,6300,100,-900,-1700,1700,5500
7998,12200,3600,-200,2400,-2150,15850
7999,100,-8500,2900,6500,-7300,-6300
8000,0,-6200,2700,8400,-950,3950
8001,-3700,7200,2900,-11000,11050,6450
8002,1000,9200,0,-15900,2900,-2800
8003,0,200,-3000,10500,750,8450
8004,0,-5400,200,12000,0,6800
8005,0,-9100,3900,-2000,0,-7200
8006,100,10100,100,-1800,-950,7550
8007,-5700,6500,2900,-11700,750,-7250
8008,10300,300,-3600,9000,-950,15050
8009,-1900,-5200,-2700,100,2900,-6800
8010,-2900,800,-4500,10400,0,3800
8011,0,-2800,100,-2000,0,-4700
8012,-3500,6600,-1000,200,0,2300
8013,8100,-3200,13200,-4600,0,13500
8014,-2700,4500,2700,-800,0,3700
8015,1000,-11100,5800,9200,-1200,3700
8016,0,6500,-11100,200,0,-4400
8017,-6300,-500,-1100,12200,-950,3350
8018,12100,7300,9300,-12000,0,16700
8019,-3000,-5600,5700,8300,1950,7350
8020,200,-6200,-3000,200,-950,-9750
8021,-3800,-3300,2100,3700,1700,400
8022,12000,16200,1100,-10600,-1200,17500
8023,-2800,-9200,7300,12200,0,7500
8024,100,7200,900,-12000,-950,-4750
8025,-2800,9300,-9900,11000,0,7600
8026,-2900,-2700,-2100,10300,1950,4550
8027,11300,-9100,14900,-1000,-950,15150
8028,-2700,-2600,-800,8100,2900,4900
8029,0,-3200,-1900,-4600,0,-9700
8030,-2800,19200,1100,0,0,17500
8031,-10200,-2500,5800,7400,-10200,-9700
8032,10200,-3400,1100,10200,-1200,16900
8033,8500,-2800,1900,0,0,7600
8034,-5800,8400,2000,2000,12000,18600
8035,10300,7200,2800,-12000,0,8300
8036,-2000,200,-1800,13000,0,9400
8037,-700,100,-3800,0,0,-4400
8038,1000,-8100,1200,-3000,0,-8900
8039,-2900,-9000,2000,0,0,-9900
8040,100,-5500,-1400,11400,0,4600
8041,-2800,12800,2100,-8000,0,4100
8042,-7300,-3300,200,-2800,0,-13200
8043,13000,-5500,4800,8200,0,20500
8044,-5700,15800,-8000,2000,0,4100
8045,-700,6500,-11700,-4000,0,-9900
8046,9100,-6400,13900,3200,-1200,18600
8047,-3600,4700,3000,-12000,0,-7900
8048,6400,6800,11100,-10800,-950,12550
8049,-800,-11300,-5300,19400,0,2000
8050,-5600,3900,1800,-10500,750,-9650
8051,9200,-3500,2000,9000,-950,15750
8052,0,7400,11300,-15700,2900,5900
8053,-6500,-3500,2600,12200,0,4800
8054,12000,-3500,100,9000,0,17600
8055,0,13500,2000,-7000,0,8500
8056,-3800,6500,-9000,13000,0,6700
8057,1100,-2300,-4400,-5000,0,-10600
8058,-6600,-5500,1800,14200,0,3900
8059,9200,3900,6900,-2800,0,17200
8060,0,-400,-5400,-4000,0,-9800
8061,-2800,7200,15600,-14600,0,5400
8062,-6500,-8300,3600,15200,0,4000
8063,12000,-6500,-1700,-1000,0,2800
8064,100,13600,-2500,-2400,-1200,7600
8065,-3700,-2800,100,-1000,0,-7400
8066,12000,9200,-7200,6400,-2150,18250
8067,200,-2800,8000,3400,-1200,7600
8068,-8600,100,2000,11300,750,5550
8069,11200,-5300,12200,-2000,-1900,14200
8070,0,-5800,1000,11100,2900,9200
8071,-2900,800,-6400,-1700,1950,-8250
8072,0,-600,-1800,-800,-2150,-5350
8073,-2700,10200,12100,-16700,2900,5800
8074,-3800,6500,-800,-10000,-950,-9050
8075,-2500,-5600,4700,8000,0,4600
8076,12100,-2600,-2000,9500,750,17750
8077,-5600,9200,500,-10600,-950,-7450
8078,11300,-5500,2900,5300,2900,16900
8079,0,-8300,200,2200,-1200,-7100
8080,-3000,3700,-10100,13200,0,3800
8081,-2800,-3600,4800,-2800,-950,-5350
8082,-6500,10200,11100,4000,0,18800
8083,8100,9200,-1800,-8000,-950,6550
8084,1000,-5500,3800,8100,2900,10300
8085,-2700,-5300,200,8300,750,1250
8086,-1700,-5400,1100,0,0,-6000
8087,12200,-3500,-1900,10000,0,16800
8088,1100,-6200,-2100,-800,0,-8000
8089,-8600,15800,3100,5000,0,15300
8090,-1700,1700,5800,-13800,0,-8000
8091,3600,-800,2800,15000,0,20600
8092,12000,-5600,2900,0,0,9300
8093,200,11400,-4700,12000,0,18900
8094,100,-5300,-700,-2000,0,-7900
8095,100,-6200,100,-2000,0,-8000
8096,-1800,13700,4800,-10600,-2400,3700
8097,-1600,-6200,-2200,-600,0,-10600
8098,-5400,-3200,900,8400,-950,-250
8099,11300,16500,200,-14000,-950,13050
8100,-5400,-3200,-900,-7700,2900,-14300
8101,-4600,1600,4500,-1500,1950,1950
8102,13100,-9200,2100,9200,0,15200
8103,-2400,7300,2900,-19800,0,-12000
8104,-2000,1100,800,4200,0,4100
8105,-3000,-6100,200,2000,0,-6900
8106,11200,-10800,2200,10200,-1200,11600
8107,100,5600,2000,-2800,0,4900
8108,-6700,-11800,7700,14000,0,3200
8109,-2600,10100,-800,-800,-2150,3750
8110,9200,12600,5700,-7000,-950,19550
8111,-3000,-700,-900,11100,2900,9400
8112,-900,10200,-1800,-15900,1950,-6450
8113,5600,6500,100,4400,-2400,14200
8114,1000,-6300,1700,-1800,0,-5400
8115,-3700,4600,-1600,3000,-950,1350
8116,1200,3700,2000,-13000,0,-6100
8117,-9400,-500,200,11100,1950,3350
8118,12100,1600,3800,200,-2150,15550
8119,-2700,-5500,3900,-4900,2900,-6300
8120,8200,9500,-2700,-8800,-1200,5000
8121,0,6600,-2900,200,-950,2950
8122,-7500,-2400,-1200,12600,-950,550
8123,7200,-5400,1200,-1900,2900,4000
8124,100,-9000,3000,14300,-8250,150
8125,-1800,-1100,2100,-7000,0,-7800
8126,-1000,-9100,3000,11000,0,3900
8127,11200,-6300,2000,-1000,12000,17900
8128,-5500,16400,2900,5000,0,18800
8129,-2900,-6300,2900,-1800,0,-8100
8130,-800,-400,-5400,11000,0,4400
8131,12000,13600,-1000,4200,0,28800
8132,-3000,1000,3000,-8000,0,-7000
8133,-2700,-6300,3900,9000,0,3900
8134,-6600,-2700,2000,3000,0,-4300
8135,9000,12800,4800,4000,0,30600
8136,-2700,-3300,100,-2000,0,-7900
8137,-3800,2000,-8800,15000,0,4400
8138,12000,-6300,2000,10000,0,17700
8139,-2700,-2600,12100,-1000,0,5800
8140,2700,18500,2000,4200,-1200,26200
8141,-900,-3500,100,200,-1200,-5300
8142,1000,4600,2000,-2000,0,5600
8143,-3700,-6400,1000,3000,-950,-7050
8144,9000,3600,3800,-700,750,16450
8145,100,11500,-2700,-4000,0,4900
8146,-3900,7400,1100,-500,750,4850
8147,-1800,-5400,-1000,-800,-950,-9950
8148,-800,-6300,1100,11000,-950,4050
8149,9000,-5500,2600,-700,1950,7350
8150,0,3700,-8000,6100,2900,4700
8151,-2800,8700,-2700,2200,-1200,4200
8152,0,4400,14000,1000,0,19400
8153,0,-9100,4800,-1000,-950,-6250
8154,-4500,-800,-2900,12000,0,3800
8155,8300,7300,800,-14300,750,2850
8156,-700,12200,100,4200,-950,14850
8157,-9200,6500,2900,-12500,500,-11800
8158,4500,0,100,13000,0,17600
8159,13100,100,700,14800,-11150,17550
8160,-3000,-2700,2900,-1800,0,-4600
8161,0,100,-800,4300,13950,17550
8162,-900,200,1000,-6500,750,-5450
8163,1100,200,-2700,-3000,0,-4400
8164,-3600,-11400,6700,13000,-950,3750
8165,12200,9300,-13100,-2600,-1200,4600
8166,-900,-2300,-5300,8300,750,550
8167,-2600,700,-5500,-2600,-950,-10950
8168,1100,-5400,10000,8300,1950,15950
8169,-2800,3800,1000,-11800,-950,-10750
8170,-3600,-3400,13100,8100,2900,17100
8171,11100,4400,2000,-13900,1950,5550
8172,-2700,-6200,200,10000,0,1300
8173,-4500,-6300,4000,-4800,0,-11600
8174,-4500,19200,500,1400,0,16600
8175,7500,700,4800,-8800,-1200,3000
8176,5400,-3500,3900,11200,0,17000
8177,0,7200,100,-11000,0,-3700
8178,-3800,-6100,2000,13000,0,5100
8179,9000,7300,-800,-7800,-1200,6500
8180,-2800,-6100,3100,8200,0,2400
8181,8200,7600,-800,4000,-950,18050
8182,0,-3600,-1100,-800,0,-5500
8183,100,4700,-1700,-2900,1950,2150
8184,0,-9100,3900,-2600,-3350,-11150
8185,-3000,7400,3000,-3500,2900,6800
8186,0,900,-700,-8000,-950,-8750
8187,0,-8300,2700,9200,0,3600
8188,-3900,6700,-8900,9300,1950,5150
8189,1000,-9000,2100,-3000,-950,-9850
8190,-800,-5600,4600,17300,2900,18400
8191,-2600,18500,-1700,-8000,0,6200
8192,6300,-3500,13100,12000,0,27900
8193,-3300,-5600,4600,-5800,0,-10100
8194,9400,18500,-900,2000,0,29000
8195,-2900,-8400,3800,1200,-1200,-7500
8196,100,6600,-3600,-1000,0,2100
8197,-3800,-6400,6600,12200,0,8600
8198,12000,7000,0,-8000,0,11000
8199,0,-600,-1800,10000,0,7600
8200,-2800,4800,-2900,-7800,0,-8700
8201,-2900,-2700,-1700,13000,0,5700
8202,0,-9000,2100,-3000,0,-9900
8203,-3800,900,6700,2200,0,6000
8204,7200,4400,3800,-9000,0,6400
8205,2000,9400,-11800,8200,-1200,6600
8206,-3900,-3600,100,15000,0,7600
8207,1100,7200,12100,-13800,-950,5650
8208,0,-5600,3800,11200,-1200,8200
8209,-1800,-800,0,-4900,1950,-5550
8210,-2600,10200,-1800,2000,-950,6850
8211,10200,-2500,200,-8900,2900,1900
8212,-5600,-2600,2100,13200,-1200,5900
8213,8200,-3300,200,-1800,0,3300
8214,-2700,7400,100,0,-950,3850
8215,-2800,-2800,1700,-800,0,-4700
8216,4600,-3500,1000,11100,1950,15150
8217,-3400,7500,2100,-5800,-950,-550
8218,10100,-5500,-1000,-1700,2900,4800
8219,-8500,-6300,5700,14200,-1200,3900
8220,11300,7200,1000,-1800,-10200,7500
8221,-6600,-700,0,13000,0,5700
8222,8300,100,-4000,1200,12000,17600
8223,1100,-5400,100,12400,-2400,5800
8224,-1800,5700,1100,11000,0,16000
8225,-900,-11100,6700,-1000,-950,-7250
8226,-2700,-600,-800,-2000,-950,-7050
8227,5600,6500,3900,-3700,1700,14000
8228,0,9200,-10000,-3900,1950,-2750
8229,-2800,12400,-2600,-3000,-950,3050
8230,-4600,-3300,-2600,2200,-1200,-9500
8231,9300,-5400,15900,7100,1950,28850
8232,100,7400,-1700,-13000,0,-7200
8233,100,-6200,3000,-7700,1950,-8850
8234,-1600,4500,1900,-1000,0,3800
8235,-3500,6500,1100,-14000,0,-9900
8236,9000,-2700,2000,12400,-1200,19500
8237,-2800,3700,-9100,0,0,-8200
8238,-6400,-2400,1200,10200,-1200,1400
8239,8500,-6400,12100,13200,-2150,25250
8240,9100,-5600,2000,1200,-2150,4550
8241,100,5700,4800,3500,1700,15800
8242,-2800,4200,2900,-9700,-200,-5600
8243,-3700,9300,-1900,3000,0,6700
8244,12200,-2800,100,-7900,1000,2600
8245,-3000,-2500,100,12100,1950,8650
8246,-3000,-6400,1700,2200,-950,-6450
8247,0,0,-900,7100,2900,9100
8248,-3800,21300,100,-12700,1950,6850
8249,12000,100,1900,7200,0,21200
8250,100,200,-4600,-4000,0,-8300
8251,-5500,-5500,-4700,20400,0,4700
8252,-3800,0,-900,3200,-1200,-2700
8253,11100,500,10400,4400,0,26400
8254,-1900,-5600,1900,2000,0,-3600
8255,-900,-8800,-900,-2800,-950,-14350
8256,-2000,4500,-2000,-8800,-950,-9250
8257,-1800,-11800,4600,9500,750,1250
8258,2000,-6200,100,-4900,2900,-6100
8259,-7400,19500,-2900,12400,-10200,11400
8260,13200,3600,3900,-2800,0,17900
8261,-6700,-2700,3900,-600,10800,4700
8262,-5400,3700,4800,-1000,0,2100
8263,12000,600,-6200,3000,-950,8450
8264,-800,100,1000,4200,0,4500
8265,-1800,6400,14900,-15700,750,4550
8266,7400,-800,-2200,15200,-950,18650
8267,-7400,10200,-900,100,2900,4900
8268,-600,400,-7400,-2000,0,-9600
8269,9300,-8400,2100,13000,0,16000
8270,-4600,-6400,7600,-3800,0,-7200
8271,-1800,4500,2000,3000,0,7700
8272,9000,3700,-6100,-2800,0,3800
8273,-2800,-800,100,11000,0,7500
8274,8300,7300,13900,-9000,0,20500
8275,-2900,200,-4200,13600,-1200,5500
8276,100,-2600,-2700,-2000,0,-7200
8277,-6500,-5500,3000,14000,-950,4050
8278,9000,6900,-700,-11800,0,3400
8279,0,-8900,1200,-4900,1950,-10650
8280,-3600,-8500,3000,13000,-950,2950
8281,9100,18800,-3700,-16100,500,8600
8282,-2700,-3500,2900,-2800,0,-6100
8283,-6600,10200,200,-800,0,3000
8284,12000,-8200,-2800,2800,-950,2850
8285,-9400,-3400,3000,15000,-950,4250
8286,9100,4500,100,-11900,2900,4700
8287,100,800,14600,-3700,1950,13750
8288,-2800,-9200,2900,3200,-1200,-7100
8289,8200,0,2800,12000,-4800,18200
8290,0,9300,-11800,10200,-1200,6500
8291,-2800,6400,2000,0,0,5600
8292,100,-6300,13000,11000,-950,16850
8293,-7400,10300,-2700,-7000,-950,-7750
8294,7200,6500,100,100,1950,15850
8295,8500,-8400,6400,-6300,750,950
8296,0,200,-3600,9300,-200,5700
8297,-5800,-3000,-1600,200,-1200,-11400
8298,-3600,-5600,3900,9100,1950,5750
8299,9000,5900,900,-1600,-1900,12300
8300,-6600,4600,2100,-700,1700,1100
8301,9200,3600,4800,-13900,1950,5650
8302,-2900,3800,-9000,15000,-950,5950
8303,11200,0,-11100,16300,1950,18350
8304,200,1100,1200,-2900,1950,1550
8305,0,-8500,3900,9200,-950,3650
8306,-2800,-3500,2900,-4700,1700,-6400
8307,100,-2600,9000,5500,-8250,3750
8308,-5800,13200,2200,-9600,-2400,-2400
8309,-3600,-6500,13100,2000,12000,17000
8310,9300,4700,2100,1000,-950,16150
8311,-9300,9300,1000,-9000,-950,-8950
8312,11100,-3400,-1700,8100,2900,17000
8313,1100,4200,4800,-5300,750,5550
8314,-2900,-400,100,-4400,-1200,-8800
8315,-3600,10100,-11100,-1800,-950,-7350
8316,9100,-5400,-1000,12200,0,14900
8317,0,-5400,12900,13900,-9450,11950
8318,-900,-6100,900,-2600,-950,-9650
8319,-8300,4800,2200,-2900,14900,10700
8320,12300,900,0,-12000,-950,250
8321,-3800,-3500,-1700,14000,-950,4050
8322,6200,7500,4900,-16500,2900,5000
8323,0,1100,2100,0,-950,2250
8324,-9200,-5300,1300,-900,2900,-11200
8325,9100,3900,-11700,14000,0,15300
8326,-700,900,3000,-13000,0,-9800
8327,12000,-9000,8300,15200,0,26500
8328,-2800,1700,8600,-13800,0,-6300
8329,-2700,3500,1000,4000,0,5800
8330,-3000,-9200,4800,2000,0,-5400
8331,10300,-1000,5800,1000,0,16100
8332,-1800,6600,-100,-13600,0,-8900
8333,-2900,-9000,200,11000,0,-700
8334,-2800,7400,2700,9000,-12600,3700
8335,11200,3900,-1900,-8800,0,4400
8336,100,-9200,1100,12200,10800,15000
8337,100,-8300,4800,-3000,-950,-7350
8338,0,9900,-6100,15000,-950,17850
8339,-2800,-3600,0,-1900,2900,-5400
8340,0,7400,11200,-2900,1950,17650
8341,-6500,6600,100,5200,-1200,4200
8342,9200,-3600,4800,-3800,0,6600
8343,-6600,10000,1900,-8800,-2150,-5650
8344,12100,9400,-4900,2400,-1200,17800
8345,0,-9200,4800,6300,-8250,-6350
8346,-1700,-2700,0,9100,1000,5700
8347,-600,18400,1900,-2000,12000,29700
8348,0,-800,0,-3900,1950,-2750
8349,0,10200,-2700,-1000,-950,5550
8350,-3000,-2500,-100,-3500,2900,-6200
8351,-3600,-2300,-1600,-1600,-2400,-11500
8352,9000,-2700,-2900,13200,0,16600
8353,0,-11800,5800,-2000,0,-8000
8354,-6400,-500,-3800,11200,-950,-450
8355,6500,13700,5700,2000,-950,26950
8356,0,1100,-7900,-3900,2900,-7800
8357,-3800,-5400,200,12100,1950,5050
8358,9000,3600,2900,-10000,0,5500
8359,100,-9100,15000,9200,-1200,14000
8360,-3000,-2700,-14300,14600,0,-5400
8361,-3000,18500,4800,-2600,0,17700
8362,-3400,-3600,17600,-4800,0,5800
8363,12000,7100,-1800,4000,0,21300
8364,-5800,6700,-100,-8800,0,-8000
8365,11200,0,-900,11000,0,21300
8366,-3900,-5100,-2800,3400,-1200,-9600
8367,200,-6200,200,6200,0,400
8368,1100,-1100,4900,-14000,0,-9100
8369,-9300,1000,4600,6200,-950,1550
8370,9000,-6400,2000,-1900,1950,4650
8371,0,4500,1700,2200,-950,7450
8372,-900,3700,2900,-14900,2900,-6300
8373,-5600,-500,-11900,24400,-1200,5200
8374,9100,1600,2900,-8000,0,5600
8375,100,3700,14900,0,0,18700
8376,100,9300,-2800,-10800,-1200,-5400
8377,-4400,6500,-9000,9000,0,2100
8378,10100,-5400,-200,3400,-2150,5750
8379,-900,-3400,-1700,10000,0,4000
8380,-4800,-2700,15900,-3700,1950,6650
8381,-9300,0,1900,14000,-950,5650
8382,23200,9300,2000,-8700,2900,28700
8383,0,-3500,2900,8400,-1200,6600
8384,0,200,-3000,-1800,0,-4600
8385,-2600,9300,0,11200,-1200,16700
8386,-3000,-5300,-1900,2400,-2150,-9950
8387,5600,6600,-8800,14400,-2400,15400
8388,-900,-5500,3900,-5500,-200,-8200
8389,1000,-6100,10300,8100,1950,15250
8390,100,1600,2600,2200,0,6500
8391,-900,-2000,6400,-13700,1000,-9200
8392,-1600,9300,-10000,11200,-2150,6750
8393,-4500,-700,-800,-5900,2900,-9000
8394,400,7400,100,-4300,-1400,2200
8395,8400,-5300,15000,-5700,750,13150
8396,1100,3600,-8000,9000,-1900,3800
8397,-1900,-5300,1100,-5900,2900,-9100
8398,0,6400,1000,-500,-450,6450
8399,-3500,-2700,11000,1000,-950,4850
8400,4500,6600,-9900,9300,750,11250
8401,-800,-2700,1100,15300,-8250,4650
8402,11300,-6200,12200,-2000,-1900,13400
8403,0,-4100,6700,100,14900,17600
8404,-2800,9300,-9900,-2900,1950,-4350
8405,-3000,400,-3800,9400,-950,2050
8406,-4500,6400,12800,-12700,2900,4900
8407,9100,-8400,7600,7300,1950,17550
8408,-2900,-800,0,0,0,-3700
8409,1100,10100,-1900,9200,-10200,8300
8410,-4700,-2700,100,15000,0,7700
8411,9300,300,200,-6800,0,3000
8412,200,3700,-200,200,12000,15900
8413,-1900,-2800,800,-1200,-2400,-7500
8414,100,-5100,-1000,8400,0,2400
8415,8300,6400,-11000,200,0,3900
8416,200,-12100,3800,12200,-950,3150
8417,-2800,-5400,100,11000,-950,1950
8418,-2800,9300,3100,-5500,1700,5800
8419,-3800,100,2700,-700,1950,250
8420,9500,7500,10300,-15000,0,12300
8421,100,-1900,2700,2400,0,3300
8422,0,-2000,2100,-10000,0,-9900
8423,-3000,-5500,-8200,23200,0,6500
8424,0,3600,4800,-14800,0,-6400
8425,-3800,9500,12100,200,0,18000
8426,9200,-5500,100,1200,-1200,3800
8427,-2800,6500,-8900,12000,0,6800
8428,0,-6500,2900,11200,-950,6650
8429,0,-5500,14900,-3000,0,6400
8430,-3800,9400,-25000,22700,750,4050
8431,9000,3100,1200,0,-950,12350
8432,0,1600,17400,-12500,1700,8200
8433,0,-3400,1100,-3800,0,-6100
8434,100,-3300,-3600,10000,-950,2250
8435,-2900,4500,3000,-1000,-950,2650
8436,-800,15800,-11000,8300,2900,15200
8437,-8400,-5600,9500,-3700,1950,-6250
8438,12000,6200,12000,-9800,-1200,19200
8439,0,200,-2700,-1000,0,-3500
8440,200,-6600,1800,10200,0,5600
8441,0,300,7500,-800,-1200,5800
8442,0,1100,4900,11000,0,17000
8443,-3000,6400,100,-8000,-950,-5450
8444,10300,-3500,1100,4200,-950,11150
8445,-1900,1800,700,-8500,1700,-6200
8446,-3000,900,-6300,8500,1950,2050
8447,-6300,-600,1000,-3000,0,-8900
8448,9300,4500,800,2200,0,16800
8449,-2900,-2800,8100,2200,0,4600
8450,-800,3600,6600,-3800,0,5600
8451,12000,-6400,3800,-800,-1200,7400
8452,-2900,10100,-5200,4400,0,6400
8453,200,6900,-700,-6400,-2150,-2150
8454,-2900,-5500,1000,2000,0,-5400
8455,0,-8400,-700,-1900,1950,-9050
8456,-3500,6400,4700,-3800,-950,2850
8457,9300,-3400,-800,-2900,2900,5100
8458,-3700,4600,1200,200,0,2300
8459,-800,-9000,3000,9000,0,2200
8460,2000,1400,200,-9800,-1200,-7400
8461,100,-6200,2600,9400,0,5900
8462,-3800,6800,-10700,-2800,0,-10500
8463,9400,3500,2000,13000,-950,26950
8464,-3900,-6200,3000,-800,-950,-8850
8465,1100,3900,300,7100,2900,15300
8466,0,3600,5700,-3900,1950,7350
8467,-3600,6600,15000,-3800,0,14200
8468,12000,9200,-9900,-3600,-1200,6500
8469,-2600,-2900,2800,8200,0,5500
8470,-900,6600,-3200,-12600,0,-10100
8471,1100,-8400,10900,12200,0,15800
8472,-6700,3800,2100,-5800,-1200,-7800
8473,12200,-12200,3900,13000,0,16900
8474,0,4800,1200,-14800,-950,-9750
8475,-900,1000,1200,2000,-950,2350
8476,1000,-6300,5700,-9700,2900,-6400
8477,0,0,0,7100,1950,9050
8478,0,3500,100,-7000,0,-3400
8479,-800,15700,-11700,11000,0,14200
8480,1000,-5500,1700,-1800,0,-4600
8481,-3000,-6200,1100,14000,0,5900
8482,-900,3500,1200,13000,0,16800
8483,1000,9200,2900,-4600,-1200,7300
8484,0,3500,13900,5200,-1200,21400
8485,-3000,-700,-900,1000,0,-3600
8486,-3500,10200,-2700,0,0,4000
8487,9200,-2700,-2100,400,-950,3850
8488,-2800,-8400,7600,10000,-950,5450
8489,0,-3400,100,-5900,2900,-6300
8490,-2700,3400,1700,1500,750,4650
8491,-3800,10200,-4500,-10000,0,-8100
8492,12000,-5400,2700,6400,0,15700
8493,-2900,3600,-7400,1600,-1200,-6300
8494,-700,-8600,1600,12200,0,4500
8495,1000,9200,-900,-13000,-950,-4650
8496,100,-6200,13000,12200,-1200,17900
8497,-3000,7400,-800,-11700,750,-7350
8498,10400,-2800,100,9400,-2150,14950
8499,-1700,3700,2600,-3500,750,1850
8500,-2700,-500,-3600,-800,-1200,-8800
8501,2600,7400,5800,-3500,750,13050
8502,-6600,-5300,-1000,2200,-1900,-12600
8503,11300,-2700,1100,4300,2900,16900
8504,-2000,-9100,3900,-1900,1000,-8100
8505,100,-11300,2900,12000,0,3700
8506,200,8500,1900,4300,1950,16850
8507,-3800,-600,-2700,-900,1950,-6050
8508,9200,12900,1200,3200,-2150,24350
8509,-900,-5300,-700,-3900,2900,-7900
8510,-2900,3600,5700,-800,0,5600
8511,-4700,5800,2000,1200,-1200,3100
8512,8400,-2300,-1600,11000,0,15500
8513,200,800,-1800,3000,-950,1250
8514,-3600,13000,-10200,3400,-1200,1400
8515,12000,-8100,1200,8100,1950,15150
8516,-5700,-3500,200,0,-950,-9950
8517,-6500,-6400,18600,9700,500,15900
8518,7500,6400,3800,-1000,0,16700
8519,-3600,3800,100,3000,-950,2350
8520,11000,-8300,3900,12000,0,18600
8521,-2700,8500,2000,-3500,-450,3850
8522,-3600,-700,1000,11000,-950,6750
8523,8500,9600,-1700,-4900,2900,14400
8524,-1700,-700,-1700,10000,-950,4950
8525,100,-5500,2900,4400,-11150,-9250
8526,0,900,6700,7100,2900,17600
8527,100,-3800,0,-700,12750,8350
8528,-2900,11400,-1800,12000,0,18700
8529,11200,10000,-1800,1000,-950,19450
8530,-3000,6600,800,3200,0,7600
8531,0,-9100,200,-1900,1950,-8850
8532,-3700,-5500,2700,11200,0,4700
8533,-2400,18500,100,-17500,750,-550
8534,12100,-6100,-800,-1600,-2400,1200
8535,100,4700,-700,0,0,4100
8536,-13100,6400,-3300,2000,-950,-8950
8537,4500,-3400,2900,12000,0,16000
8538,11300,7300,-800,-14900,1950,4850
8539,-5800,100,14900,12200,-950,20450
8540,-700,-5800,1900,8100,2900,6400
8541,11100,-600,-1800,-1000,0,7700
8542,1000,4300,-2900,12600,-11400,3600
8543,0,-8400,6600,-2000,0,-3800
8544,-3000,9400,-1800,4000,11050,19650
8545,-4800,-800,-1800,1000,0,-6400
8546,2200,4700,-200,-8500,1950,150
8547,-3600,-2600,-2700,2000,-950,-7850
8548,5500,-3300,4900,5300,2900,15300
8549,9300,4500,-800,-10000,0,3000
8550,-3000,-8200,900,200,0,-10100
8551,0,900,2100,1200,-1200,3000
8552,-3000,-9100,7600,-1800,0,-6300
8553,-6600,7200,3800,4000,0,8400
8554,8200,-600,-2800,13000,0,17800
8555,1100,9200,-13000,-2600,-1200,-6500
8556,-3000,9200,2900,10200,0,19300
8557,8300,-5300,800,1200,-950,4050
8558,100,-3600,11100,-2000,0,5600
8559,0,1700,-700,1100,1950,4050
8560,100,-6100,200,-5000,-950,-11750
8561,-2900,-8200,2900,13300,1700,6800
8562,-4400,800,2000,-8000,0,-9600
8563,10300,6500,2000,-2800,-1200,14800
8564,-6600,3800,2100,1000,0,300
8565,-3600,-9300,1500,2400,0,-9000
8566,11200,-3200,-3500,10200,-2150,12550
8567,2000,6700,4000,-7600,-950,4150
8568,-3000,3700,2900,-2700,-7300,-6400
8569,0,800,1200,-700,750,2050
8570,100,1200,-8800,9200,-1200,500
8571,0,-6300,-1700,3000,11050,6050
8572,-800,4400,12800,-1400,0,15000
8573,1000,1300,-1900,-14700,1950,-12350
8574,100,-9200,3800,8100,1950,4750
8575,-3000,4600,200,-8000,0,-6200
8576,9500,3700,-8900,8000,0,12300
8577,-600,3800,-10300,-2400,-1200,-10700
8578,0,-8200,14100,11000,0,16900
8579,0,-6300,2900,-4000,0,-7400
8580,-2800,-6100,12000,12200,-950,14350
8581,0,19400,-1700,-12000,-950,4750
8582,0,-1900,4900,-2700,1950,2250
8583,100,-5300,-2600,-3700,1700,-9800
8584,-2800,3800,-100,400,0,1300
8585,11200,-8900,3000,11200,-1200,15300
8586,-8600,-2700,3900,2000,0,-5400
8587,-500,15800,2000,-3600,-1200,12500
8588,12100,-9000,2100,-3000,-950,1250
8589,-3000,-5500,2000,13000,0,6500
8590,-3000,12800,3900,-10700,750,3750
8591,100,-6200,-800,10000,-950,2150
8592,-4600,2000,200,-9900,1950,-10350
8593,13300,1000,-200,-1800,-950,11350
8594,-3600,-3400,-800,5300,-7300,-9800
8595,-2000,1800,2100,1100,1950,4950
8596,-3000,-8800,1200,1000,12000,2400
8597,11200,3000,4900,6200,0,25300
8598,-2900,1200,300,4000,0,2600
8599,-14900,10200,4900,-9000,0,-8800
8600,6500,-6100,-800,12000,0,11600
8601,14100,-3400,-2000,-5400,-1200,2100
8602,-6400,19200,3800,-1000,0,15600
8603,12200,600,-8000,200,-1200,3800
8604,200,-6100,1100,8200,0,3400
8605,-3900,4400,2000,4000,-950,5550
8606,1100,-6300,14900,-6800,-950,1950
8607,-3000,-8300,3900,13300,1700,7600
8608,8400,18500,2000,-13900,1950,16950
8609,0,-1900,4600,-800,0,1900
8610,-3000,-6200,2000,15000,0,7800
8611,100,7400,-4500,-10000,0,-7000
8612,-2600,-3300,-5100,10400,0,-600
8613,-3800,-3400,-700,200,0,-7700
8614,9000,3900,5800,11200,0,29900
8615,-2700,6500,-800,-13000,0,-10000
8616,0,2800,5700,12600,-3600,17500
8617,-2700,4500,1700,-10800,0,-7300
8618,-800,1100,1200,1000,-950,1550
8619,12000,-6400,-2600,1000,0,4000
8620,-3900,1700,6700,-2700,1950,3750
8621,100,-6000,2100,4300,1000,1500
8622,-2900,-3400,1100,-3800,-950,-9950
8623,-2600,19400,-1600,-3900,2900,14200
8624,12200,6600,-7000,-10500,1950,3250
8625,0,-8000,2100,10000,0,4100
8626,-2800,6500,3900,-14800,0,-7200
8627,-6400,9300,11000,1200,0,15100
8628,9200,-2700,7600,5400,0,19500
8629,-2800,3600,1100,-10000,0,-8100
8630,0,-3400,-800,9200,-1200,3800
8631,-3500,4300,2000,-8000,0,-5200
8632,6200,-600,-800,14200,-1200,17800
8633,100,-6100,1100,-3000,0,-7900
8634,-3800,4400,2000,4000,0,6600
8635,6300,8500,2900,1200,-2150,16750
8636,0,-800,0,7000,-950,5250
8637,-3800,12000,-2400,1500,2900,10200
8638,12100,-600,-3600,6100,1950,15950
8639,-3000,11200,3800,-4600,0,7400
8640,-5800,6500,500,4600,-1200,4600
8641,7500,200,-1700,-2000,0,4000
8642,-1800,9600,300,8400,-2150,14350
8643,0,-8500,1100,13000,0,5600
8644,-2700,5700,-3600,3500,1950,4850
8645,-3800,7300,100,2000,-950,4650
8646,6200,-3300,9200,-2700,2900,12300
8647,-1600,-9100,4800,9000,0,3100
8648,7400,19200,2600,-9800,0,19400
8649,-2800,-3500,-1800,12000,0,3900
8650,8400,7400,1100,-13000,0,3900
8651,-3000,-6400,2900,15000,0,8500
8652,-900,300,100,7200,0,6700
8653,1000,-2800,100,-4000,0,-5700
8654,-3600,9200,2800,11000,0,19400
8655,8100,9200,-1200,-7800,0,8300
8656,300,-2600,-1800,9000,0,4900
8657,-2000,0,100,-800,0,-2700
8658,0,-5700,2600,9400,0,6300
8659,-2800,-500,-1000,-3600,0,-7900
8660,7500,4200,1700,5200,0,18600
8661,-2800,-2600,-4800,11200,0,1000
8662,-2600,3900,2100,-15800,0,-12400
8663,6300,-5600,3800,16200,-1200,19500
8664,0,1000,4900,-15800,0,-9900
8665,0,-6400,3800,13200,-2150,8450
8666,0,7400,-11000,-2800,0,-6400
8667,0,6400,-200,-1700,1950,6450
8668,0,-6300,2900,-1000,-950,-5350
8669,-2800,10000,11800,-3700,2900,18200
8670,-800,-2600,-2900,-600,-1200,-8100
8671,6200,-3200,200,15000,0,18200
8672,-6600,10100,2000,-800,-950,3750
8673,9300,-5400,2000,1600,-3600,3900
8674,-5800,-2800,4800,6300,1950,4450
8675,10400,9200,-1000,-12000,-1900,4700
8676,-5600,0,100,11500,500,6500
8677,9000,300,100,-4700,1950,6650
8678,100,-5200,-700,9000,-1900,1300
8679,100,-8500,-1100,-700,2900,-7300
8680,-5600,-6400,3000,9100,1950,2050
8681,11200,-6200,200,-3000,-950,1250
8682,-5700,19400,1100,100,2900,17800
8683,-2800,3600,-5200,-1000,0,-5400
8684,11400,-6300,2900,8000,0,16000
8685,-3000,10200,10200,-10000,0,7400
8686,0,4100,-12500,11000,0,2600
8687,-3700,-2600,200,-3000,0,-9100
8688,-2700,-9000,12800,15200,0,16300
8689,9000,-5300,1200,11200,0,16100
8690,-6400,6500,-7000,-1000,0,-7900
8691,6200,6500,4800,12000,0,29500
8692,-3900,3700,2000,-9000,0,-7200
8693,200,-5400,11900,11200,0,17900
8694,12000,6400,1000,-11000,0,8400
8695,0,-800,2800,7200,0,9200
8696,0,7100,-3000,-6800,0,-2700
8697,0,-8500,2000,12000,0,5500
8698,-2900,-3600,-2100,3200,0,-5400
8699,-2800,7500,1800,-1400,-1200,3900
8700,100,3500,1000,-10600,-1200,-7200
8701,-1800,-5500,2000,11000,0,5700
8702,-800,700,2900,-11000,-950,-9150
8703,-3700,6400,700,1500,750,5650
8704,5300,-2700,2000,14000,0,18600
8705,400,9300,-4800,-14900,1950,-8050
8706,9200,-2700,2000,10000,-950,17550
8707,-3000,-8300,3000,0,-950,-9250
8708,100,-3500,1900,7100,2900,8500
8709,-4600,9400,-3600,-11900,1950,-8750
8710,13000,1600,-9900,13000,0,17700
8711,0,100,2000,5400,0,7500
8712,-5600,3400,19600,-10800,0,6600
8713,100,200,-3700,10200,-1200,5600
8714,-800,-5500,2900,-3000,0,-6400
8715,-3600,-3400,-800,12200,-1200,3200
8716,10000,4500,2000,-10000,0,6500
8717,0,-3500,-2000,12400,-1200,5700
8718,-6300,7400,2900,-13600,-3350,-12950
8719,500,-6500,-3300,12400,-950,2150
8720,12000,-2500,200,-6700,1950,4950
8721,-2700,6500,3000,7100,1950,15850
8722,-2900,900,2900,2000,-950,1950
8723,100,-9100,2900,-2700,1700,-7100
8724,100,4500,1000,-2900,1950,4650
8725,-3000,3800,-9100,1200,-950,-8050
8726,11400,-2700,-900,10000,0,17800
8727,-1700,-2100,2900,-9900,1950,-8850
8728,-1000,-6200,13100,11000,-950,15950
8729,0,4600,-9100,-4700,2900,-6300
8730,100,-12000,2000,15000,0,5100
8731,-3700,9200,-200,-12800,0,-7500
8732,-2800,5600,13700,13200,0,29700
8733,9000,7300,-200,4200,0,20300
8734,-2900,6700,-5400,-8800,-1200,-11600
8735,0,-8200,5800,8400,-1200,4800
8736,-6600,-3600,2600,3200,0,-4400
8737,12000,-6300,1100,10000,-950,15850
8738,0,9400,1000,-2800,-2150,5450
8739,100,9300,-4900,-700,2900,6700
8740,0,4900,3900,-7700,1950,3050
8741,-2800,5400,3000,-1000,0,4600
8742,-6500,-3400,-800,15000,0,4300
8743,8200,-8100,3900,-1800,0,2200
8744,100,11600,-4400,8200,0,15500
8745,-5500,4500,5800,-13800,0,-9000
8746,9200,-5700,2000,13000,0,18500
8747,-2700,-700,2900,-3800,0,-4300
8748,-800,3400,-8100,12200,-1200,5500
8749,9100,12100,-900,11200,-1200,30300
8750,-900,100,-1800,0,-950,-3550
8751,-8400,300,13100,12200,-1200,16000
8752,12000,-5500,1100,-5900,1950,3650
8753,0,-9300,1700,16600,-3350,5650
8754,0,4500,-12600,-900,1950,-7050
8755,100,3800,2000,-2800,-950,2150
8756,-2900,3800,3100,-900,1950,5050
8757,-3000,-8100,1200,10100,1950,2150
8758,7500,3900,2100,-13000,-950,-450
8759,-1800,3800,4100,8100,2900,17100
8760,-2700,-8400,2000,-1900,1950,-9050
8761,8500,6500,1100,-1000,0,15100
8762,100,-6200,13900,0,0,7800
8763,-5800,10000,-1700,0,0,2500
8764,8400,6500,4500,-12200,-2400,4800
8765,-3000,-6300,2900,13200,-1200,5600
8766,-3000,10000,0,4200,-2150,9050
8767,11200,300,-3600,-1000,0,6900
8768,-3000,-5200,-1900,9300,1000,200
8769,-2800,-3300,200,200,-2150,-7850
8770,0,7100,-1700,-2700,2900,5600
8771,-3700,900,4800,-15700,1950,-11750
8772,12100,-5500,3900,7400,-2150,15750
8773,-5700,-3500,700,-700,2900,-6300
8774,-3000,3800,3000,-800,-950,2050
8775,11200,4500,-9800,-2000,0,3900
8776,-2900,-8900,800,9300,1950,250
8777,0,7600,7300,2200,-950,16150
8778,-2700,-3400,1100,-7700,2900,-9800
8779,-13800,-3400,3900,13000,0,-300
8780,13200,16600,-8900,3400,-10200,14100
8781,3500,-2700,4800,12600,-2400,15800
8782,-500,3800,9200,-11000,0,1500
8783,9000,-8300,3000,12000,12000,27700
8784,-3600,3700,3800,-11000,-950,-8050
8785,-2800,-6300,2000,13000,0,5900
8786,6200,-2600,200,11100,1950,16850
8787,0,3700,3600,-16500,1950,-7250
8788,-800,3200,-4400,14000,0,12000
8789,-2400,-5800,2700,7400,-10200,-8300
8790,9200,-3300,2100,9400,-1200,16200
8791,100,13900,1200,-12000,12000,15200
8792,-6500,6600,-800,2000,0,1300
8793,6700,-6100,3000,-1800,-1200,600
8794,-6400,7400,-800,1000,0,1200
8795,9200,-9100,3000,14000,0,17100
8796,-900,-6100,-700,-1000,-950,-9650
8797,-5400,16500,2000,1200,-2150,12150
8798,9000,1100,-7900,-900,2900,4200
8799,-3600,-3400,1800,4500,1950,1250
8800,12100,1600,10000,-6800,0,16900
8801,-3000,-9000,3000,13200,-1200,3000
8802,-900,-6400,2900,-2000,0,-6400
8803,-1600,13400,3900,2400,-2400,15700
8804,-2800,6600,1100,-12800,-950,-8850
8805,11300,-6300,1000,11000,-950,16050
8806,-800,-14100,4900,-900,2900,-8000
8807,1000,10200,1200,-1900,1000,11500
8808,100,-6100,-1000,8400,-950,450
8809,-2800,-2800,2000,-3900,2900,-4600
8810,200,3700,1600,-5500,1950,1950
8811,0,8500,-1000,-3600,0,3900
8812,-3000,4600,600,-400,0,1800
8813,-3000,3900,1200,-10800,0,-8700
8814,-800,3900,2100,-2600,-1200,1400
8815,11100,-9000,3000,-1000,0,4100
8816,-1900,-11100,4800,10000,0,1800
8817,0,5800,1100,10000,0,16900
8818,200,-8500,100,1000,0,-7200
8819,-5700,1000,-4200,12000,0,3100
8820,8400,21400,-1700,-10800,-1200,16100
8821,0,-3400,12100,11000,0,19700
8822,100,4700,-2900,-10800,0,-8900
8823,100,-6300,2900,6200,-950,1950
8824,0,-8900,1900,-5500,1950,-10550
8825,-2800,13700,1900,3000,-950,14850
8826,-3600,900,4900,-14900,2900,-9800
8827,9200,-5900,300,11000,0,14600
8828,300,4500,-4700,4000,0,4100
8829,-2800,-6300,3900,-1800,-1200,-8200
8830,-3800,-6100,-700,14000,0,3400
8831,9000,6500,2000,1000,0,18500
8832,-2700,6600,200,-3000,0,1100
8833,-6500,900,-3300,-1600,-1200,-11700
8834,9000,6400,800,15200,0,31400
8835,-3000,900,4800,-8800,-2150,-8250
8836,-4500,-600,12100,11000,0,18000
8837,10100,10200,-3600,-13700,1950,4950
8838,0,-14900,6700,14000,-950,4850
8839,-1600,-3400,-3700,-5900,2900,-11700
8840,-1800,1900,2000,2200,-1200,3100
8841,9100,5700,200,10400,-11400,14000
8842,-3700,-5500,5500,8400,-950,3750
8843,-3500,15500,-9200,1200,12000,16000
8844,10100,6500,-200,-4300,750,12850
8845,-5500,-3700,14000,0,0,4800
8846,-700,1700,2900,-2900,1000,2000
8847,11100,3400,-9000,3000,0,8500
8848,-1800,-3800,1900,9100,1950,7350
8849,-800,10300,-3700,-11000,-950,-6150
8850,-2000,6600,0,11500,1700,17800
8851,100,-9000,1100,10000,0,2200
8852,-1800,4600,13100,-13000,0,2900
8853,-1800,900,3900,1000,0,4000
8854,11100,-6400,1100,-600,-1200,4000
8855,-1700,10100,-2100,400,-1200,5500
8856,-5800,-6400,3900,2000,-950,-7250
8857,-4700,-9000,3900,13000,0,3200
8858,13000,22100,-2700,-11000,-950,20450
8859,-3800,6500,-200,-2500,1950,1950
8860,1000,-6300,2900,-6700,1700,-7400
8861,-3600,4500,0,14200,-10200,4900
8862,12100,1200,-1600,0,-950,10750
8863,-2900,-6000,1100,-3800,12000,400
8864,-700,-2600,-3700,8300,750,2050
8865,1200,-1900,2000,-13800,-950,-13450
8866,-3000,2900,3000,11300,1700,15900
8867,0,-5400,2100,-3800,0,-7100
8868,0,6400,100,1000,-950,6550
8869,0,3800,5800,-4800,0,4800
8870,-6300,6500,1700,-2500,1950,1350
8871,8300,6700,-1600,0,0,13400
8872,1000,-6300,1100,-5900,1950,-8150
8873,200,-11400,5400,9400,0,3600
8874,-2900,-9100,3600,200,0,-8200
8875,7600,16600,2000,1000,0,27200
8876,-2600,-3800,1900,-1600,-1200,-7300
8877,1000,15700,-10800,12000,0,17900
8878,0,-6200,200,11000,0,5000
8879,-3700,1800,1100,-7000,0,-7800
8880,9200,3900,14100,-12000,0,15200
8881,-2800,-3400,1100,10000,0,4900
8882,-9400,7400,2100,5000,0,5100
8883,9000,-6100,1100,1000,0,5000
8884,11300,1600,3800,1000,0,17700
8885,-2900,6600,-10800,2000,0,-5100
8886,100,-6400,2900,10000,0,6600
8887,-2800,9300,13000,-12000,0,7500
8888,-3700,10100,-2800,4000,0,7600
8889,9300,6300,-9000,-800,0,5800
8890,-2800,-3400,2000,9000,0,4800
8891,-1800,-5400,9400,14200,-1200,15200
8892,-600,3600,-8400,-1400,-2400,-9200
8893,-1500,9300,-1800,8000,0,14000
8894,13200,3500,1100,-1600,-2150,14050
8895,-3000,-5600,3600,11400,-950,5450
8896,100,1000,2000,-16700,750,-12850
8897,-2600,-9200,11800,12300,1950,14250
8898,100,-2100,3000,2000,-950,2050
8899,100,1700,-1600,-14300,1950,-12150
8900,-2800,800,4900,-1700,1950,3150
8901,-3800,-8100,1200,1000,-950,-10650
8902,12000,900,3900,-3900,2900,15800
8903,-5500,-6400,5700,-2900,1950,-7150
8904,10300,10200,-2700,1000,0,18800
8905,-2000,3700,-7100,-1000,0,-6400
8906,100,-6300,1000,12200,-1200,5800
8907,-2900,10000,10100,-9000,0,8200
8908,200,3800,100,-1000,0,3100
8909,-6600,-3500,2000,2200,-1200,-7100
8910,9300,6600,-200,1200,0,16900
8911,0,4500,1100,-2000,-950,2650
8912,-900,-6400,3900,-1600,-1200,-6200
8913,-1900,-700,900,4300,1950,4550
8914,-800,19300,-1100,400,-10200,7600
8915,9000,-2700,800,7500,1950,16550
8916,0,-9100,3900,-2000,12000,4800
8917,-2800,-2900,100,16200,-1200,9400
8918,-3800,18700,-1700,-9000,0,4200
8919,-2800,-3300,2100,8200,-950,3250
8920,9000,7200,100,5000,0,21300
8921,-5800,200,1100,-5700,1950,-8250
8922,11300,-5400,2900,17500,-9450,16850
8923,100,3600,-11800,2000,0,-6100
8924,-3000,-2500,-2600,12000,12000,15900
8925,-2800,3700,3900,-10000,0,-5200
8926,5500,3700,6800,13000,0,29000
8927,-7400,-2700,2000,-1000,0,-9100
8928,13000,100,-900,10000,0,22200
8929,-9500,9500,12200,4000,0,16200
8930,9200,300,-5500,2200,-1200,5000
8931,0,-8100,2100,11400,-2400,3000
8932,-800,-8500,2700,-400,-2150,-9150
8933,-4700,3700,2000,2200,-2150,1050
8934,7500,-3500,3900,-7700,1950,2150
8935,100,-5600,1000,9300,750,5550
8936,-1700,3600,2700,-12000,0,-7400
8937,-1400,5700,-900,7100,1000,11500
8938,7300,7600,-1700,-8000,-950,4250
8939,-2900,6600,200,-5500,1700,100
8940,-6400,-2700,3900,8100,1950,4850
8941,12000,-9200,5700,-2000,-1900,4600
8942,-2900,10300,-5800,300,2900,4800
8943,11300,900,-8200,-3700,1950,2250
8944,-3000,-8400,4800,14000,-950,6450
8945,200,3600,12900,-16900,2900,2700
8946,0,-3500,2900,8400,-1200,6600
8947,-2900,7400,-1800,-8000,0,-5300
8948,-7500,-3500,-100,13400,-1200,1100
8949,13100,1800,2900,-1000,0,16800
8950,-2800,-6100,-2700,2000,-950,-10550
8951,-2800,1600,3900,1000,0,3700
8952,8500,-6400,5700,-4900,1950,4850
8953,-3900,0,0,15000,-950,10150
8954,-1900,21200,0,-13900,2900,8300
8955,-800,-600,-1800,12000,0,8800
8956,9000,10100,-1800,-8000,0,9300
8957,-2700,-5600,2000,12200,-1200,4700
8958,-900,-2600,-800,0,0,-4300
8959,1000,-8300,2900,10000,0,5600
8960,0,6400,1000,1000,0,8400
8961,0,-6600,1900,2000,0,-2700
8962,-3900,10100,-3000,4200,0,7400
8963,11300,-8900,2100,-3000,0,1500
8964,-4800,7500,-1600,4000,0,5100
8965,100,6400,1600,-13600,0,-5500
8966,100,-2500,1100,6200,0,4900
8967,-3700,-5500,100,3000,0,-6100
8968,8200,3800,100,3000,0,15100
8969,100,-8100,1200,9000,0,2200
8970,1100,-11900,3000,-800,0,-8600
8971,-3000,-6200,200,14000,0,5000
8972,0,13800,3000,-12800,-1200,2800
8973,-3700,800,-6200,15200,-1200,4900
8974,9100,-3400,1100,-2600,-1200,3000
8975,-3000,9400,14000,-1600,-950,17850
8976,300,7200,-3200,-10800,-950,-7450
8977,-3800,900,3000,1100,1950,3150
8978,12100,-6300,-200,-5700,1950,1850
8979,100,-8300,1700,13200,-950,5750
8980,100,800,2900,-3900,2900,2800
8981,-2800,6300,2900,-900,1950,7450
8982,-2600,-3600,1700,9200,0,4700
8983,0,-800,0,0,0,-800
8984,0,22300,-3600,2000,0,20700
8985,0,3600,2900,-12000,0,-5500
8986,100,-3400,-1100,8400,0,4000
8987,0,1800,-2800,-8800,0,-9800
8988,0,-6200,2100,7400,-1200,2100
8989,-4400,-5500,5800,-4800,0,-8900
8990,6500,6400,4700,-1800,0,15800
8991,-2700,8500,2000,-3000,0,4800
8992,12200,-2800,-2700,12000,0,18700
8993,0,3000,-700,15200,-1200,16300
8994,-5600,7300,3900,-11800,-1200,-7400
8995,0,6400,100,1200,0,7700
8996,-3900,-2400,-4700,3200,-950,-8750
8997,-2600,-2600,3000,2500,750,1050
8998,5300,-5900,300,3000,-950,1750
8999,9400,-5500,-700,9100,2900,15200
9000,-3700,5800,3000,9000,-950,13150
9001,-2700,3600,-9900,1000,-950,-8950
9002,9100,3800,1100,11100,2900,28000
9003,-2800,3800,3900,-15900,1950,-9050
9004,-3800,-6300,15000,11400,-1200,15100
9005,9000,4500,2900,-10000,0,6400
9006,0,9300,1000,-2800,0,7500
9007,0,-6200,-1000,200,0,-7000
9008,-3900,4600,-100,1200,0,1800
9009,9400,3800,4600,-14400,-1200,2200
9010,-5800,-2600,200,14000,0,5800
9011,-6400,9300,-9200,12200,0,5900
9012,11200,-2700,2000,-5600,-2150,2750
9013,-1800,-2800,12500,-600,0,7300
9014,-2800,0,3800,4300,1950,7250
9015,8300,-800,0,0,-950,6550
9016,-2800,100,-3800,11300,1700,6500
9017,-2600,6400,2800,10000,0,16600
9018,11200,-2700,-800,0,-950,6750
9019,-3900,-6000,200,13000,0,3300
9020,-1700,4400,4800,-16900,1950,-7450
9021,8200,-3500,1000,10100,1950,17750
9022,100,7100,-2800,-6600,-2400,-4600
9023,-2800,-8300,5800,9000,0,3700
9024,-2700,6300,-1800,2000,-950,2850
9025,3000,-3600,-300,-3400,-1200,-5500
9026,-2600,7300,0,-3900,1950,2750
9027,-3700,-5300,-800,2000,-950,-8750
9028,7200,3900,200,1100,2900,15300
9029,-800,-9100,2000,-2000,0,-9900
9030,-700,1700,2900,-1000,0,2900
9031,1100,3800,-1700,1000,0,4200
9032,-900,-11600,4000,-5000,0,-13500
9033,-5400,7300,3900,-800,-1200,3800
9034,9200,600,4800,-9000,0,5600
9035,-3000,-700,-900,12000,-950,6450
9036,11300,7200,-2700,-10000,0,5800
9037,200,-6200,-200,5700,750,250
9038,-2900,800,-7100,14000,-950,3850
9039,-3900,5700,2000,-1900,2900,4800
9040,200,7300,13100,-3800,0,16800
9041,-2700,3800,-8100,0,0,-7000
9042,12100,-6400,1900,-800,-1200,5600
9043,0,7500,-2900,2200,0,6800
9044,-3000,3700,12200,3000,-950,14950
9045,-8500,100,4700,-800,0,-4500
9046,11200,3700,800,-700,1950,16950
9047,100,-2800,-4600,0,-950,-8250
9048,-3000,-5400,2100,8300,2900,4900
9049,-2800,9400,2700,-18400,0,-9100
9050,11200,-8600,2000,14200,-1200,17600
9051,-2700,9200,-6300,6200,0,6400
9052,-3000,-5600,2900,12400,-11400,-4700
9053,200,-3800,-2000,14000,0,8400
9054,-5800,7200,14900,-8000,11050,19350
9055,-1600,300,-3700,11000,0,6000
9056,10000,6500,2000,-13700,1950,6750
9057,-3500,-2600,100,9000,-950,2050
9058,12000,-2700,-1700,7100,2900,17600
9059,-2800,-5400,3000,9600,-11400,-7000
9060,0,700,1100,3000,0,4800
9061,-2800,-6000,-9000,8200,12000,2400
9062,-3800,4400,2700,-600,0,2700
9063,12000,-6300,1700,400,-1200,6600
9064,-2800,-600,9400,11000,0,17000
9065,0,13500,4800,-10800,-950,6550
9066,100,-6300,2900,9000,-950,4750
9067,-2900,10000,-1000,-11700,1700,-3900
9068,-5700,9300,-900,4000,-950,5750
9069,11400,-5500,2000,-6900,2900,3900
9070,-3000,-2500,-1700,14000,0,6800
9071,100,900,1700,-10600,-1200,-9100
9072,0,-3200,-3800,11200,0,4200
9073,-7400,-2600,-1700,2200,-2150,-11650
9074,6600,-3500,5500,5400,-950,13050
9075,6400,6700,-3000,-500,2900,12500
9076,-6600,-5500,4800,10100,1950,4750
9077,11200,6400,1000,-15800,0,2800
9078,-11200,9300,4600,13400,-1200,14900
9079,9200,900,5500,-1600,-10200,3800
9080,8400,-3200,-2800,12200,-950,13650
9081,100,4500,1000,-12000,12000,5600
9082,-8600,-2600,2100,11700,-1650,950
9083,-700,1100,-8200,10200,0,2400
9084,9000,-3500,-1700,300,-200,3900
9085,-3000,-5600,14000,14000,0,19400
9086,10300,3700,6600,-18700,1950,3850
9087,-2000,11200,-3300,14400,-1900,18400
9088,-2900,4500,1900,-10900,2900,-4500
9089,-700,-2700,100,6100,1950,4750
9090,-2800,6600,-3700,-8000,-950,-8850
9091,11400,-2700,2000,2300,2900,15900
9092,-2000,-8900,2100,13000,0,4200
9093,100,7200,2900,-13600,-1200,-4600
9094,-2800,700,4800,4000,0,6700
9095,-800,-800,-1000,-3000,0,-5600
9096,-2800,7200,0,5000,0,9400
9097,9200,-2700,0,1000,0,7500
9098,200,-6000,-3900,10200,0,500
9099,-3000,4800,-1600,3000,0,3200
9100,-2700,-6200,2000,-800,-1200,-8900
9101,5400,7300,1100,4000,0,17800
9102,-8300,-9100,2800,1200,-950,-14350
9103,11500,3700,-1200,-600,0,13400
9104,-2800,4400,3000,-11800,-950,-8150
9105,11200,3500,200,-1500,750,14150
9106,-2800,-9000,4900,-4900,2900,-8900
9107,-9400,7200,-5200,23200,-10200,5600
9108,9100,-8800,2100,2200,-1200,3400
9109,0,10100,9300,-1000,0,18400
9110,-6600,3700,4800,6200,10800,18900
9111,9400,-3400,100,-3800,-950,1350
9112,100,-1100,5800,-1000,-950,2850
9113,0,-700,-1800,-2700,1700,-3500
9114,-3000,7200,3800,-1700,1950,8250
9115,11200,9300,-10900,-1000,-950,7650
9116,-3000,-2600,-1700,13000,0,5700
9117,-800,-5600,14900,-3900,1950,6550
9118,200,-800,1800,8200,-950,8450
9119,1100,100,-1800,5100,2900,7400
9120,0,6500,1700,-600,-1200,6400
9121,100,100,-3700,10400,-2400,4500
9122,-2800,6700,1100,-10800,-1200,-7000
9123,0,-8300,3000,12000,0,6700
9124,-5700,-5600,4700,200,-2150,-8550
9125,-800,9200,-1200,-1300,-450,5450
9126,9000,9500,-3600,-8000,-1900,5000
9127,-6500,-2700,1000,9300,1700,2800
9128,3700,-2700,5800,-4900,1000,2900
9129,9500,-2700,100,10000,0,16900
9130,-800,100,-900,-4900,1000,-5500
9131,100,-6300,2900,10000,-950,5750
9132,-2800,200,-800,7100,2900,6600
9133,11200,6300,-1100,-700,1950,17650
9134,-2800,3900,-7900,10000,-950,2250
9135,-2800,-8200,300,-900,2900,-8700
9136,-3000,900,3000,1100,1950,3950
9137,11200,-12200,17700,13000,0,29700
9138,100,10000,-1000,-13000,0,-3900
9139,-900,6400,-3900,4200,0,5800
9140,-2000,-6200,1100,0,0,-7100
9141,-900,4600,-1000,1200,0,3900
9142,-1600,3600,5600,-13800,0,-6200
9143,100,-3600,-900,11000,0,6600
9144,-800,7200,900,-14000,0,-6700
9145,1000,3700,-7100,12200,-1200,8600
9146,-3000,-2600,-800,14000,0,7600
9147,11200,6900,9500,-13800,0,13800
9148,100,-5800,-3300,14400,0,5400
9149,-3600,-6200,3000,-5800,0,-12600
9150,1100,-5500,-700,9800,0,4700
9151,-3000,3700,200,-9000,0,-8100
9152,-800,3000,1700,11200,0,15100
9153,1100,-5400,-2600,-2000,0,-8900
9154,-4500,-9100,9500,9200,0,5100
9155,9300,19400,2000,-13800,0,16900
9156,-1800,3800,-7000,10000,0,5000
9157,-5600,6500,-7000,0,0,-6100
9158,8200,-5500,3800,11200,-1200,16500
9159,0,9500,8400,1000,0,18900
9160,-6400,-3500,100,2200,-1200,-8800
9161,9100,1700,16800,1000,-950,27650
9162,-3600,-3600,3600,-3600,-950,-8150
9163,9000,10100,-900,1300,1700,21200
9164,100,-8200,-3700,-1700,1950,-11550
9165,0,-11100,6700,11000,-950,5650
9166,0,9600,-14500,10200,-1200,4100
9167,-5600,-3300,1200,-3900,1950,-9650
9168,8500,7500,-1700,-1600,-2150,10550
9169,-3700,-3600,14700,-5500,2900,4800
9170,-2800,-9200,4500,13200,0,5700
9171,6300,4400,-4300,-1000,-950,4450
9172,100,11400,7100,12200,-950,29850
9173,200,-8600,1900,-1900,2900,-5500
9174,0,-6300,2000,3100,1950,750
9175,8200,16600,-1300,-5600,0,17900
9176,-3000,-6300,2000,14000,0,6700
9177,-2700,-6200,2000,-2000,0,-8900
9178,100,13600,-6200,11200,-1200,17500
9179,100,6400,13000,0,0,19500
9180,-3400,-800,-100,-2000,0,-6300
9181,7200,0,-3000,13200,0,17400
9182,2000,0,2800,-8600,0,-3800
9183,0,6400,2000,12200,0,20600
9184,100,-6400,-3600,2000,0,-7900
9185,100,4600,4800,-5800,0,3700
9186,-2900,3600,-8100,13200,-10200,-4400
9187,-3900,0,-900,14000,0,9200
9188,200,600,2800,-10000,12000,5600
9189,12000,100,10200,8200,-1200,29300
9190,-6700,9300,-10400,14600,0,6800
9191,-4800,-2800,3800,0,-950,-4750
9192,11300,100,10200,-1800,-2150,17650
9193,-2900,-2500,1100,-5700,2900,-7100
9194,-2800,6400,-9000,-2800,-950,-9150
9195,11200,-5500,2900,-4700,1700,5600
9196,0,-700,11100,-2800,-1200,6400
9197,-3700,10000,-10400,12600,-2150,6350
9198,1000,-2700,100,9000,-950,6450
9199,-3000,-2800,3800,-2700,2900,-1800
9200,-2900,300,7400,-1900,1000,3900
9201,11200,-2500,200,-7700,1950,3150
9202,-2900,-9100,3900,14000,-950,4950
9203,0,-5800,2000,-4700,2900,-5600
9204,200,9200,1800,-5600,-10200,-4600
9205,0,9300,-800,-1000,0,7500
9206,-3900,-2600,-800,13000,12000,17700
9207,1100,3700,1600,-11800,0,-5400
9208,0,-3600,1000,11000,0,8400
9209,200,4400,-2800,-9000,0,-7200
9210,-2800,-5200,1200,9000,0,2200
9211,4500,-3300,-3100,1400,0,-500
9212,-11100,-3600,4500,11200,0,1000
9213,8500,16400,1700,1200,0,27800
9214,11100,-8500,200,3000,0,5800
9215,1000,-1900,6700,-11600,-2400,-8200
9216,0,-3400,800,7600,-1200,3800
9217,-3000,10200,-3600,-7000,0,-3400
9218,-3600,6500,2000,1000,-950,4950
9219,9200,-5600,4700,-2800,0,5500
9220,-2800,6700,-14900,9500,750,-750
9221,-4300,-3500,-1000,400,-3350,-11750
9222,6500,-5600,14900,10100,2900,28800
9223,-4500,-5400,-1100,-800,-950,-12750
9224,14100,0,3600,9200,-950,25950
9225,-6500,6500,-10800,-1900,1950,-10750
9226,-4600,3900,3900,-2900,1950,2250
9227,11200,3900,1200,-14800,-950,550
9228,-3000,-6100,11300,11100,2900,16200
9229,-2800,4700,2100,-14700,750,-9950
9230,-3700,3800,-7900,10200,0,2400
9231,5500,-3600,7600,-5800,0,3700
9232,6700,200,13100,8000,0,28000
9233,-2800,15600,2000,2200,-10200,6800
9234,10300,-6400,2900,9000,0,15800
9235,1200,10400,-6500,-13000,12000,4100
9236,-5800,-8200,4000,14200,-1200,3000
9237,-6300,-3600,-2000,15200,0,3300
9238,12100,4400,4700,-14800,0,6400
9239,-3000,6700,0,-13400,-950,-10650
9240,-3000,-5600,1700,13400,-2150,4350
9241,8500,3700,2900,-1700,1700,15100
9242,-2900,-6100,-800,100,1950,-7750
9243,100,4300,-1700,0,0,2700
9244,-2600,6500,2800,-12600,-2150,-8050
9245,11200,-8200,2100,9000,0,14100
9246,-2900,-1900,-5700,-2300,750,-12050
9247,200,9500,-5600,2200,-2150,4150
9248,100,-9000,8500,-1900,1950,-350
9249,-2700,-2500,-100,8400,-950,2150
9250,100,3400,1000,-12700,2900,-5300
9251,-3000,3700,3000,12000,-950,14750
9252,10300,-4600,6800,-15700,1700,-1500
9253,-1900,6400,-13300,14600,-1200,4600
9254,0,-12000,-3400,17600,0,2200
9255,-2800,4800,-9700,-2000,-950,-10650
9256,0,900,5900,12200,-2150,16850
9257,-3000,-8400,5700,8300,-8250,-5650
9258,8400,9200,15800,-5700,1950,29650
9259,0,-600,-1800,10000,12000,19600
9260,-3000,0,900,11200,-950,8150
9261,100,1000,-8200,5300,2900,1100
9262,-3800,5900,12200,-2900,1950,13350
9263,9300,7200,500,-12200,-1200,3600
9264,-2800,3900,1100,-1600,-10200,-9600
9265,-3000,9400,-900,9400,0,14900
9266,-600,-11700,1900,9200,0,-1200
9267,4500,7500,-700,-8800,10800,13300
9268,-3700,6400,5800,-3800,0,4700
9269,5700,-3500,4800,8200,-950,14250
9270,11300,1400,12700,-6600,-1200,17600
9271,-3000,-9000,3000,10100,1950,3050
9272,100,7300,1000,-13800,-950,-6350
9273,-3000,3800,12200,1100,2900,17000
9274,-900,-6200,2000,-2000,0,-7100
9275,-1500,7400,-900,-2000,0,3000
9276,7500,3700,2000,-11000,0,2200
9277,100,-8400,-100,12200,0,3800
9278,100,6600,-2900,-13600,0,-9800
9279,-5600,-9200,7600,12000,0,4800
9280,9300,4500,1100,200,0,15100
9281,-5700,3700,2900,-10000,0,-9100
9282,10300,-3500,2000,7200,0,16000
9283,1000,100,-2700,-800,-1200,-3600
9284,-3800,3600,4700,2000,0,6500
9285,100,12100,-900,-2000,-950,8350
9286,-1700,-2500,-800,10000,0,5000
9287,-900,-5500,1100,8100,1950,4750
9288,-5400,6500,-6100,-2000,-950,-7950
9289,12200,-5700,-9200,18300,2900,18500
9290,0,6500,-5700,-7600,-1200,-8000
9291,0,-2800,14900,7200,0,19300
9292,-2700,-3500,500,-3400,0,-9100
9293,0,-8400,14000,13000,0,18600
9294,0,5600,4800,-5800,0,4600
9295,-4700,300,-6000,16400,0,6000
9296,11200,800,-6600,-2400,-1200,1800
9297,-800,5900,2100,8000,0,15200
9298,-5700,10100,-800,3000,0,6600
9299,-6600,3700,16800,-7800,-2150,3950
9300,12000,-2700,100,10000,-950,18450
9301,-3500,-2800,-800,-900,2900,-5100
9302,12100,3800,100,-14900,1950,3050
9303,100,-5500,800,11200,0,6600
9304,-8400,6600,-7800,9200,0,-400
9305,-3600,-6400,1100,0,0,-8900
9306,11100,1600,3900,2400,-2400,16600
9307,1000,-3100,10300,-3000,0,5200
9308,200,7300,-1200,-2400,-2150,1750
9309,-2900,3600,2000,-11000,-950,-9250
9310,-2500,-8400,100,10100,2900,2200
9311,10300,800,4800,-14900,1000,2000
9312,-1800,-3500,800,11400,-2150,4750
9313,-6200,7300,-1000,-1900,2900,1100
9314,-900,3800,3000,-16500,750,-9850
9315,13000,-9100,-2800,14200,0,15300
9316,-3000,1900,3000,-9000,-950,-8050
9317,-6700,3700,3000,4000,0,4000
9318,200,-6200,-100,-4700,1950,-8850
9319,9300,-5700,2000,13000,-950,17650
9320,200,13100,200,-14900,2900,1500
9321,0,-11900,3000,14000,0,5100
9322,-3900,4500,3000,-11800,0,-8200
9323,-1800,6400,3800,0,0,8400
9324,-800,-3600,-1800,1000,0,-5200
9325,6200,10300,-3500,4000,0,17000
9326,-3600,3600,5700,-13000,0,-7300
9327,12000,-3400,1100,9400,-1200,17900
9328,0,1700,-100,5200,0,6800
9329,-900,3700,1100,-13000,0,-9100
9330,1100,-6400,2800,7000,0,4500
9331,-3900,7500,-1700,-9000,0,-7100
9332,1000,3600,-11800,13000,0,5800
9333,-2800,-6000,0,-1800,0,-10600
9334,-800,7300,10200,2000,0,18700
9335,-4800,3800,-5100,9200,0,3100
9336,11300,-5600,1900,-1000,0,6600
9337,-3000,900,2100,3000,0,3000
9338,-3000,-6400,18600,-800,0,8400
9339,11300,300,-3600,9000,0,17000
9340,-2700,15700,-10000,14000,0,17000
9341,-2900,-2700,3000,-5600,0,-8200
9342,0,6500,15600,-17400,0,4700
9343,-3800,200,-2700,14000,0,7700
9344,6200,-2500,200,12000,0,15900
9345,-2600,-2500,-2900,-800,0,-8800
9346,8400,3600,6700,-800,0,17900
9347,0,-9400,2000,-1000,0,-8400
9348,100,1900,900,1200,0,4100
9349,0,-6300,-1700,3000,0,-5000
9350,-800,-8400,-1100,13200,0,2900
9351,-2600,13100,4000,-14800,-1200,-1500
9352,1000,-6100,-4600,12400,0,2700
9353,-3500,-8600,3800,2200,-2150,-8250
9354,6500,18500,3900,-2000,0,26900
9355,-6500,3700,-4300,-3700,1950,-8850
9356,6200,-3600,2000,15200,-2150,17650
9357,-800,-5600,15800,5100,2900,17400
9358,12000,-600,-5100,400,-950,5750
9359,100,13200,-9800,9000,0,12500
9360,-2800,-5600,-700,-2900,1950,-10050
9361,0,9900,4800,3000,-950,16750
9362,-2700,-3400,10900,-2700,2900,5000
9363,-4600,7400,-800,200,0,2200
9364,7300,3800,1100,-10000,0,2200
9365,100,-8900,3000,9000,0,3200
9366,100,2000,1200,-12000,0,-8700
9367,0,-1900,2100,4000,0,4200
9368,0,-6300,1100,10000,0,4800
9369,-900,1700,2700,-11800,0,-8300
9370,-3700,4000,-1600,4000,0,2700
9371,13000,-6100,200,-4000,0,3100
9372,0,-1200,6700,400,-2400,3500
9373,-3800,6500,-12900,1200,0,-9000
9374,-4800,-3400,5800,7400,-950,4050
9375,8500,4700,-700,-12000,-950,-450
9376,100,-6300,14600,6700,1700,16800
9377,-8300,-6500,5800,9100,1950,2050
9378,8400,22200,-2900,-10800,0,16900
9379,-6300,6300,1900,3000,0,4900
9380,11100,-3500,100,-800,-1200,5700
9381,-1600,4600,100,0,0,3100
9382,-3600,900,-8800,2000,-950,-10450
9383,9000,-8900,2100,14000,0,16200
9384,0,4500,15900,-14800,-950,4650
9385,-900,6800,200,-4300,500,2300
9386,-700,3700,-900,-2900,1950,1150
9387,-1600,-5500,1900,-2000,0,-7200
9388,-2800,6600,1100,-800,-950,3150
9389,9200,-6200,-2700,0,-950,-650
9390,-3700,-5400,3000,8100,2900,4900
9391,200,5600,-100,-6700,1950,950
9392,-2000,-11700,6800,9400,-1200,1300
9393,5400,0,3800,-400,-2400,6400
9394,-1700,18400,1900,-2000,0,16600
9395,-2700,-800,-1200,14200,-950,8550
9396,13100,9400,-2700,-2800,-1200,15800
9397,-2700,-5600,4700,8100,1950,6450
9398,0,18600,-800,-13900,1950,5850
9399,-2900,-5500,1000,12200,-2150,2650
9400,0,3900,-1600,-1600,-12350,-11650
9401,-3800,-9100,2600,12300,2900,4900
9402,6600,-2700,0,-4900,13000,12000
9403,-3500,3800,-9300,10800,-3350,-1550
9404,6300,5700,2900,-900,2900,16900
9405,100,7300,-4700,-2500,1000,1200
9406,0,1000,8700,8200,0,17900
9407,-3600,3500,-8000,-2900,1950,-9050
9408,12000,-8300,15000,11200,-2150,27750
9409,-2800,-6500,2900,-2900,2900,-6400
9410,0,10100,10200,0,0,20300
9411,0,-3400,2000,-4800,0,-6200
9412,-2800,-600,-4700,15000,0,6900
9413,-3000,4000,300,-1000,0,300
9414,-800,-5500,2000,12200,-1200,6700
9415,9100,18600,-3600,-7000,0,17100
9416,-6600,-9000,6700,10200,-950,350
9417,12200,-2700,-100,7600,-2150,14850
9418,-5800,3800,4900,-14700,2900,-8900
9419,0,6600,3900,2500,750,13750
9420,0,-700,-1800,-2000,0,-4500
9421,-3700,-2500,-1700,10200,-950,1350
9422,6300,6400,3800,200,-1200,15500
9423,0,3700,800,-1700,1950,4750
9424,-3700,-3500,3800,-1400,-2150,-6950
9425,12000,7200,1000,-4900,2900,18200
9426,-2900,-2800,700,400,-950,-5550
9427,-3000,6500,1000,2000,0,6500
9428,-900,0,-900,-4900,1950,-4750
9429,8500,-2700,2900,9000,-950,16750
9430,-2900,9400,-13700,11300,1700,5800
9431,1000,-5600,3800,-4800,0,-5600
9432,-900,-2800,-500,12400,0,8200
9433,-2900,-6400,14900,-1000,0,4600
9434,-1700,10000,0,-1800,-10200,-3700
9435,3200,500,-5500,6000,0,4200
9436,-600,-8500,100,12200,10800,14000
9437,1000,-5300,-2800,-600,-1200,-8900
9438,-6500,-9100,4800,3000,-950,-8750
9439,9000,900,-7000,13200,-1200,14900
9440,0,3900,0,6700,-450,10150
9441,-3800,-1900,7400,-8600,-1900,-8800
9442,12100,6500,11100,-3900,2900,28700
9443,-2700,-2700,1000,6300,-8250,-6350
9444,-9100,-3400,1000,14000,-1900,600
9445,11100,-6400,-1700,-2900,14900,15000
9446,1000,13500,3800,-2700,1950,17550
9447,0,3700,3900,-13800,-950,-7150
9448,-2900,-3400,-1700,6300,2900,1200
9449,-2900,4400,2900,-11000,0,-6600
9450,-600,6700,-13300,8600,0,1400
9451,6200,4100,12300,-9000,0,13600
9452,-2800,-9200,4800,10000,0,2800
9453,-1700,-2800,1700,10600,-1200,6600
9454,9300,8500,800,-2600,-1200,14800
9455,-2000,-3500,-1700,-2000,0,-9200
9456,100,4500,3600,-3400,0,4800
9457,-6600,16000,-8800,12000,-950,11650
9458,12000,-6100,1200,-5800,-950,350
9459,-6400,7300,14900,300,1700,17800
9460,8400,-3400,-1700,-3900,1950,1350
9461,-5500,-5600,5800,8200,0,2900
9462,200,5600,2900,-3800,-1200,3700
9463,12000,4500,-800,5000,0,20700
9464,0,-6100,-700,-1800,-2150,-10750
9465,100,-5500,800,10200,0,5600
9466,-8600,18500,3000,-12900,1950,1950
9467,-800,-700,1000,9600,-2400,6700
9468,12000,1700,1100,100,1950,16850
9469,-3700,-3400,-2700,2000,-950,-8750
9470,-2000,1600,5700,1000,-950,5350
9471,-3500,-600,-2700,-2900,2900,-6800
9472,9100,10600,-5400,-2700,1950,13550
9473,-5600,-5400,4900,-3000,0,-9100
9474,8300,-9200,500,16400,0,16000
9475,-2900,1600,4800,2200,-1200,4500
9476,0,800,1800,-11800,0,-9200
9477,0,-2100,3600,5200,0,6700
9478,0,-5600,3800,-1000,-950,-3750
9479,8200,9400,-1800,4000,-950,18850
9480,-2900,6700,-2600,-12900,2900,-8800
9481,100,-3400,-1100,5700,750,2050
9482,-6600,-8400,5500,2200,0,-7300
9483,8100,6400,-9000,13000,0,18500
9484,-4800,5800,800,1200,0,3000
9485,-3600,4400,-5200,11200,-1200,5600
9486,12000,6300,-1300,2400,0,19400
9487,-900,-500,-3600,11200,-1200,5000
9488,-5500,100,15900,-6400,-3350,750
9489,3600,12500,-1600,14000,-950,27550
9490,-4600,-8200,12900,8300,1950,10350
9491,13000,-8200,3000,-4700,750,3850
9492,-2800,-3400,200,10000,-950,3050
9493,-2900,-11700,3000,8500,-8500,-11600
9494,8300,16500,-2000,1300,1000,25100
9495,100,800,5700,-12000,-950,-6350
9496,0,-12200,3900,10100,14900,16700
9497,-3000,-2800,2800,11100,1950,10050
9498,0,21400,-11800,-1000,0,8600
9499,-3700,-6200,100,14000,0,4200
9500,12100,7500,10300,-13600,-2400,13900
9501,100,3600,-100,1200,0,4800
9502,-3800,-6300,4700,-3800,0,-9200
9503,-5600,7500,200,200,-950,1350
9504,-2600,3900,1200,-13000,-950,-11450
9505,6300,-800,1000,9500,1700,17700
9506,8400,4500,4800,-13900,1950,5750
9507,-3400,300,-2800,9000,-950,2150
9508,-2600,-6100,1200,-4800,-2150,-14450
9509,9400,4300,1100,-2900,2900,14800
9510,200,-6400,-2100,-2500,1950,-8850
9511,-3700,-2700,1100,9000,0,3700
9512,-2800,6500,2000,-10800,0,-5100
9513,12000,3400,5700,11200,0,32300
9514,-2800,-3500,2900,-2000,0,-5400
9515,-3000,0,0,13000,0,10000
9516,0,21300,-900,1000,0,21400
9517,100,-2600,-3000,-1800,0,-7300
9518,-7500,-5500,3900,15600,-3600,2900
9519,10300,-2700,1100,-4000,0,4700
9520,100,-6300,1900,11000,-950,5750
9521,-3800,-6200,-100,1400,-2150,-10850
9522,12100,22200,-4600,-1900,1950,29750
9523,-700,-11300,700,12300,1950,2950
9524,-2000,900,3900,-800,-11150,-9150
9525,-5500,-6400,4800,9100,1950,3950
9526,-3600,10200,-1100,-14700,14900,5700
9527,12000,3600,2900,0,0,18500
9528,0,-5100,-1600,-800,-1200,-8700
9529,-2600,3700,-1700,-800,0,-1400
9530,3000,-6100,-2700,-2000,0,-7800
9531,-2700,10100,100,-1800,-950,4750
9532,-7600,6500,1800,-11600,-950,-11850
9533,13300,-2700,3900,-500,2900,16900
9534,-6600,-2400,-1600,-900,1950,-9550
9535,5500,6600,5800,-2800,0,15100
9536,-4600,-2700,3900,9000,0,5600
9537,4700,-6000,-9900,12200,0,1000
9538,2600,7600,1200,1000,0,12400
9539,300,-3300,12200,-5600,-1200,2400
9540,9000,2000,-600,5000,0,15400
9541,-5700,-6200,2000,0,0,-9900
9542,10300,-8200,3000,9200,-1200,13100
9543,200,7200,800,-6800,0,1400
9544,1000,-6600,-800,13200,-1200,5600
9545,0,1800,5800,-13800,-950,-7150
9546,-2900,-6300,2000,13200,-2150,3850
9547,-3000,-8800,1200,-700,1700,-9600
9548,0,16600,200,-2700,-200,13900
9549,-7400,3800,800,5200,0,2400
9550,9300,600,-5200,-2900,1000,2800
9551,100,-8400,-5500,21400,-1200,6400
9552,-6500,9400,-9900,-1900,1950,-6950
9553,12400,-700,6500,7000,-950,24250
9554,1000,1000,7600,-22700,1950,-11150
9555,-5800,7400,13100,1500,500,16700
9556,8500,9300,-16000,4200,0,6000
9557,0,-5200,-1900,8200,-950,150
9558,100,-6300,13700,-2400,-1200,3900
9559,-2900,-6300,11200,11300,750,14050
9560,-3000,13700,3900,-10900,1000,4700
9561,-2400,800,2900,-1000,0,300
9562,11000,-6300,2000,-2900,1950,5750
9563,-3000,-5500,1100,13000,-950,4650
9564,0,3000,3900,-2700,1700,5900
9565,-3800,-6000,-700,14000,0,3500
9566,9300,16400,-5400,-2800,-950,16550
9567,100,3800,2000,-2800,0,3100
9568,0,-6200,13100,9100,1950,17950
9569,-2800,6500,2900,-13000,-950,-7350
9570,-2600,-2700,-900,7100,2900,3800
9571,5400,9400,800,-10600,0,5000
9572,-2900,5800,-2200,13400,0,14100
9573,11200,4400,2000,-12000,0,5600
9574,-6600,-6400,3300,12400,0,2700
9575,-2000,-6300,2000,2200,-1200,-5300
9576,5500,22200,-1800,3000,0,28900
9577,100,6600,100,-13600,-1200,-8000
9578,-7500,-2700,900,12400,0,3100
9579,13100,-5500,3800,5200,0,16600
9580,0,-6500,-7300,8400,-950,-6350
9581,-2700,10100,100,1000,-950,7550
9582,-2800,3900,2100,-15900,2900,-9800
9583,-800,-5200,11300,9100,1950,16350
9584,7200,-2700,-1700,1000,0,3800
9585,-800,-6300,2600,8200,0,3700
9586,100,-3400,-10100,6400,0,-7000
9587,-9400,19200,4800,4000,0,18600
9588,12100,-2700,11100,10000,0,30500
9589,-5300,3500,2900,-9000,0,-7900
9590,11500,500,-4500,7000,0,14500
9591,200,3900,-14800,-1800,0,-12500
9592,-5600,-5700,5800,20400,-10200,4700
9593,-6500,-6300,3900,1000,0,-7900
9594,12100,7400,13800,-7400,0,25900
9595,-3800,800,3900,-7000,12000,5900
9596,12000,-5500,2000,10000,0,18500
9597,-2800,6500,2900,8400,-10200,4800
9598,-900,-3700,-1800,2000,0,-4400
9599,1000,-5700,2900,10200,12000,20400
9600,-900,11500,-3600,-3000,0,4000
9601,-5500,4700,2100,4200,-1200,4300
9602,9200,-2800,100,0,0,6500
9603,100,3900,2000,-2000,0,4000
9604,-2800,-6200,2100,13200,-1200,5100
9605,-6500,4700,1100,-10000,0,-10700
9606,9500,-2700,1000,9000,-950,15850
9607,-3700,6500,-800,-9000,0,-7000
9608,9000,-5500,-100,11300,1950,16650
9609,-3700,-6300,6700,-4800,-950,-9050
9610,-2800,-3600,1900,9100,2900,7500
9611,9400,19100,-2100,-9800,0,16600
9612,3100,300,-4600,7000,0,5800
9613,-2800,6700,-1000,-9800,0,-6900
9614,-2700,-2700,-900,7200,0,900
9615,0,-8300,1500,12400,0,5600
9616,100,-12000,1800,2200,0,-7900
9617,-5800,-2600,1100,13000,0,5700
9618,7600,6400,700,-11800,0,2900
9619,-2600,8500,1100,11000,0,18000
9620,12100,1600,-1100,-9800,0,2800
9621,0,-1800,5800,11200,-10200,5000
9622,0,-6300,1100,0,0,-5200
9623,-2800,-5800,4800,11200,12000,19400
9624,0,-200,4800,0,0,4600
9625,0,-700,-900,11000,0,9400
9626,-800,7300,100,200,-1200,5600
9627,1100,5500,-900,-1000,0,4700
9628,-2800,7600,-10000,11200,0,6000
9629,-6500,3600,2100,-8000,0,-8800
9630,9500,-3600,13900,10200,-1200,28800
9631,0,7400,-800,-10000,0,-3400
9632,-3000,3800,1100,1000,-950,1950
9633,5400,-3400,-1900,-500,750,350
9634,-900,-5500,4800,9400,-2150,5650
9635,-1800,8500,2000,-4900,2900,6700
9636,-800,7000,2800,-600,-2150,6250
9637,12100,200,-4600,-1000,-950,5750
9638,0,3800,3900,-6700,2900,3900
9639,-5800,-2800,800,10300,1950,4450
9640,0,-2700,-9500,10400,0,-1800
9641,-5800,6700,-700,3000,0,3200
9642,7500,-5500,3900,-2000,0,3900
9643,-1800,-3600,13900,12000,0,20500
9644,-700,7200,-900,200,0,5800
9645,6200,0,-200,2200,0,8200
9646,0,6400,1000,200,-1200,6400
9647,200,-5700,0,-600,-1200,-7300
9648,100,-5100,-1600,-2000,-950,-9550
9649,-6600,6400,-5200,11400,-1200,4800
9650,5400,-400,-5600,-700,1950,650
9651,9000,1800,16600,-600,-1900,24900
9652,0,-8100,2100,-4700,1700,-9000
9653,200,3900,-11800,7300,750,350
9654,-5800,-3400,200,0,-950,-9950
9655,10300,-5400,3900,15500,2900,27200
9656,-2000,900,3000,-10000,-950,-9050
9657,100,12600,-10200,2200,0,4700
9658,-900,-5600,17700,5300,1950,18450
9659,-1900,3700,3800,-11000,-950,-6350
9660,0,-6600,11800,11300,2900,19400
9661,0,7300,1000,-12000,0,-3700
9662,-3800,6700,-2600,3000,0,3300
9663,9000,-6200,1100,2000,0,5900
9664,-900,4600,2000,1200,-1200,5700
9665,-2000,-9100,2000,14000,0,4900
9666,0,4000,-11600,-1000,0,-8600
9667,0,900,6700,12000,0,19600
9668,-3000,-6300,14000,1000,0,5700
9669,8200,-600,-1800,13000,0,18800
9670,-900,19200,-1100,-11800,0,5400
9671,-2000,-3400,-100,12400,0,6900
9672,-3000,-6300,4800,-800,0,-5300
9673,11200,19400,-3800,-13800,0,13000
9674,-5700,-2700,800,3200,0,-4400
9675,-2900,3800,-11100,13200,0,3000
9676,11200,-3400,3000,5400,0,16200
9677,-3800,1700,2900,-9000,0,-8200
9678,-2000,-8300,14900,2200,-1200,5600
9679,0,3900,-1000,1200,0,4100
9680,-6600,-700,-1000,-400,-2150,-10850
9681,8300,4500,6700,-1400,-3350,14750
9682,1200,3600,600,-5300,-8500,-8400
9683,0,-3500,-5700,15200,-1900,4100
9684,-5800,7200,4800,-15700,1950,-7550
9685,8500,-6200,1700,8300,13950,26250
9686,-2800,0,-1400,9500,1950,7250
9687,-4500,-5600,-700,200,-1200,-11800
9688,10200,6600,5800,4300,1950,28850
9689,-6600,-6300,3900,-1900,1950,-8950
9690,9100,-6200,-11300,23400,0,15000
9691,0,16500,1100,-12000,0,5600
9692,-6500,-3300,200,13200,-1200,2400
9693,9000,-10000,16800,2000,0,17800
9694,0,6300,1000,1000,0,8300
9695,100,100,-3000,-800,-950,-4550
9696,-3000,8600,1100,-800,-950,4950
9697,11200,4500,2900,-13900,2900,7600
9698,-2900,9300,100,9100,1950,17550
9699,-5800,9300,100,-8000,0,-4400
9700,5600,200,2000,10000,0,17800
9701,-3000,-5600,2900,3000,0,-2700
9702,8200,200,-2700,14000,0,19700
9703,-2700,-3200,-1700,-800,-1200,-9600
9704,100,-8600,1000,1000,0,-6500
9705,0,6500,500,400,0,7400
9706,100,3700,-2000,-10800,0,-9000
9707,-3800,1100,-9700,1200,-1200,-12400
9708,9100,-9100,6600,11400,-1200,16800
9709,-6400,7300,3900,-12000,0,-7200
9710,9100,-6400,14800,14200,-2150,29550
9711,-800,10100,-3100,-10800,-950,-5550
9712,-1800,6400,2000,-2900,1950,5650
9713,100,-2800,2800,-6700,1950,-4650
9714,-3000,9200,0,3000,0,9200
9715,7600,300,-2700,6100,1950,13250
9716,-8200,-2700,2000,-2900,1950,-9850
9717,6200,-2800,3800,14000,0,21200
9718,11200,-800,0,-1000,0,9400
9719,-3900,10100,-900,4000,0,9300
9720,-2000,0,-2800,0,0,-4800
9721,0,-5600,4700,13400,-2400,10100
9722,-4700,200,-2700,2000,0,-5200
9723,7200,-2600,-1100,14600,-3350,14750
9724,0,-3600,2000,-3800,-950,-6350
9725,-7500,-2700,3800,-1900,2900,-5400
9726,13100,3400,1900,-2700,-200,15500
9727,100,100,-15100,6500,1950,-6450
9728,-3000,3700,1100,-9000,0,-7200
9729,200,6800,1100,-8700,1950,1350
9730,-4200,-2600,-1900,12000,0,3300
9731,9100,-8300,900,200,0,1900
9732,1000,900,16800,-1000,0,17700
9733,-6700,-6400,3900,3200,-1200,-7200
9734,-8400,7300,4800,3000,0,6700
9735,23200,-6300,2000,-3000,-950,14950
9736,0,-3700,-2100,16200,0,10400
9737,0,16600,1100,-13900,1950,5750
9738,0,-6200,200,10000,-950,3050
9739,-3000,-5500,2900,12100,2900,9400
9740,-6700,9400,-800,-9000,0,-7100
9741,-2800,8400,1000,1000,0,7600
9742,12000,4500,2900,1000,0,20400
9743,100,-2800,-4900,3200,0,-4400
9744,100,3900,-2900,2200,0,3300
9745,-2800,-5500,3900,10000,0,5600
9746,-800,800,-8300,200,0,-8100
9747,1200,-6000,-2700,10000,0,2500
9748,-3600,7300,14000,-13800,0,3900
9749,6700,6400,4800,-13800,-1200,2900
9750,-3000,-9100,6700,11200,0,5800
9751,8400,10000,2900,-14800,0,6500
9752,0,-800,-2400,12400,0,9200
9753,-3000,7600,-2600,-9000,0,-7000
9754,-2800,-5300,2100,10000,0,4000
9755,-600,-2800,-3000,-600,-1200,-8200
9756,12100,-3400,2900,5400,0,17000
9757,-5800,-5500,3900,2000,0,-5400
9758,-5800,9300,2000,11200,-2150,14550
9759,10400,-6300,-1100,12400,-2150,13250
9760,-2000,100,1000,-4700,1950,-3650
9761,-9400,18600,-600,-11300,1950,-750
9762,12200,-11000,2000,-800,-2150,250
9763,-4700,-3500,-800,10100,2900,4000
9764,10000,-5400,3000,-3700,1950,5850
9765,-3000,15700,1100,4000,0,17800
9766,-4500,-600,2000,-7600,0,-10700
9767,12300,-1100,6700,0,0,17900
9768,1100,-500,-5500,8200,-10200,-6900
9769,0,4500,2000,2000,0,8500
9770,-3700,800,6400,-11800,0,-8300
9771,1000,-3300,-2600,11200,10800,17100
9772,-3000,4500,1700,-6800,0,-3600
9773,-3000,-6200,-100,13400,-2150,1950
9774,5600,-6300,4900,-2000,0,2200
9775,-3800,19400,100,2300,750,18750
9776,9000,6600,-10800,-900,1950,5850
9777,400,-8200,1000,9000,-950,1250
9778,0,9500,-3400,10200,-1200,15100
9779,-2800,-5400,2700,-1700,1950,-5250
9780,-3500,6400,12100,1000,-950,15050
9781,9200,-8200,3100,-4700,2900,2300
9782,-3000,3700,-6100,12200,0,6800
9783,0,-3400,2000,-5800,0,-7200
9784,-2800,1700,4600,-9800,0,-6300
9785,-4600,-3400,9300,11000,0,12300
9786,13000,-8300,3600,200,0,8500
9787,0,3900,-700,1000,0,4200
9788,-900,18600,-11900,9400,0,15200
9789,1000,-11100,7600,-2000,0,-4500
9790,-2900,6600,-1600,15000,0,17100
9791,-900,-9000,3900,-2000,0,-8000
9792,6700,7300,11900,-8000,0,17900
9793,-3000,6500,-800,2000,0,4700
9794,-3600,900,5800,-12000,0,-8900
9795,12000,-2800,100,10200,0,19500
9796,0,6400,1000,-8800,-1200,-2600
9797,100,-2500,-2700,11200,-1200,4900
9798,100,3800,-800,-12000,-950,-9850
9799,-5600,-8300,5700,13000,0,4800
9800,0,3800,-9800,-5900,1950,-9950
9801,-3800,-6300,-1300,15400,-950,3050
9802,3400,-2600,15900,-1900,2900,17700
9803,-700,15800,100,1000,0,16200
9804,12000,-6400,2000,-1000,0,6600
9805,-3000,-5400,1100,14000,0,6700
9806,-3000,18700,-2000,-8800,0,4900
9807,0,-8800,-600,-1800,-1200,-12400
9808,-3800,-5500,800,16400,-1200,6700
9809,6200,5700,5800,-800,0,16900
9810,8400,-6400,5700,-1000,-950,5750
9811,300,10200,-4700,-14700,750,-8150
9812,-3600,18400,2000,0,-950,15850
9813,1200,-5500,1900,-4900,1950,-5350
9814,-3000,-6200,2000,14000,0,6800
9815,-800,4600,-800,-14900,1950,-9950
9816,1000,-6500,2000,11400,-2150,5750
9817,0,4600,800,-15700,2900,-7400
9818,-3400,6600,-3000,200,0,400
9819,9200,-5500,3000,-1800,0,4900
9820,100,1000,2000,1200,-1200,3100
9821,-3700,-3600,4800,-4800,0,-7300
9822,1100,-2800,-1200,11200,0,8300
9823,-2800,-6200,3000,9000,-950,2050
9824,11200,6400,100,2000,-950,18750
9825,-3700,5800,-11900,7500,1700,-600
9826,1100,4800,200,-4900,1950,3150
9827,-2600,700,14900,3000,0,16000
9828,-3800,-3300,-700,-2800,0,-10600
9829,11100,-8200,3000,11200,-1200,15900
9830,1200,12600,-8400,-600,0,4800
9831,-2800,-3600,2000,9000,-950,3650
9832,0,-5400,14900,-4000,0,5500
9833,200,6800,-6700,700,-450,550
9834,-5800,8400,3900,-1800,-950,3750
9835,8500,4500,3600,-7500,2900,12000
9836,-3000,-6300,1100,4200,-2150,-6150
9837,-8600,-6100,2800,12200,-950,-650
9838,10300,16500,2000,-13900,2900,17800
9839,-2600,-6100,-1800,10100,1950,1550
9840,6200,-6400,2700,14200,0,16700
9841,0,3800,3900,-800,-1200,5700
9842,200,6500,-4200,1600,-1200,2900
9843,0,-6400,4800,-3600,-2150,-7350
9844,-4500,16400,1100,3000,0,16000
9845,7200,6500,-7100,-1700,750,5650
9846,0,-5400,200,11000,-1900,3900
9847,100,-7200,2800,-4900,2900,-6300
9848,-3700,100,9000,11300,1950,18650
9849,8300,16300,1100,-9000,-950,15750
9850,1100,-2800,3700,3300,2900,8200
9851,-5800,9500,-1700,-9000,0,-7000
9852,11200,-5800,1000,13000,0,19400
9853,0,-5500,1700,-800,0,-4600
9854,-3000,9300,-1800,5000,0,9500
9855,-3900,-2800,3800,10200,0,7300
9856,1100,-500,-4600,-3000,0,-7000
9857,100,-1300,2000,4000,0,4800
9858,-2700,-2500,1100,-4800,0,-8900
9859,11300,-6300,2000,11000,0,18000
9860,-8600,-600,3000,-1600,-1200,-9000
9861,-3600,19200,-7100,10000,0,18500
9862,9300,-2400,-1900,-1800,-950,2250
9863,-2800,-3600,14900,0,0,8500
9864,11400,7300,-1900,-2900,1950,15850
9865,-900,-5500,2000,10000,-950,4650
9866,1000,-3300,-1700,-5900,2900,-7000
9867,-5600,10200,1000,-12800,0,-7200
9868,0,-2500,-1600,7400,-1200,2100
9869,-3600,-5500,5800,-3800,0,-7100
9870,9300,3600,4700,0,0,17600
9871,-2900,-3500,-900,2000,0,-5300
9872,-3000,-2700,2000,10600,-2400,4500
9873,7600,100,-1200,-800,0,5700
9874,-1900,8600,-4600,15200,-2150,15150
9875,100,-1200,4800,400,-2150,1950
9876,100,-5400,-800,-2900,1000,-8000
9877,-2900,900,-7100,11100,2900,4900
9878,11200,-6100,-1600,-4900,1950,550
9879,-1700,1900,10100,-10400,-2150,-2250
9880,-700,-6300,4500,3500,2900,3900
9881,-3700,-6300,-300,11400,0,1100
9882,1100,1700,2000,-12000,-950,-8150
9883,100,10200,5800,1000,-950,16150
9884,-800,-6300,100,-4900,2900,-9000
9885,-3700,-2700,1000,9300,1950,5850
9886,10000,6400,-6200,5400,-10200,5400
9887,200,3000,-1000,8200,0,10400
9888,-6600,-8000,14800,4400,-1200,3400
9889,8100,3600,2000,2000,12000,27700
9890,-2600,5700,2900,-2000,0,4000
9891,-1800,1600,3000,4000,0,6800
9892,-3700,6500,-1800,-9000,0,-8000
9893,12200,3900,-700,-2000,0,13400
9894,-5800,-3300,3000,200,0,-5900
9895,4800,7300,-1700,3000,0,13400
9896,200,-9100,2000,10000,0,3100
9897,-2000,4600,3900,-12800,0,-6300
9898,5400,3600,3900,3000,0,15900
9899,100,-500,100,-4800,0,-5100
9900,-3800,-3500,-2100,11200,0,1800
9901,200,6400,-100,-1800,0,4700
9902,9000,-1800,4600,5200,0,17000
9903,-3000,-6200,-700,2000,0,-7900
9904,-2800,16600,4800,0,0,18600
9905,-3700,6600,-13600,3000,0,-7700
9906,12200,-9100,1900,9000,0,14000
9907,0,7200,-7100,-3400,-2400,-5700
9908,0,3900,12800,3200,0,19900
9909,-5800,-3500,1100,0,-950,-9150
9910,-800,1600,16800,200,-2150,15650
9911,9100,6600,-900,-9900,2900,7800
9912,-3000,-3500,-800,11100,1000,4800
9913,0,7400,2000,-14800,0,-5400
9914,-6500,6500,2000,-900,1950,3050
9915,9000,200,-800,-400,-3350,4650
9916,-900,3600,3800,-3900,2900,5500
9917,1000,100,-4200,-600,0,-3700
9918,-4800,-5600,2000,11000,-950,1650
9919,1300,-6100,1000,8200,-2150,2250
9920,9100,7300,1000,-13700,2900,6600
9921,-2900,6600,-3900,2500,750,3050
9922,-2600,-5600,3800,-6000,0,-10400
9923,8200,-3300,200,13400,-2150,16350
9924,-5700,7300,1100,-10800,0,-8100
9925,11300,-5400,2900,4500,750,14050
9926,0,700,1100,-9000,-950,-8150
9927,-3000,-6200,3900,7300,2900,4900
9928,0,4400,2000,-1000,-950,4450
9929,0,6300,1900,-9800,-950,-2550
9930,-3000,-600,-1800,9100,2900,6600
9931,-900,7300,-4100,-11500,1950,-7250
9932,-1700,-11400,6600,12000,0,5500
9933,-800,-3500,1000,-1000,0,-4300
9934,11200,4500,200,200,0,16100
9935,1000,3600,-1700,-9000,0,-6100
9936,0,-6200,2000,11200,-1200,5800
9937,-5600,200,1100,-1000,0,-5300
9938,-3000,-6200,3000,10200,0,4000
9939,-800,6600,200,12000,0,18000
9940,9400,6400,3800,-14000,0,5600
9941,-3000,12300,-3600,14000,0,19700
9942,-900,3800,1200,-14800,0,-10700
9943,1000,-11300,5700,10000,0,5400
9944,100,-600,-4900,9400,-10200,-6200
9945,-3700,7200,3600,-3400,0,3700
9946,8100,-700,-2000,600,-1200,4800
9947,1000,-2700,3600,3800,10800,16500
9948,200,6500,-1100,-800,-950,3850
9949,-5800,-3300,200,11000,0,2100
9950,8400,-8400,-4700,5500,1950,2750
9951,-7400,9400,100,4000,-950,5150
9952,10000,5700,-800,-1900,2900,15900
9953,0,-5400,14000,11000,0,19600
9954,-6600,7400,2000,5000,0,7800
9955,9000,6700,200,-11800,0,4100
9956,0,-2600,-2600,10000,0,4800
9957,-3000,-6400,4800,-800,0,-5400
9958,-3000,7200,-6500,10400,0,8100
9959,11200,-500,-3600,-800,-1200,5100
9960,-2800,7400,13100,2000,0,19700
9961,-3900,-5600,1700,1200,0,-6600
9962,1000,-2600,-2700,11000,-950,5750
9963,5400,6400,4800,-9800,-950,5850
9964,-2700,200,2900,5300,2900,8600
9965,100,0,-2800,-2700,750,-4650
9966,-2700,-2500,3000,17400,-10200,5000
9967,8600,-3600,-200,10200,0,15000
9968,0,4500,2000,-10000,0,-3500
9969,0,-2600,1000,9000,12000,19400
9970,0,-6400,2900,200,-1200,-4500
9971,0,0,-10200,19200,0,9000
9972,0,21400,-2700,-10800,-2150,5750
9973,100,-8600,15800,12200,-2150,17350
9974,-3900,-700,-3900,-700,2900,-6300
9975,200,1600,3700,-1900,1950,5550
9976,1000,-2700,1000,-800,-2150,-3650
9977,-2700,6600,-3000,200,-950,150
9978,-800,-8200,1200,-3900,2900,-8800
9979,9000,-6200,2000,10100,1950,16850
9980,100,4600,1100,-13000,0,-7200
9981,-2700,-6200,-900,13000,0,3200
9982,-2900,-9100,1100,2000,0,-8900
9983,11200,13700,4800,0,0,29700
9984,-3000,4000,-1600,4000,0,3400
9985,-5700,-6300,3900,-800,-1200,-10100
9986,-800,10100,1000,-3800,0,6500
9987,9100,6600,-2000,-8800,0,4900
9988,-5700,200,-2000,10400,-950,1950
9989,8500,3600,6600,-13600,-2150,2950
9990,0,-8300,-700,12100,2900,6000
9991,-2900,-9200,5700,5500,-8250,-9150
9992,0,7300,100,0,0,7400
9993,0,3700,1700,-10800,12000,6600
9994,0,-6400,-11000,23200,0,5800
9995,-3600,4600,3000,-10800,-1200,-8000
9996,9200,6700,7400,5000,0,28300
9997,-3000,-6300,1100,2200,-2150,-8150
9998,-800,1900,4900,-3800,-950,1250
9999,1000,3400,100,-11900,2900,-4500
10000,-6600,-3500,3800,11100,1950,6750
10001,9200,7400,1100,-3800,-10200,3700
10002,-3800,-400,-5400,15000,0,5400
10003,11100,-8400,5700,11000,0,19400
10004,1100,15800,-800,-13000,12000,15100
10005,-3000,-5600,3800,15200,-1200,9200
10006,-5800,9400,-800,-7800,-1200,-6200
10007,-3500,6400,2800,0,-950,4750
10008,12100,100,-5200,1600,-1200,7400
10009,-900,-5500,1100,18300,-8250,4750
10010,1100,-5400,2900,8200,-950,5850
10011,-2800,3800,900,-12700,1950,-8850
10012,0,-6300,1100,6100,13950,14850
10013,-2800,4400,4500,-9800,0,-3700
10014,-1700,9400,100,-4700,1950,5050
10015,13000,300,-6400,0,0,6900
10016,-8600,-2500,7500,3800,0,200
10017,-800,-2700,-3800,600,-2400,-9100
10018,12000,900,7600,-3800,0,16700
10019,0,-3400,-4100,2400,0,-5100
10020,-2700,7500,-700,0,-950,3150
10021,0,-6300,3900,-3400,-3350,-9150
10022,0,-11300,6700,8500,1700,5600
10023,-600,18500,-11900,-4700,750,2050
10024,-1700,-2600,200,10000,-950,4950
10025,-700,-9100,17700,5200,-950,12150
10026,1000,-3500,-2000,-2700,1950,-5250
10027,-3700,16600,3900,-2900,1950,15850
10028,-2600,9600,-12600,8400,-12350,-9550
10029,9100,-2700,-1700,11100,2900,18700
10030,100,-3600,3500,-10300,1950,-8350
10031,0,-2600,13100,6200,12000,28700
10032,0,-5300,-300,-4200,-1200,-11000
10033,-3000,5900,-1000,14200,0,16100
10034,11400,-2500,-5500,-1000,0,2400
10035,0,-9200,3900,9200,-950,2950
10036,100,10100,200,4200,-2150,12450
10037,-5800,100,-100,-4300,1700,-8400
10038,100,-1700,2800,-15500,750,-13550
10039,-800,6000,1200,16400,-10200,12600
10040,-2000,-1100,-5100,13200,-2150,2850
10041,11200,900,3000,-13000,11050,13150
10042,100,-9100,14900,9100,1950,16950
10043,-3000,1800,3000,-10700,750,-8150
10044,0,6400,2900,-2800,-950,5550
10045,-3000,-6200,3000,-3700,2900,-7000
10046,-6500,7400,100,100,1950,3050
10047,12100,1000,3000,-15000,0,1100
10048,-2700,-500,-4100,10600,0,3300
10049,-2900,4500,1100,3000,0,5700
10050,11400,900,3800,-15800,0,300
10051,-3000,-8200,2100,14000,0,4900
10052,-2700,900,4800,-11000,0,-8000
10053,100,-9000,-2900,14200,0,2400
10054,-3000,-5600,1700,1200,0,-5700
10055,-700,13000,-7000,12200,-1200,16300
10056,8300,-6300,200,0,0,2200
10057,-1500,4700,3000,9200,-2150,13250
10058,-6600,6600,3000,1200,0,4200
10059,9300,-3400,10000,-2700,1950,15150
10060,-900,4600,-100,-9800,-950,-7150
10061,-2800,900,1100,-1700,1700,-800
10062,9500,-3600,2600,5400,0,13900
10063,-6500,7300,2600,-8600,0,-5200
10064,12000,900,-7900,11200,-950,15250
10065,0,-5300,-900,-5600,-950,-12750
10066,-2800,3800,-2700,1100,2900,2300
10067,0,-9200,19600,-7700,1950,4650
10068,-3800,1000,2000,5200,-1200,3200
10069,-2800,1900,-10300,12400,0,1200
10070,11100,-9100,3900,-1000,0,4900
10071,1100,-6300,11100,11000,0,16900
10072,0,16500,3000,-15800,0,3700
10073,-2800,6700,-9100,11200,0,6000
10074,0,-5500,1100,-1000,0,-5400
10075,-3000,-3600,16700,8400,-1200,17300
10076,100,11200,-1000,1200,-1200,10300
10077,0,7300,100,1000,0,8400
10078,-2800,6600,1100,-11000,-950,-7050
10079,-4700,-3400,-800,12200,-2150,1150
10080,13100,-5600,1900,7300,1700,18400
10081,-3900,15900,200,-10900,1950,3250
10082,1100,-6200,2000,10000,-950,5950
10083,0,4200,1000,-9000,-950,-4750
10084,-700,6400,1900,-3900,2900,6600
10085,1000,-3500,-900,-3700,750,-6350
10086,100,4600,1100,0,0,5800
10087,-3800,9300,-9900,10200,0,5800
10088,9100,-3600,0,1000,-950,5550
10089,100,7600,10200,0,-950,16950
10090,0,6500,-1700,-12700,1700,-6200
10091,-900,-11300,4800,11100,1950,5650
10092,-5500,6600,-7000,-4000,0,-9900
10093,9300,-6400,4800,9400,-1200,15900
10094,-3000,600,5700,1000,0,4300
10095,-3500,-6600,2900,11000,-950,2850
10096,6400,9300,3000,-800,-1200,16700
10097,0,6500,700,2200,-950,8450
10098,-2900,9400,200,6300,1950,14950
10099,-600,-5600,900,-2900,2900,-5300
10100,12100,3700,1900,0,0,17700
10101,-3700,-6200,2100,-3000,0,-10800
10102,-2000,10300,-1700,200,0,6800
10103,0,800,1100,-8000,0,-6100
10104,-2700,-5400,3000,9000,0,3900
10105,11200,900,-6100,-800,-1200,4000
10106,100,-3800,-11200,23200,0,8300
10107,-2800,10100,12100,0,-950,18450
10108,-3700,-800,1900,-600,-2400,-5600
10109,1000,-2800,10200,11100,1950,21450
10110,0,12200,-2700,-1000,-950,7550
10111,-2700,300,-2600,4300,1950,1250
10112,8400,-8300,6700,-1800,-2150,2850
10113,-3000,-12000,6700,11100,2900,5700
10114,100,10400,-15000,-5500,1950,-8050
10115,-3800,6500,-800,2000,0,3900
10116,9200,-5400,13800,12400,-1200,28800
10117,-700,900,-4100,-7600,0,-11500
10118,-4800,-3400,3900,10200,-950,4950
10119,-3500,7200,-100,-11800,0,-8200
10120,8300,6800,1200,-5500,750,11550
10121,-5600,-5500,3900,1000,-950,-7150
10122,9200,-6100,1200,6100,2900,13300
10123,-7500,4400,3900,-7000,0,-6200
10124,7200,-6200,4800,11200,-1200,15800
10125,10300,-6300,2000,-2000,0,4000
10126,1000,16400,-1800,5200,-1200,19600
10127,0,6400,2900,-15800,-950,-7450
10128,0,-2700,1000,12000,-950,9350
10129,-2800,9400,-4700,-11900,2900,-7100
10130,-2800,-2700,1100,5100,1950,2650
10131,-9400,-2700,6700,1400,-1200,-5200
10132,9000,100,-1800,13200,-1200,19300
10133,11200,3700,2900,-12000,-950,4850
10134,-2900,0,-1000,15000,-950,10150
10135,-2800,-5700,2000,-900,2900,-4500
10136,0,100,-1800,8300,750,7350
10137,-3700,-6400,2800,2000,0,-5300
10138,11100,100,-900,12000,0,22300
10139,1000,18400,-200,1200,-950,19450
10140,100,-2700,-1100,-800,-950,-5450
10141,300,-2500,-2700,5300,2900,3300
10142,-800,-8300,4800,-4900,1950,-7250
10143,1000,1000,-7900,9000,0,3100
10144,-900,-6400,3800,9200,-1200,4500
10145,-2700,10300,9100,-12600,-1200,2900
10146,-1900,6500,-800,3200,-1200,5800
10147,0,-11100,6700,-1000,-950,-6350
10148,0,9300,-900,-2000,-950,5450
10149,-7400,-700,-4200,2500,2900,-6900
10150,13100,1600,-100,-2700,1950,13850
10151,-2700,-5400,900,-1800,0,-9000
10152,100,-2100,2900,14200,-10200,4900
10153,-900,-8800,1200,-1000,0,-9500
10154,1000,7300,2000,-3800,0,6500
10155,-900,6400,-10100,-2600,12000,4800
10156,-1800,-6300,5400,6600,-1200,2700
10157,8200,7400,10300,-8000,0,17900
10158,-5700,3700,2900,4000,0,4900
10159,-3600,-600,-800,11000,-950,5050
10160,9100,-2400,-2600,-800,0,3300
10161,-8600,6500,5800,-1900,1950,3750
10162,10300,9300,100,-5700,1950,15950
10163,-2800,0,800,-5400,0,-7400
10164,12300,-2600,2800,4200,0,16700
10165,0,-6600,100,23200,-10200,6500
10166,-5800,4400,-4500,200,0,-5700
10167,100,-700,-900,10000,12000,20500
10168,0,10300,-3600,-12000,0,-5300
10169,-9400,-2700,15900,14000,0,17800
10170,9100,100,0,-600,-1200,7400
10171,-1700,-2700,-800,10000,0,4800
10172,10000,-2700,100,14000,0,21400
10173,-2700,-6200,100,2000,0,-6800
10174,0,-5500,1100,11000,0,6600
10175,-3500,15800,-9200,-1800,0,1300
10176,6200,-3400,-700,12000,0,14100
10177,0,1700,16800,-9800,-1200,7500
10178,100,-6100,200,6000,0,200
10179,0,-5600,1700,1400,-2150,-4650
10180,0,15800,-8900,12000,-950,17950
10181,-5800,-6400,6700,-4700,2900,-7300
10182,11200,10100,11100,-14900,1950,19450
10183,100,9300,-12100,11200,0,8500
10184,-2900,-5400,1100,-3000,0,-10200
10185,-3500,-2500,10300,12200,-1200,15300
10186,8100,6700,-9800,-800,0,4200
10187,-1900,-2600,1100,8200,-950,3850
10188,-3400,-6200,15000,-4000,0,1400
10189,12200,1600,2900,-14900,1950,3750
10190,-900,-3500,2900,-3800,-950,-6250
10191,-2800,7400,-1800,-900,2900,4800
10192,1000,3900,200,-14000,0,-8900
10193,-9300,-2700,2000,22200,-10200,2000
10194,12000,3700,800,1400,-1200,16700
10195,-3800,-6400,3600,400,12000,5800
10196,1000,4300,1000,1200,-1200,6300
10197,0,6600,-11700,-5800,-1200,-12100
10198,0,-11200,600,17600,-1200,5800
10199,-3600,3500,-9200,2200,-950,-8050
10200,12200,-8100,7900,8500,1950,22450
10201,-2900,800,2900,-8000,-1900,-9100
10202,-5700,-8800,12000,-2700,2900,-2300
10203,8400,4700,-8100,6300,1950,13250
10204,200,3700,14000,-13800,-950,3150
10205,100,-12100,2900,10100,2900,3900
10206,0,4500,-19100,6200,0,-8400
10207,-2900,3700,-7300,13600,-1200,5900
10208,-10200,-600,15900,-3800,0,1300
10209,3800,100,3600,8400,-10200,5700
10210,8200,9400,8400,-7000,0,19000
10211,8100,8700,200,-2800,12000,26200
10212,-1600,7200,-6500,6600,-1200,4500
10213,0,-9200,16800,0,0,7600
10214,0,10200,-13200,-1600,0,-4600
10215,0,6500,12100,0,-950,17650
10216,0,-8100,1200,0,-950,-7850
10217,-8400,-3500,2000,9100,2900,2100
10218,14100,4600,1000,-7500,750,12950
10219,100,6700,1100,-14800,0,-6900
10220,-3000,-9100,4500,22400,0,14800
10221,100,-5600,3600,5400,0,3500
10222,-3800,6700,-3800,-6800,0,-7700
10223,9100,6600,15000,-1800,0,28900
10224,-1700,3600,3800,-3800,0,1900
10225,-1000,-3600,1900,1200,-1200,-2700
10226,-3000,10200,-1800,4200,-1200,8400
10227,-800,-2800,1000,-2000,-950,-5550
10228,9000,-2600,100,14000,0,20500
10229,-800,3700,100,-1900,1950,3050
10230,-2800,200,-1700,-6700,1950,-9050
10231,1000,3600,6600,-2800,0,8400
10232,-3000,0,0,1000,0,-2000
10233,-700,300,-4600,9000,0,4000
10234,12000,-2700,1100,-4800,0,5600
10235,-5800,-5300,900,16200,0,6000
10236,-3000,-6200,2000,1000,0,-6200
10237,-3500,-6200,2000,12000,0,4300
10238,8400,6600,-1700,2000,0,15300
10239,1100,3700,100,-12000,0,-7100
10240,-3800,8700,-700,-800,0,3400
10241,12100,-8400,3900,10000,0,17600
10242,-5800,21300,4800,-16600,0,3700
10243,200,-8500,-1200,2200,0,-7300
10244,-3700,-3400,200,11000,0,4100
10245,-5600,4600,5800,1200,0,6000
10246,9100,-6300,1100,0,0,3900
10247,10300,-7100,-8500,21400,0,16100
10248,-2000,17400,1100,-10000,0,6500
10249,0,3700,4000,-800,-1200,5700
10250,-3000,-3600,100,15200,-1200,7500
10251,-3700,10100,11700,-11600,-950,5550
10252,9500,500,-6300,-3000,0,700
10253,-5700,-8300,5700,6300,750,-1250
10254,-7400,3700,2900,-7800,-2150,-10750
10255,8700,-3400,-800,-8900,1950,-2450
10256,13000,4500,3900,-1800,0,19600
10257,0,-6400,-2600,-1900,1950,-8950
10258,0,4500,5700,-4800,-950,4450
10259,-5800,-6400,3600,1500,1700,-5400
10260,-2900,9600,-4600,3000,0,5100
10261,-800,7300,-12000,11200,-950,4750
10262,6300,-5500,800,2200,0,3800
10263,-6500,-9100,17700,11300,750,14150
10264,12000,4400,2000,-13000,-950,4450
10265,-3000,3800,1100,1100,2900,5900
10266,100,-6200,-800,-1000,0,-7900
10267,-800,1800,2900,-2000,0,1900
10268,1100,-6600,-1200,2400,-1200,-5500
10269,-5800,-6100,2100,13000,0,3200
10270,-700,16500,-800,-2000,0,13000
10271,6200,3600,-3600,1400,-950,6650
10272,8200,-3600,1900,13000,-950,18550
10273,100,10000,0,-15900,2900,-2900
10274,100,6600,-2600,12100,1950,18150
10275,-5600,0,-1000,1000,0,-5600
10276,-700,-8300,2900,11000,0,4900
10277,9200,-3400,11300,0,0,17100
10278,-3000,1700,3000,2000,0,3700
10279,-4300,3900,-8500,-1600,0,-10500
10280,10000,-3500,-1700,14000,0,18800
10281,-2900,1800,17800,-13800,0,2900
10282,100,900,-400,1400,0,2000
10283,200,-12000,3000,1000,0,-7800
10284,-2900,1800,1100,2000,0,2000
10285,8500,-3400,-3200,12400,0,14300
10286,-2800,4400,900,-7000,0,-4500
10287,-6600,3700,3900,4000,0,5000
10288,9200,-6100,2100,-3000,0,2200
10289,-900,1900,1200,3200,-1200,4200
10290,-5500,3700,2900,-9000,0,-7900
10291,12000,-6400,2000,9000,0,16600
10292,-3000,4400,4700,-5800,-1200,-900
10293,-3800,9400,-1800,4000,0,7800
10294,9200,-3600,2900,-2000,-950,5550
10295,0,7100,-900,4000,0,10200
10296,-3000,9200,-3300,1500,1950,6350
10297,-3500,-6600,1000,-800,-2150,-12050
10298,12200,7300,1800,-3300,500,18500
10299,-3900,9400,-4800,-7800,0,-7100
10300,-5700,-2500,200,10200,-950,1250
10301,300,-5600,4800,4400,-1200,2700
10302,9000,-6200,-100,-1500,750,1950
10303,-2900,4600,100,-9000,-950,-8150
10304,-2800,900,5800,-1900,1950,3950
10305,5700,-700,1000,10000,-950,15050
10306,-3600,-2800,3800,-3700,1700,-4600
10307,12100,-2900,-3900,10500,750,16550
10308,-2900,15600,4700,-9000,-950,7450
10309,-2700,-500,-4600,10000,-950,1250
10310,-2700,7400,-1700,-13900,2900,-8000
10311,8200,-5300,3000,8300,1950,16150
10312,-2900,-5400,-800,0,0,-9100
10313,0,6400,1700,6600,-10200,4500
10314,-4500,-5500,5800,-3600,-1200,-9000
10315,6400,6500,-7100,10200,-1200,14800
10316,1000,-500,-1700,8400,9850,17050
10317,-4700,-5500,15900,-1800,0,3900
10318,10000,-2700,1000,10300,750,19350
10319,200,8700,-4700,-3800,-950,-550
10320,-2800,4600,2900,-3700,1950,2950
10321,-3900,-5600,2000,-900,1950,-6450
10322,12200,-6400,1600,11200,-950,17650
10323,0,-11800,300,-1900,2900,-10500
10324,-3000,6800,-1900,14200,0,16100
10325,-2800,6700,200,1000,0,5100
10326,-7200,5600,1800,2000,0,2200
10327,13100,4500,-1900,-1600,0,14100
10328,-3600,-6300,800,-800,0,-9900
10329,-2700,3800,-8900,9200,0,1400
10330,9100,3100,1200,1600,-3600,11400
10331,-2700,1600,16500,400,-1200,14600
10332,-3500,3600,-800,-8600,-3350,-12650
10333,9200,-9100,4800,13200,-2150,15950
10334,-5600,7400,0,-14500,1700,-11000
10335,-6600,1100,4900,3300,-200,2500
10336,4500,-3600,2000,12000,0,14900
10337,13100,4400,5600,-16500,-200,6400
10338,200,3800,-4600,3000,-950,1450
10339,0,-6400,-11900,8300,1950,-8050
10340,200,4600,2000,-5700,1950,3050
10341,-9300,6400,15900,-8000,-1900,3100
10342,3400,6800,-7900,8300,1700,12300
10343,-1600,-5400,-800,-4900,1950,-10750
10344,10100,900,3800,4000,-1900,16900
10345,-3400,-6400,11000,7300,2900,11400
10346,12000,4400,1100,-15900,1950,3550
10347,-6700,900,5500,-5600,-2150,-8050
10348,-1600,-9100,100,10100,2900,2400
10349,-700,-2700,1000,4300,1950,3850
10350,9000,15900,-10000,2200,-950,16150
10351,-5600,-3400,-2000,9500,1700,200
10352,-700,1700,13700,-10800,0,3900
10353,9300,3800,200,10200,-11150,12350
10354,-2700,3700,-8000,-800,-2150,-9950
10355,-4300,-2700,3800,5300,14900,17000
10356,13100,-1800,10400,100,1950,23750
10357,-5600,3900,-17100,7400,-1200,-12600
10358,100,-8400,2600,9400,-1200,2500
10359,-3700,6500,2800,-4400,-950,250
10360,7200,-6100,2100,9200,0,12400
10361,-700,1600,6600,-15900,1950,-6450
10362,-4600,9200,11100,1200,-950,15950
10363,13200,-5800,-3600,-5900,2900,800
10364,-2800,4500,3900,1000,0,6600
10365,-5800,-3500,15000,-1800,0,3900
10366,-6600,-3400,900,10400,0,1300
10367,11100,16600,200,-12000,0,15900
10368,1000,6700,1800,-4400,0,5100
10369,-6700,-2500,2100,-1800,0,-8900
10370,11300,3600,2900,-1000,0,16800
10371,-6400,-2600,1100,11200,-1200,2100
10372,10200,3800,1100,-11000,0,4100
10373,100,-2700,1000,8200,0,6600
10374,-2900,3700,100,-8000,-950,-8050
10375,0,-5500,2000,9000,-950,4550
10376,-3800,3900,2000,-9900,2900,-4900
10377,9000,-6300,-100,11300,1950,15850
10378,0,4400,1700,-11800,0,-5700
10379,-2800,3700,2000,2000,0,4900
10380,0,-6400,3800,200,-1200,-3600
10381,0,-3000,0,13200,-1200,9000
10382,-3700,-600,-1800,2000,0,-4100
10383,9000,9400,-800,12000,0,29600
10384,-2800,-5400,3000,-1800,-2150,-9150
10385,-900,8800,-3500,9100,1950,15450
10386,1000,1700,3900,-13000,0,-6400
10387,200,-6200,1000,6100,1950,3050
10388,-3700,9400,-4500,-9800,0,-8600
10389,6200,1800,-4400,13400,-1200,15800
10390,100,-7900,300,-3000,0,-10500
10391,-900,-1800,-11200,15400,-950,550
10392,-6400,-6400,15900,-1000,0,2100
10393,13100,4500,1000,-3900,1950,16650
10394,-2800,900,15400,2600,-2150,13950
10395,-2800,-6400,1000,-2700,1700,-9200
10396,-800,-6300,1800,8400,0,3100
10397,11200,13700,2600,-9600,-2150,15750
10398,-1700,6500,1000,-2000,0,3800
10399,-3000,3600,-8300,500,750,-6450
10400,-2700,-2700,-200,11200,-950,4650
10401,-600,6500,-900,-4900,1950,2050
10402,9300,-3300,9400,1400,-3350,13450
10403,-2800,-8400,2500,18500,-7300,2500
10404,-2800,6500,-600,-16100,1000,-12000
10405,-6600,8400,2000,15000,0,18800
10406,12100,1500,4800,-15700,13950,16650
10407,0,6700,-2600,-1000,-950,2150
10408,-9100,-3400,7700,5500,1700,2400
10409,9200,4800,-2700,-9000,0,2300
10410,5700,300,-1900,6200,0,10300
10411,-4600,1000,2000,-7000,0,-8600
10412,12100,-8500,-100,13200,0,16700
10413,1000,-9200,3000,-3000,0,-8200
10414,-5800,-9100,6700,14000,0,5800
10415,0,13600,2000,-7000,0,8600
10416,100,9300,-1800,-1000,0,6600
10417,0,-6400,2600,-800,0,-4600
10418,-2800,7100,100,4000,0,8400
10419,8200,5800,-9900,1000,0,5100
10420,200,-5300,-1700,10000,0,3200
10421,0,4700,11300,-10000,0,6000
10422,-2800,3800,3000,0,0,4000
10423,0,-6100,-1600,-1000,0,-8700
10424,-3800,-8100,2100,14000,0,4200
10425,6200,18700,4900,-14600,0,15200
10426,-3600,6800,-1600,1000,0,2600
10427,9100,-5400,2900,11200,0,17800
10428,100,-9000,2100,-4000,0,-10800
10429,-2600,-6400,1900,11200,-1200,2900
10430,-8400,16600,2100,-8000,0,2300
10431,13100,3700,1700,-800,-950,16750
10432,-1600,-3600,2000,-4000,-950,-8150
10433,100,-8600,3700,12300,1700,9200
10434,-2900,-800,-1900,-2900,1950,-6550
10435,8500,18400,-6200,10200,-1200,29700
10436,-3000,400,-4500,15000,0,7900
10437,-6600,9300,2000,1000,0,5700
10438,12000,-2800,15800,-3800,-950,20250
10439,-2900,-800,-1900,14200,-2150,6450
10440,-3800,4500,1000,100,2900,4700
10441,9400,-2700,1900,-4900,1950,5650
10442,-3000,-5600,-7300,25200,0,9300
10443,0,6500,-14500,1000,0,-7000
10444,-900,-2700,15800,9200,0,21400
10445,1000,6300,-14000,-800,0,-7500
10446,-3600,-4900,-4500,11400,-1200,-2800
10447,9000,-3600,14700,-3400,0,16700
10448,-2800,4500,-400,2800,-2150,1950
10449,0,-9000,14100,-5000,0,100
10450,-3800,2000,5600,-2300,1950,3450
10451,9100,3600,1900,-9000,-950,4650
10452,-900,-6300,-1000,6300,2900,1000
10453,-6400,7600,200,-9400,-2400,-10400
10454,13000,700,-8000,12000,0,17700
10455,-2800,-3400,2000,10000,-950,4850
10456,-2800,1500,15000,-8000,0,5700
10457,0,800,3000,-1700,1950,4050
10458,100,-3300,-2000,-4600,-950,-10750
10459,-2800,4300,3000,-2700,2900,4700
10460,-3800,3700,-8200,2400,-1200,-7100
10461,12000,-8200,2100,9000,0,14900
10462,-3000,3700,3800,3200,-950,6750
10463,0,-9300,1700,14200,-950,5650
10464,100,3700,1000,-13900,2900,-6200
10465,0,1400,5800,11100,1950,20250
10466,0,9300,-900,1000,0,9400
10467,-3800,-3600,13000,2000,0,7600
10468,8400,10200,-2100,-9600,-1200,5700
10469,1000,3600,2000,0,0,6600
10470,-5700,-2600,-200,15200,0,6700
10471,10300,6600,1100,-13600,-1200,3200
10472,-2000,-2800,-2000,14200,0,7400
10473,-2700,6600,2900,-13800,-950,-7950
10474,0,-5500,1100,12000,0,7600
10475,200,-6300,2900,-5900,1950,-7150
10476,100,4400,2800,1000,-950,7350
10477,-3900,6600,-800,1100,2900,5900
10478,12300,-2700,0,-3000,0,6600
10479,-2800,6300,-800,4000,0,6700
10480,0,-8400,2000,1400,-2400,-7400
10481,0,9300,-1700,-2600,-1200,3800
10482,-3000,100,4700,-3400,-1200,-2800
10483,200,-2700,-2800,10000,-950,3750
10484,0,-8400,-5700,9400,-950,-5650
10485,-800,600,-8100,9100,1950,2750
10486,1100,9200,-13400,8700,750,6350
10487,100,-5500,7300,2200,-950,3150
10488,-3900,-6200,3000,6300,2900,2100
10489,-2500,-400,7600,-6700,1950,-50
10490,9300,16500,4700,-800,0,29700
10491,0,-5400,13100,-2000,0,5700
10492,-3500,-9400,3800,14000,0,4900
10493,9200,4600,3000,-11000,0,5800
10494,-2800,3700,200,3000,0,4100
10495,-800,6400,800,-3400,-1200,1800
10496,-4500,-6400,3600,-400,-1200,-8900
10497,8200,-5500,2000,13000,0,17700
10498,-3900,3800,-700,-9000,-950,-10750
10499,9500,12900,-4300,10200,-2150,26150
10500,0,-2600,-800,-2700,1700,-4400
10501,200,3600,14800,-5700,-200,12700
10502,-2900,9400,-13700,3000,0,-4200
10503,-2900,-5400,100,11300,750,3850
10504,-1700,-11200,6700,-2000,-1900,-10100
10505,10100,-6400,13900,9100,2900,29600
10506,0,9300,-2100,-14700,1950,-5550
10507,0,5800,1100,8000,-950,13950
10508,300,4200,-1000,-10900,2900,-4500
10509,-5800,-700,1100,-800,0,-6200
10510,-1700,-2600,1100,7200,0,4000
10511,10000,12000,-1400,-1400,0,19200
10512,-2700,-5500,6700,7200,0,5700
10513,100,-3000,-2200,1200,0,-3900
10514,-2800,6800,-14500,12000,0,1500
10515,8400,-5500,2700,200,0,5800
10516,0,-2100,15900,4000,0,17800
10517,-2900,-6400,4800,-1800,0,-6300
10518,0,10400,-14800,11200,0,6800
10519,-2800,6300,-1100,-7800,0,-5400
10520,-4500,-2600,12200,10000,0,15100
10521,12100,600,2000,-7800,-1200,5700
10522,-4800,3900,4000,200,0,3300
10523,11400,-2700,-2800,-3000,-950,1950
10524,-5600,3700,6700,-1000,0,3800
10525,-6500,-2700,700,4400,-2150,-6250
10526,12100,9400,-7600,-1700,2900,15100
10527,-2900,-8400,5700,-3700,1950,-7350
10528,-3500,-9200,4800,10400,-1200,1300
10529,12100,-5500,1100,-1800,-1200,4700
10530,-3800,3800,1900,5000,0,6900
10531,-1800,8500,1100,-1800,-2150,3850
10532,-4400,7400,800,1400,-2150,3050
10533,13000,6400,-11100,6300,1000,15600
10534,-900,-5600,5700,-7700,2900,-5600
10535,1000,6200,2000,9100,1950,20250
10536,300,-2400,-5600,-2000,-950,-10650
10537,-5800,-5600,5700,21300,2900,18500
10538,200,3800,-12100,-1800,0,-9900
10539,200,800,-6200,11000,0,5800
10540,-6400,100,13100,-2000,0,4800
10541,9300,3700,3800,0,0,16800
10542,0,-500,7500,12000,0,19000
10543,-6400,7500,4000,-13800,0,-8700
10544,9300,-2800,14600,9400,0,30500
10545,-2800,-5400,200,-2000,0,-10000
10546,11400,-9200,2800,11000,0,16000
10547,-3600,-2800,2600,-800,0,-4600
10548,-2000,6500,-10900,12200,-1200,4600
10549,-900,6700,200,-800,-1200,4000
10550,-4700,3800,4000,13000,0,16100
10551,-3600,-600,-3500,-3000,-950,-11650
10552,12000,-8500,6700,10800,-3350,17650
10553,300,-400,8400,3300,2900,14500
10554,-6600,13900,4000,-11900,1000,400
10555,12000,-6100,1200,7200,0,14300
10556,-5400,7500,-2000,-13700,1950,-11650
10557,-800,-9200,3900,6100,1950,1950
10558,11200,-2200,3800,-7800,-1200,3800
10559,1000,7400,1000,-3800,0,5600
10560,-900,-3400,-1000,-2400,-2150,-9850
10561,-4800,-3200,-700,10200,0,1500
10562,-2900,4700,2000,-2700,1950,3050
10563,7500,11300,1100,5400,-11150,14150
10564,-1800,4700,4900,-5300,500,3000
10565,-3800,-5400,200,3000,12000,6000
10566,12000,1000,-7200,10200,-950,15050
10567,-900,-6300,3900,-3800,-950,-8050
10568,-2000,7200,100,-700,1700,6300
10569,0,9500,12100,-13800,-950,6850
10570,-3000,-2800,2000,7500,1700,5400
10571,-3400,-2500,100,-800,-2150,-8750
10572,12200,3900,-12600,9000,-950,11550
10573,-5700,-5500,3800,100,1950,-5350
10574,0,-9200,200,10100,1950,3050
10575,-3600,-3600,14000,-1000,-950,4850
10576,12100,19400,200,-5700,2900,28900
10577,-2900,3700,6600,-2500,750,5650
10578,-1800,9200,-10000,-2000,0,-4600
10579,2000,200,-4900,10200,0,7500
10580,-900,-5600,14000,0,0,7500
10581,-1900,-2600,2000,8200,0,5700
10582,-800,-6200,1100,-1800,-1200,-8900
10583,-2800,4500,2900,3000,0,7600
10584,9400,-3400,-1800,-800,-2150,1250
10585,-800,4500,1000,1000,-950,4750
10586,-7600,-6100,4000,8100,2900,1300
10587,8400,7300,-100,-13700,1950,3850
10588,-3600,6700,1200,-2800,0,1500
10589,9000,100,-200,-600,0,8300
10590,-5700,-2700,-10100,24200,0,5700
10591,11200,-8100,3100,-4800,0,1400
10592,-2900,-6400,13900,14000,0,18600
10593,-800,18600,-18300,5400,0,4900
10594,1000,200,-3600,10000,0,7600
10595,-2700,3800,3900,-15800,0,-10800
10596,-3600,-2700,14000,10400,-2400,15700
10597,12000,700,2000,-8000,0,6700
10598,-3900,-5200,11300,14000,-950,15250
10599,-1700,6700,-800,0,-950,3250
10600,-6600,-2700,-100,-700,2900,-7200
10601,9000,800,6700,-2700,1950,15750
10602,100,-6400,2800,-800,-1200,-5500
10603,-6500,10100,-900,3000,0,5700
10604,5300,9700,-3800,-9800,0,1400
10605,200,-2700,100,10000,-950,6650
10606,8200,-2700,-3900,15200,-950,15850
10607,300,-11100,5600,-9700,2900,-12000
10608,-1900,-3400,-4100,6700,1950,-750
10609,-3000,-1700,4000,-8000,0,-8700
10610,-4500,1600,5800,0,0,2900
10611,13000,-9000,3000,-2000,0,5000
10612,100,-6200,1100,7200,0,2200
10613,0,1700,3900,-13000,0,-7400
10614,-3000,15600,3800,3000,0,19400
10615,-4800,-800,-1200,16400,-1200,8400
10616,1200,4600,1100,-13000,0,-6100
10617,9000,-500,-3600,14000,0,18900
10618,-3000,-8800,300,2000,0,-9500
10619,100,16500,100,0,0,16700
10620,-3000,3800,3900,-10800,0,-6100
10621,9600,-7100,1000,10000,0,13500
10622,-3800,5400,1100,-11000,0,-8300
10623,-5800,3900,4000,200,0,2300
10624,11200,-6300,800,200,0,5900
10625,0,-1000,1200,3000,0,3200
10626,-3000,-3500,2000,11200,0,6700
10627,100,-3500,-2700,-2000,0,-8100
10628,0,13700,4800,1000,0,19500
10629,-3500,3500,1900,-10000,0,-8100
10630,9000,-400,-16800,25400,0,17200
10631,100,1800,-7100,-3000,0,-8200
10632,-7500,3800,14100,5200,-1200,14400
10633,12100,-8900,-1600,2200,-1200,2600
10634,-1700,4800,10400,1000,0,14500
10635,-5600,4000,-9900,13000,-950,550
10636,8400,-500,-1600,-3600,-2150,550
10637,-2800,7400,13800,-3500,1950,16850
10638,-5800,-6200,2100,-900,1950,-8850
10639,8500,7300,100,0,0,15900
10640,-6600,3700,4800,-9900,1950,-6050
10641,12000,-8800,300,12000,-950,14550
10642,-3300,7200,-2800,-13900,2900,-9900
10643,1100,-1600,-4100,5200,0,600
10644,-5500,-5300,4000,10000,0,3200
10645,-700,-6300,12100,200,-1200,4100
10646,9200,3800,-7000,11000,0,17000
10647,100,6400,2000,-3000,0,5500
10648,-6600,3700,4800,5200,-1200,5900
10649,12000,3400,4000,-1800,0,17600
10650,-5500,-2500,4800,9200,-950,5050
10651,7300,3800,2100,-12800,0,400
10652,1400,3600,2700,3300,1950,12950
10653,-3000,-9000,1800,3200,0,-7000
10654,100,-1200,2000,1100,1950,3950
10655,-2800,9200,6400,-9000,0,3800
10656,-700,-8800,4000,5200,0,-300
10657,11100,-8300,3000,-1000,0,4800
10658,-1900,900,1700,3200,0,3900
10659,-2700,3200,3000,12200,-1200,14500
10660,-5800,7300,1100,-8000,0,-5400
10661,8200,3600,-6100,10400,-1200,14900
10662,0,5000,-9900,-1000,0,-5900
10663,-3800,-3800,13100,14000,0,19500
10664,9000,3700,2900,-9000,-950,5650
10665,-900,-6100,-700,10000,-950,1350
10666,-4700,7300,10900,-12500,1700,2700
10667,11200,6400,2600,-5500,1950,16650
10668,-5800,-2500,900,-600,0,-8000
10669,-3000,3700,2000,3200,-1200,4700
10670,11200,-6400,2900,-3000,0,4700
10671,0,4200,1900,5000,0,11100
10672,-1800,9200,-1200,1400,-2150,5450
10673,2100,-800,-3800,-4000,0,-6500
10674,0,1500,3800,1100,1950,8350
10675,-6700,9200,-10200,3200,-950,-5450
10676,-5600,300,-800,7100,2900,3900
10677,9200,-2700,13100,-800,-1200,17600
10678,0,-5300,200,10000,0,4900
10679,-6600,-6400,4800,2200,-2150,-8150
10680,12000,7500,-3200,1400,0,17700
10681,-3000,3700,-8000,-1900,1950,-7250
10682,-6400,200,-1000,10400,-2150,1050
10683,9200,6500,9800,-2100,1700,25100
10684,500,-11400,2700,10200,-11150,-9150
10685,100,-6300,2900,7200,12000,15900
10686,-6600,7300,-9800,100,1950,-7050
10687,9300,-6200,3800,10000,-950,15950
10688,5400,-6300,13800,9700,-8500,14100
10689,-2800,19800,-1600,1000,0,16400
10690,-3000,3800,-8900,1000,11050,3950
10691,-700,-2700,100,5200,0,1900
10692,12000,-9200,2400,10500,1950,17650
10693,100,7300,10200,-11000,-950,5650
10694,-3000,1200,1200,100,2900,2400
10695,-6600,-6000,-10900,12200,0,-11300
10696,12200,-5500,4800,7200,0,18700
10697,-2900,4100,9500,-9000,0,1700
10698,-2900,15900,-7900,11400,-1200,15300
10699,-2800,-5200,300,11000,0,3300
10700,11200,900,3900,-12000,0,4000
10701,100,3600,4000,21200,-10200,18700
10702,-5600,-2500,2000,-2600,-1200,-9900
10703,100,1000,1100,0,0,2200
10704,-2800,3700,5000,0,11050,16950
10705,11200,-8400,3000,10200,0,16000
10706,100,3700,1000,-1700,750,3850
10707,-3900,-9100,14100,2200,-1200,2100
10708,1000,-1200,3900,300,750,4750
10709,-2800,6500,800,-11800,0,-7300
10710,-3800,-6200,1100,15200,-2150,4150
10711,12000,7200,-6200,-2600,-2150,8250
10712,0,-800,0,8100,1950,9250
10713,-3000,9400,9300,100,1950,17750
10714,-3600,7300,100,-11000,-950,-8150
10715,-2800,-3600,4700,7300,2900,8500
10716,10400,200,-5000,-4700,1950,2850
10717,2000,9300,-1700,20200,-10200,19600
10718,100,-13800,4600,-800,0,-9900
10719,0,3900,1200,-1800,12000,15300
10720,-3700,-9100,300,2000,0,-10500
10721,-4700,4600,3800,0,0,3700
10722,-4500,3900,0,-9800,0,-10400
10723,10300,-8900,-1800,14000,0,13600
10724,0,-8400,3000,-1600,-1200,-8200
10725,-2800,3700,-8200,11400,-1200,2900
10726,-3700,5600,1700,1200,0,4800
10727,9000,1100,14100,3200,-2150,25250
10728,300,1600,-8200,11000,-950,3750
10729,-3000,-8900,13200,-900,1950,2350
10730,11400,1700,2000,-3500,-450,11150
10731,-5600,3600,6700,-11000,-950,-7250
10732,-3800,9300,-9000,7300,2900,6700
10733,9200,0,-1000,-2900,1000,6300
10734,-2800,9300,100,-2000,-950,3650
10735,-6500,9400,200,24700,-9700,18100
10736,9000,-5500,2000,-2900,1950,4550
10737,5700,9200,5800,12200,9850,42750
10738,-3000,-800,0,0,0,-3800
10739,0,10100,-1800,-4900,1950,5350
10740,0,-5500,13700,-800,-950,6450
10741,-2800,-2800,1700,8300,2900,7300
10742,-3800,9300,-12100,2200,0,-4400
10743,12100,100,-800,4200,0,15600
10744,-3900,-8200,15900,14000,0,17800
10745,1000,-2600,-800,-600,-2400,-5400
10746,0,800,4800,-12000,0,-6400
10747,0,-600,-3000,200,-950,-4350
10748,-3800,-5600,1900,13000,-950,4550
10749,200,-700,-2700,-4900,2900,-5200
10750,10400,19300,1800,-4500,750,27750
10751,-800,200,-2600,-3000,0,-6200
10752,-3900,-8300,6700,9200,0,3700
10753,-1800,3800,1100,-11000,-950,-8850
10754,11200,-700,1000,8200,-950,18750
10755,-2900,7300,-900,2100,2900,8500
10756,-800,-2600,-1700,-4000,-950,-10050
10757,1100,-8800,1100,6100,2900,2400
10758,0,4500,1800,-12600,0,-6300
10759,0,-9300,-8200,23200,0,5700
10760,-900,2900,3900,-1000,0,4900
10761,-2000,10200,12100,-800,0,19500
10762,-3900,6500,100,-8800,-1200,-7300
10763,200,-2500,-700,7400,-1200,3200
10764,9100,6500,0,-8000,0,7600
10765,-2700,-8600,2600,13200,-950,3550
10766,100,-5500,2000,10000,0,6600
10767,-8400,3700,3900,-10900,1950,-9750
10768,11200,-6300,-2900,13200,0,15200
10769,-2800,7200,2900,-13900,1950,-4650
10770,8400,6500,900,1200,0,17000
10771,-3000,-600,-2700,1000,0,-5300
10772,-9200,7200,6700,0,0,4700
10773,8300,200,-4900,3400,-1200,5800
10774,9200,-5600,0,14000,0,17600
10775,100,-9000,1800,-1800,0,-8900
10776,-3700,1500,3900,5000,0,6700
10777,-1800,3700,-8100,12000,0,5800
10778,8600,-600,-800,-3000,0,4200
10779,-2800,4500,15900,0,0,17600
10780,-3700,9200,-2800,-6800,-1200,-5300
10781,9000,-5500,3800,13000,0,20300
10782,-2700,-3500,1000,-1000,-950,-7150
10783,-4600,-2500,-1700,13000,0,4200
10784,10200,6400,-2200,-500,750,14650
10785,100,3700,2900,-13000,-950,-7250
10786,-2700,-8200,3000,-1500,500,-8900
10787,-2700,6500,100,-2000,0,1900
10788,8200,-9100,4800,4400,-3350,4950
10789,-3000,-5600,2900,14000,-950,7350
10790,0,11400,-1800,-3900,1950,7650
10791,-4700,-3300,-1700,11100,1950,3350
10792,10400,19200,1900,-14000,-950,16550
10793,200,-2700,-900,-3700,1700,-5400
10794,-3700,6600,-1000,-1700,1950,2150
10795,200,-8300,5700,-6800,-950,-10150
10796,-2800,-6300,100,15000,0,6000
10797,6200,-2700,2900,-2900,1950,5450
10798,-3500,-3400,1100,10000,-950,3250
10799,9100,6600,100,11100,2900,29800
10800,-800,-3500,-3900,-800,0,-9000
10801,-1700,16600,800,-12800,0,2900
10802,-900,800,4800,-11600,-2400,-9300
10803,1000,-3500,-800,9000,0,5700
10804,-3700,7300,-5300,-2600,0,-4300
10805,9100,9200,1900,-1800,-950,17450
10806,-3800,200,10200,12000,-950,17650
10807,1000,300,-3600,-4700,1700,-5300
10808,-2600,-2600,-900,8100,1950,3950
10809,7400,-11100,4800,-1000,0,100
10810,1100,7100,-6200,-1600,-1200,-800
10811,-6600,4000,-8800,3000,0,-8400
10812,6300,-5500,3000,11000,-950,13850
10813,100,3600,3600,-4600,0,2700
10814,-7500,-6300,14700,300,1950,3150
10815,7200,-5000,-600,11000,-950,11650
10816,-800,4000,300,-17700,2900,-11300
10817,6200,9400,1100,14200,-1200,29700
10818,-4500,3800,3000,-14000,0,-11700
10819,10000,-5200,300,12400,-1200,16300
10820,0,800,2100,200,0,3100
10821,-5800,-3300,2100,-1800,-950,-9750
10822,-800,4800,-700,1000,0,4300
10823,6200,-6300,3900,-700,750,3850
10824,-6400,-6400,2900,12000,0,2100
10825,9200,19300,1100,-13700,750,16650
10826,100,900,1100,2400,-1200,3300
10827,-700,-3500,1000,5200,0,2000
10828,-2800,4600,2000,-11800,-950,-8950
10829,12000,3600,2000,1200,-2150,16650
10830,-1800,-6400,4800,-7700,1950,-9150
10831,-900,1700,2800,100,1950,5650
10832,-2800,3600,200,-9000,0,-8000
10833,0,-6200,200,5100,1950,1050
10834,-3700,4600,1000,2100,1950,5950
10835,12100,-9200,2600,-800,0,4700
10836,-2700,-6300,2900,9000,0,2900
10837,-2900,16400,1000,-9000,0,5500
10838,-6400,9200,-7400,11200,0,6600
10839,12100,-700,-900,-1800,-1200,7500
10840,100,7100,9000,4200,0,20400
10841,-2700,-2600,1100,-3800,0,-8000
10842,-4500,-5800,5700,11200,0,6600
10843,13000,-700,-900,-3000,0,8400
10844,100,7200,-900,1000,0,7400
10845,-3800,400,-1700,9200,0,4100
10846,-4800,6500,2000,-10000,0,-6300
10847,8500,-8300,-100,12400,-1200,11300
10848,100,-2700,-100,-3400,-1200,-7300
10849,-3800,-9100,2900,14000,0,4000
10850,1000,-1700,-6000,-3000,-950,-10650
10851,-2800,12200,-2600,9000,-950,14850
10852,5500,-6400,14600,1300,2900,17900
10853,-5800,-6300,6700,8300,1950,4850
10854,-800,22100,-2700,-12000,0,6600
10855,9100,4000,-2000,4200,0,15300
10856,-9200,-700,0,12000,0,2100
10857,9400,-2700,3900,-5600,-1200,3800
10858,-3600,-5400,-800,13000,0,3200
10859,8200,6700,-2000,2400,-2150,13150
10860,1000,-8800,-700,11200,-1200,1500
10861,-6400,-3600,4800,-3900,1950,-7150
10862,5300,-8200,4900,13400,-4300,11100
10863,-5400,21400,1100,-16900,2900,3100
10864,9300,-3500,200,7100,1950,15050
10865,11300,16600,2900,-5600,-11150,14050
10866,-900,800,-3300,3300,1950,1850
10867,1200,200,-3800,7100,1950,6650
10868,-2700,3800,-2900,-7800,12000,2400
10869,-3700,-2600,12200,6100,1950,13950
10870,1000,-5500,100,0,0,-4400
10871,-3000,-12000,6700,11200,-1200,1700
10872,8400,900,-5100,200,-1200,3200
10873,-3900,6500,2900,1000,0,6500
10874,1000,9300,-900,200,-2150,7450
10875,-5500,-700,13000,7200,-2150,11850
10876,11200,7300,-3200,-11500,2900,6700
10877,-5800,-2700,2900,10300,-200,4500
10878,-3500,3600,3600,-3600,-10200,-10100
10879,12100,100,-3100,7300,1950,18350
10880,0,-600,-3900,-800,11050,5750
10881,0,1700,3900,-4900,2900,3600
10882,-3000,-8300,3000,4200,-1200,-5300
10883,0,3800,2000,1000,0,6800
10884,0,-700,-5100,-1600,-950,-8350
10885,-3800,1700,3000,3000,-950,2950
10886,9200,1000,3900,-12900,2900,4100
10887,-700,-3500,-4900,6300,1950,-850
10888,-1600,1900,5800,-15800,0,-9700
10889,-3900,3600,-8000,13000,0,4700
10890,11300,-3500,2600,-5600,0,4800
10891,-2000,7200,1000,4000,0,10200
10892,-900,700,4000,13000,0,16800
10893,1000,-2600,100,-2800,-1200,-5500
10894,0,6400,8400,4000,0,18800
10895,-3000,-11100,6700,2000,0,-5400
10896,100,9300,-1800,-4000,0,3600
10897,-3600,-3300,-2500,2800,-1200,-7800
10898,12000,-2700,-800,9000,0,17500
10899,200,6600,-3200,-1600,-950,1050
10900,-2700,6400,3800,-2800,0,4700
10901,-3000,9700,-14600,5700,1950,-250
10902,100,-11300,5700,-3600,-2150,-11250
10903,0,-8400,15900,7100,2900,17500
10904,-3800,-1700,4900,-8000,0,-8600
10905,11100,3700,-11000,11200,0,15000
10906,1000,-8200,5800,-4800,0,-6200
10907,100,-12100,15900,10200,-1200,12900
10908,0,-3700,-900,1200,-1200,-4600
10909,0,19300,-2000,1200,0,18500
10910,0,-9200,4500,12200,-950,6550
10911,200,9200,-1000,-14800,-2150,-8550
10912,0,3500,800,14500,1700,20500
10913,-3800,6400,0,-12900,1950,-8350
10914,1200,-3300,-12900,18200,-950,2250
10915,-5600,7500,-800,-8000,-950,-7850
10916,8600,700,11800,300,2900,24300
10917,-2700,3700,-7000,-7900,1950,-11950
10918,-2800,-6500,-100,14200,0,4800
10919,8200,1800,13600,-10400,0,13200
10920,-900,900,-6400,10200,0,3800
10921,-2000,-3600,100,13000,0,7500
10922,-2800,1800,-4300,-2800,0,-8100
10923,11300,3900,10300,2400,-2400,25500
10924,0,-6200,200,-1000,0,-7000
10925,-2800,4600,15900,-1000,-950,15750
10926,-2700,6300,200,-9600,-2150,-7950
10927,-2900,-6300,4700,5500,1700,2700
10928,8400,7600,-1900,-500,-200,13400
10929,-3000,9300,-11800,2000,0,-3500
10930,200,-5400,200,5100,1950,2050
10931,100,3700,15000,-14800,-1900,2100
10932,-3800,900,5700,1100,2900,6800
10933,12000,-800,-1800,-4900,1950,6450
10934,0,4800,1100,1000,-950,5950
10935,0,-700,-1800,-3900,2900,-3500
10936,-5700,6500,3900,-2800,0,1900
10937,0,-1800,-1700,10200,-10200,-3500
10938,-900,-9000,3900,11000,0,5000
10939,1300,1700,1900,-14000,12000,2900
10940,-3700,-3400,-800,14000,0,6100
10941,9200,-3300,1200,-3800,0,3300
10942,0,16600,3000,-4800,0,14800
10943,-5800,-2500,-1600,16400,-2400,4100
10944,10500,800,700,-10600,0,1400
10945,1000,-6400,2000,9000,-950,4650
10946,-2900,4400,1900,-8000,0,-4600
10947,200,6500,2800,-6700,1950,4750
10948,-2800,-3600,-1800,0,-950,-9150
10949,0,4500,5700,-5500,1700,6400
10950,-3700,0,-1900,2000,0,-3600
10951,6500,9400,1000,1000,0,17900
10952,-900,-5600,2900,12000,0,8400
10953,1100,-2800,-3700,-1800,-1200,-8400
10954,100,-3500,-1700,8000,0,2900
10955,8400,-5500,3300,0,-2400,3800
10956,-2800,8400,800,11200,-950,16650
10957,-3800,-2600,1000,-800,-950,-7150
10958,1000,-2600,-2300,5700,1950,3750
10959,100,5700,-800,6100,1950,13050
10960,0,-11300,4800,1000,-950,-6450
10961,0,12900,3900,7300,-7300,16800
10962,5400,6500,-8300,300,1950,5850
10963,-3000,-2600,-1700,14000,12000,18700
10964,100,3900,11300,-13000,0,2300
10965,-6600,-9000,5800,14000,0,4200
10966,11200,4500,1000,-12000,0,4700
10967,-2600,-6400,2600,9200,0,2800
10968,-1800,6200,-9900,12000,0,6500
10969,7300,9300,1900,2200,-1200,19500
10970,1200,9400,-4000,200,0,6800
10971,-5500,-2600,12100,0,0,4000
10972,-700,-9200,-700,13000,0,2400
10973,12000,-5500,200,-1000,0,5700
10974,-2800,3700,8500,-1800,0,7600
10975,-2800,5400,2900,1000,0,6500
10976,-900,100,-900,11000,0,9300
10977,1200,21400,-3800,-13000,0,5800
10978,-1800,-5800,-3200,14400,0,3600
10979,2000,-8300,2000,9000,0,4700
10980,-3800,-9000,4600,400,0,-7800
10981,9000,-5400,1100,14000,0,18700
10982,-2700,15900,1100,-12000,0,2300
10983,-3800,3900,-11900,14200,0,2400
10984,7200,-9100,3000,1000,0,2100
10985,1200,1600,5800,10200,-1200,17600
10986,-4700,-6400,5700,0,0,-5400
10987,7400,-500,8300,14000,-950,28250
10988,100,16400,2000,-11000,0,7500
10989,-1600,6200,-2200,-12300,-450,-10350
10990,-2800,-600,1100,5300,1950,4950
10991,11400,1800,2900,-1000,0,15100
10992,-900,-5400,200,200,-2150,-8050
10993,-1700,900,1200,-3000,-950,-3550
10994,0,-3400,-2200,-7100,1700,-11000
10995,-800,-8200,3900,6700,-450,1150
10996,-2000,-9000,800,1400,-2150,-10950
10997,-2600,8600,-1700,9000,0,13300
10998,11200,-11100,5500,-4700,1950,2850
10999,-3000,5800,-1900,14200,-1900,13200
11000,200,-6300,3800,-7500,1700,-8100
11001,-2800,4200,800,1300,1950,5450
11002,-6500,8600,2000,9200,-1900,11400
11003,12100,3900,-8900,-4900,2900,5100
11004,-3000,3900,1200,10100,1950,14150
11005,-6500,1000,15900,-8000,-950,1450
11006,11200,5600,1000,8100,2900,28800
11007,-2900,7500,200,-12800,0,-8000
11008,-2000,4000,-11600,11200,-1200,400
11009,11200,-6300,2400,-4400,0,2900
11010,-900,4300,10300,4400,-2400,15700
11011,-1800,600,400,-5600,0,-6400
11012,0,9200,-10000,11400,-3350,7250
11013,-2800,200,-4100,21400,0,14700
11014,0,-6200,900,-6100,-1400,-12800
11015,-800,9400,9100,-4100,750,14350
11016,-2000,6600,5800,-6600,-950,2850
11017,-3600,-6300,3900,6100,1950,2050
11018,3500,-2800,13400,-1300,750,13550
11019,8200,18600,200,-600,-2150,24250
11020,200,-2500,-2300,-6300,1950,-8950
11021,-6500,-5400,1200,14000,-950,2350
11022,9000,3700,-6100,-5700,1000,1900
11023,100,-5100,-600,5300,2900,2600
11024,-3600,3800,11100,-11900,1950,1350
11025,12100,-9000,200,8200,-2150,9350
11026,-6600,-2500,-700,-900,2900,-7800
11027,-2000,-6200,6700,4500,1950,4950
11028,10300,5600,-100,8400,-1200,23000
11029,-2900,-1100,5700,-7800,-1200,-7300
11030,-5500,5400,4800,13000,0,17700
11031,12300,-6400,2800,-4000,-950,3750
11032,100,19100,-1800,4200,-2150,19450
11033,-6700,6400,3800,-10900,2900,-4500
11034,1100,-700,-1900,5100,1950,5550
11035,-6500,-2700,800,1200,-950,-8150
11036,12200,9300,-4500,12000,-950,28050
11037,-6400,6500,2900,-14900,2900,-9000
11038,-8300,-2600,2000,11300,750,3150
11039,17600,3600,3800,-9000,0,16000
11040,200,-2600,-2800,8000,0,2800
11041,-3600,-3600,1000,-800,0,-7000
11042,6200,4500,6700,200,0,17600
11043,100,100,-900,9200,-1200,7300
11044,-6300,6400,-12000,4200,0,-7700
11045,9000,-5400,200,14200,-2150,15850
11046,200,-9000,14000,-2000,0,3200
11047,-2700,4200,2800,1100,1950,7350
11048,8300,3800,-800,-11900,1950,1350
11049,-700,-3500,-1900,19200,-10200,2900
11050,-1900,-5500,2900,-800,0,-5300
11051,0,-6500,1100,10200,0,4800
11052,-3600,16500,3800,-10800,10800,16700
11053,6400,6500,-7100,12000,0,17800
11054,0,-2600,-800,-1000,-950,-5350
11055,-3400,5600,2000,11000,0,15200
11056,9000,-7300,900,11300,1950,15850
11057,-6600,6600,-9900,1000,-950,-9850
11058,12400,-6000,9100,-9500,2900,8900
11059,-5800,7300,-100,-7600,-1200,-7400
11060,4700,-3400,1900,9600,-1200,11600
11061,1000,4500,3000,-2800,0,5700
11062,-2900,-11200,18600,1000,0,5500
11063,-6600,3600,2700,-7800,-950,-9050
11064,9200,-6300,3800,12000,-950,17750
11065,0,7400,-800,-3700,1700,4600
11066,-6600,3700,3900,-10900,1950,-7950
11067,12100,9200,-11000,11000,0,21300
11068,-900,-2700,100,-1000,0,-4500
11069,1000,-2800,13900,8000,0,20100
11070,-2900,9300,-12800,1000,0,-5400
11071,100,-2700,2000,7400,-1200,5600
11072,0,-8600,2600,2400,-1200,-4800
11073,-900,-700,10200,11000,-950,18650
11074,-5500,7400,-900,-10000,-950,-9950
11075,12100,-6500,1000,9500,1700,17800
11076,100,4500,800,-14700,1950,-7350
11077,-2700,-9400,2600,1200,-950,-9250
11078,-3600,4300,2000,4000,0,6700
11079,9300,-800,900,-3900,1950,7450
11080,-1800,-6500,100,14000,-950,4850
11081,-1000,19400,-900,-900,2900,19500
11082,-6300,-700,1000,-1000,0,-7000
11083,6400,4500,2000,3000,0,15900
11084,8300,-2600,-2000,1200,0,4900
11085,-5800,3600,-5200,13000,0,5600
11086,-800,-2600,-3200,400,0,-6200
11087,5300,-6300,3000,14200,-1200,15000
11088,1000,4500,14000,-13000,0,6500
11089,8200,-600,100,-1600,-1200,4900
11090,-3000,-5500,2900,14000,0,8400
11091,0,100,-2700,-2000,-950,-5550
11092,100,18800,-9800,-4800,-950,3350
11093,-3000,-5600,2900,-2700,1700,-6700
11094,-3500,-2800,14600,-4700,1950,5550
11095,9000,6500,100,2000,0,17600
11096,-7300,0,-100,2000,0,-5400
11097,13000,-2800,1000,10000,0,21200
11098,-4800,200,100,-4800,0,-9300
11099,-1000,3800,-1000,4200,0,6000
11100,-5800,-2500,-700,2000,0,-7000
11101,11200,-8400,4800,10000,0,17600
11102,-3900,-3300,-800,2000,0,-6000
11103,1000,3800,200,-10800,-1200,-7000
11104,0,6500,2900,-1800,-1200,6400
11105,0,-6200,1100,11000,-950,4950
11106,-3000,-3600,1000,1000,-950,-5550
11107,8200,22100,1900,-16700,2900,18400
11108,-2800,100,-1100,9300,1950,7450
11109,-5800,-5300,2100,1000,0,-8000
11110,11200,-3300,-1700,9000,0,15200
11111,-2700,4400,3900,-11000,0,-5400
11112,-3000,-6100,1100,13000,0,5000
11113,11200,-5500,1100,-800,-1200,4800
11114,-3700,3600,600,3200,0,3700
11115,-2000,11400,-3900,2400,-2150,5750
11116,-3500,-5700,-3200,14400,-950,1050
11117,9200,12100,2000,-7700,2900,18500
11118,-6600,3600,6400,-9600,-950,-7150
11119,12000,-5600,2900,-4900,2900,7300
11120,-800,6600,-10200,7400,0,3000
11121,-4800,200,-2600,1200,-1200,-7200
11122,-6300,-5400,1900,13200,-1200,2200
11123,11100,-3600,14900,-3800,-950,17650
11124,-4800,-2500,200,12000,0,4900
11125,8500,-6200,2000,-5700,1950,550
11126,200,16600,100,-14900,1950,3950
11127,0,-6400,200,-1800,0,-8000
11128,-3900,-3400,3000,8400,0,4100
11129,-5300,19300,3900,-4000,0,13900
11130,9100,-5300,-1900,2200,0,4100
11131,0,3700,-9800,10200,0,4100
11132,0,-8400,3900,-2000,0,-6500
11133,0,800,1700,4200,0,6700
11134,100,-6500,11200,0,0,4800
11135,-2700,7300,3800,-1600,-1200,5600
11136,-6600,-600,-800,12200,-1200,3000
11137,11200,-8900,200,-1000,0,1500
11138,-1800,16200,2900,2200,-2150,17350
11139,7300,3600,3800,-9700,750,5750
11140,-2000,-700,-900,13000,0,9400
11141,0,-5300,200,-4900,1000,-9000
11142,-4500,9300,100,11000,-950,14950
11143,13000,-6300,2000,-5900,1950,4750
11144,100,-2700,1000,-3900,2900,-2600
11145,-3000,21500,-4500,3000,0,17000
11146,-5800,-8300,6700,0,0,-7400
11147,-600,-400,-6700,10200,0,2500
11148,8100,4400,1100,-9000,0,4600
11149,-2500,-5700,1900,9200,0,2900
11150,-4400,-3500,4700,-5600,-1200,-10000
11151,-7500,-8900,3100,13200,-1200,-1300
11152,20300,16500,1800,-10600,0,28000
11153,1000,3800,2000,-1000,-950,4850
11154,-3900,-6300,2000,200,-2150,-10150
11155,-2000,7300,-12200,10700,1700,5500
11156,-3600,6700,3000,-16500,-200,-10600
11157,9000,-5500,12800,3200,0,19500
11158,-3900,-5300,-700,10100,1950,2150
11159,400,6500,1000,-2800,-1900,3200
11160,9100,1000,-8900,-3900,2900,200
11161,100,-5600,2900,7300,750,5450
11162,-3000,9300,12700,-9600,-950,8450
11163,0,-6400,2900,7100,2900,6500
11164,0,200,-1800,-2000,0,-3600
11165,-7500,12000,1000,25200,-10200,20500
11166,9100,-2400,-3500,-1000,0,2200
11167,1000,-3500,2000,6200,12000,17700
11168,-3700,-5600,4700,-800,0,-5400
11169,12200,6200,-2200,2200,0,18400
11170,-900,3800,-10000,-1800,0,-8900
11171,100,-14700,4000,-1000,0,-11600
11172,-2000,4500,12800,4800,-3600,16500
11173,0,3800,1100,-11000,0,-6100
11174,-6600,6600,-8900,14000,-950,4150
11175,12000,-6300,2000,-3800,-1200,2700
11176,0,4400,15800,500,-450,20250
11177,-3000,9300,-900,-7800,-3100,-5500
11178,100,-3400,-5500,10300,1700,3200
11179,-5400,7400,-9000,-3900,1000,-9900
11180,-800,-2600,9400,11000,-950,16050
11181,5400,-2700,3800,5300,2900,14700
11182,-1800,-6400,3900,-2700,-200,-7200
11183,8200,-5400,1100,0,-950,2950
11184,-8600,18400,5700,1100,1950,18550
11185,11300,-3600,900,-3900,1950,6650
11186,-2900,10200,-3700,2000,-950,4650
11187,-900,-5500,2700,-6500,2900,-7300
11188,8400,-5200,-2700,11100,1950,13550
11189,-2000,900,-7000,-1800,-2150,-12050
11190,-2800,-3400,200,6100,2900,3000
11191,-3700,7300,3800,-1200,-1200,5000
11192,8300,-9200,2700,12200,0,14000
11193,-4400,7300,10600,-11600,-950,950
11194,-3600,6400,2900,-13000,0,-7300
11195,5700,-5300,100,10100,1950,12550
11196,2500,9400,-7000,-3500,750,2150
11197,-700,-5300,-700,9000,0,2300
11198,13000,-11900,14100,13000,0,28200
11199,-5700,7200,3000,-12800,0,-8300
11200,-3600,-6300,4500,12200,0,6800
11201,12100,-6400,-3000,1200,0,3900
11202,0,12700,1800,400,0,14900
11203,-2800,10100,2000,-14800,0,-5500
11204,-2900,-3500,700,11400,0,5700
11205,-5800,0,1000,1200,-1200,-4800
11206,8400,9500,-1900,21400,-10200,27200
11207,-3700,-6300,2900,0,0,-7100
11208,10200,-1300,2700,3200,11050,25850
11209,-800,-700,-2100,-600,-2150,-6350
11210,300,-2600,-2600,4100,2900,2100
11211,-900,5700,3400,-8100,1950,2050
11212,1200,-2600,0,-4800,0,-6200
11213,-2700,800,1000,-9800,-1200,-11900
11214,-2900,2900,3800,11200,-1200,13800
11215,-1700,2100,-600,400,-12350,-12150
11216,10100,-6200,2000,-2600,-1200,2100
11217,-800,-5600,800,8300,13950,16650
11218,1000,15600,3600,-3600,-950,15650
11219,100,700,-8000,-1900,1950,-7150
11220,0,-3500,100,8100,1950,6650
11221,-700,-2800,14700,-7800,-950,2450
11222,-4700,6500,-1100,2300,2900,5900
11223,8200,8400,4800,-5600,0,15800
11224,0,7200,700,1200,0,9100
11225,-900,-3600,-1800,0,0,-6300
11226,1000,10200,-4600,12600,-12600,6600
11227,0,-8300,600,-600,0,-8300
11228,-2700,-5500,2700,10200,11050,15750
11229,-2900,-9000,2900,0,0,-9000
11230,11300,800,-5200,6100,1950,14950
11231,-3000,9400,-2900,2200,-950,4750
11232,0,9500,2100,-11300,2900,3200
11233,-2800,-6300,15000,-1000,0,4900
11234,-3700,7500,-1800,2000,0,4000
11235,9100,3800,200,-7800,-1200,4100
11236,100,-2500,-1700,7200,0,3100
11237,100,-9100,3900,-4800,-2150,-12050
11238,-3000,-9000,3900,12100,1950,5950
11239,-2900,16800,-1600,3000,-950,14350
11240,-800,6500,-7100,-6700,2900,-5200
11241,9200,-3100,300,7400,-1200,12600
11242,-2800,7500,1100,-600,-1200,4000
11243,-9400,-2500,4000,8400,-1200,-700
11244,8400,700,3800,2400,-2150,13150
11245,6500,-2800,4800,10000,-950,17550
11246,-9400,-3400,3000,-1900,1950,-9750
11247,9000,8400,9700,11500,1950,40550
11248,11200,4600,-400,-12300,750,3850
11249,-3000,-5500,-8200,23200,0,6500
11250,0,-6200,1100,6100,1000,2000
11251,-3600,-2700,12100,1200,-1200,5800
11252,1100,1200,1200,-17700,750,-13450
11253,-2700,5700,3900,-2000,-950,3950
11254,-6400,4500,700,1300,2900,3000
11255,9200,-3800,-800,13200,-2150,15650
11256,5400,6500,-4300,-1600,-2150,3850
11257,0,12200,-1800,8300,1700,20400
11258,-7500,200,-2000,-2700,1000,-11000
11259,13000,-8600,11800,15200,0,31400
11260,100,-6200,-800,-4700,750,-10850
11261,100,-8500,3800,-800,-950,-6350
11262,100,3600,-5200,4300,1950,4750
11263,-900,5900,200,-2000,0,3200
11264,-2900,-2800,11100,-900,1950,6450
11265,1000,15800,1900,0,-950,17750
11266,200,-9200,-800,-1900,2900,-8800
11267,0,4800,-1600,11200,-10200,4200
11268,-2900,-9200,4800,-1000,0,-8300
11269,-3500,-3100,-2500,11000,12000,13900
11270,8300,13600,6700,-12000,0,16600
11271,-3800,900,-6400,200,0,-9100
11272,1200,-3500,-800,8000,0,4900
11273,12000,4300,11800,-5800,0,22300
11274,-2800,-6200,-900,13200,-1200,2100
11275,0,-3600,1700,-3600,0,-5500
11276,-3000,16400,2900,5000,0,21300
11277,0,3400,3800,200,0,7400
11278,100,-800,-2200,-800,0,-3700
11279,-3700,400,-4500,14000,0,6200
11280,9100,12900,1800,-9800,0,14000
11281,-2800,-5500,3000,-1000,0,-6300
11282,-3800,3600,4700,4000,0,8500
11283,9000,-700,-900,2000,0,9400
11284,400,7500,-2700,-2000,0,3200
11285,-3800,-2600,-800,-800,0,-8000
11286,-2500,-5700,100,13000,0,4900
11287,12000,-6300,4800,-4800,0,5700
11288,2600,-600,-700,2000,0,3300
11289,-5800,19300,4800,1200,0,19500
11290,0,-5400,800,-800,0,-5400
11291,0,-6400,2000,11000,0,6600
11292,-3000,10100,1900,-12600,-1200,-4800
11293,-700,9400,-3700,1200,-1200,5000
11294,9200,-5400,-700,2000,-950,4150
11295,-5800,-5300,2100,14000,0,5000
11296,-700,-9200,3900,-4900,1950,-8950
11297,12100,-5600,2800,11000,0,20300
11298,-2800,-700,100,-5900,1950,-7350
11299,-3700,19400,-2000,-8800,0,4900
11300,100,3800,1100,-2800,-1200,1000
11301,100,-5300,-1000,1800,-3600,-8000
11302,-3700,-6200,900,10400,0,1400
11303,13000,-8500,100,2000,-950,5650
11304,0,10200,5800,-1000,-950,14050
11305,-2800,-6200,-1600,300,750,-9550
11306,100,-11400,3800,11100,1950,5550
11307,-5500,15800,3900,-11000,-1900,1300
11308,8200,-6000,-1600,11100,2900,14600
11309,-700,-5700,1000,7300,1950,3850
11310,1000,6400,1700,-16600,-950,-8450
11311,-3900,6100,-900,-4500,2900,-300
11312,-4800,4400,4800,-900,1950,5450
11313,11200,6600,-10800,11000,0,18000
11314,-2700,-2700,-800,8200,-10200,-8200
11315,-6500,6600,14000,1200,0,15300
11316,12000,1000,-4200,-3800,0,5000
11317,-2800,-2700,-2100,12200,12000,16600
11318,-3000,-9000,12900,12400,-10200,3100
11319,11200,3600,-8300,10400,-1200,15700
11320,0,2700,1100,3000,12000,18800
11321,100,-5600,14500,-600,-1200,7200
11322,200,6600,-900,-13800,0,-7900
11323,-5800,11500,-1700,2000,0,6000
11324,-2800,-8200,-800,14000,-950,1250
11325,8400,1000,4900,-12000,-950,1350
11326,-800,300,-700,-900,2900,800
11327,1100,-1100,-7900,12000,-950,3150
11328,0,6600,-2600,-15900,2900,-9000
11329,-5800,-9200,19600,2000,0,6600
11330,8200,7300,-800,4000,0,18700
11331,0,900,-4200,8200,0,4900
11332,0,-5600,3800,-1000,0,-2800
11333,-2800,9500,7300,2000,0,16000
11334,-7100,-600,-1800,-3000,0,-12500
11335,13000,1400,500,4400,0,19300
11336,100,900,2900,-14000,0,-10100
11337,0,-6400,1100,11200,-1200,4700
11338,-2900,1000,2100,-6600,-2400,-8800
11339,100,-1200,3900,2000,0,4800
11340,100,-6400,2800,-1000,-950,-5450
11341,-3800,-2500,-800,15000,0,7900
11342,6200,18600,1100,-11900,1950,15950
11343,-900,6500,-12600,8100,1950,3050
11344,-5600,-400,3000,-3400,-1200,-7600
11345,2900,10300,4100,7000,0,24300
11346,9200,3900,900,400,-11150,3250
11347,-4500,6600,-9800,11000,0,3300
11348,4400,-2700,13800,-2700,13950,26750
11349,-3500,3800,-8200,10200,0,2300
11350,9200,3800,2100,-1900,1950,15150
11351,-2800,-2600,2100,8200,0,4900
11352,-6600,-6400,16800,1000,0,4800
11353,12000,-5600,3800,-2000,0,8200
11354,-4800,21600,-3400,15200,-1200,27400
11355,1200,-8100,200,-3000,0,-9700
11356,12000,-2700,14000,-3800,0,19500
11357,-2900,3800,-6200,-1800,0,-7100
11358,-2700,-700,-12000,9200,0,-6200
11359,-6400,-5500,16800,-3000,0,1900
11360,11200,-5500,-200,-600,-1200,3700
11361,1000,15600,8900,-11200,-1200,13100
11362,-2800,-9100,2900,0,-950,-9950
11363,-800,-5600,1000,12000,0,6600
11364,-2600,6700,2100,-17700,1950,-9550
11365,8100,5600,2900,0,-950,15650
11366,1200,4800,200,-4700,1700,3200
11367,-3900,-9100,3900,1000,0,-8100
11368,1100,-3600,-300,8200,-950,4450
11369,-3800,19300,-1100,6200,0,20600
11370,8100,3900,200,-10900,1950,3250
11371,1100,-5400,-1700,9000,-950,2050
11372,-2900,6400,4500,-17300,2900,-6400
11373,-9400,-3500,2700,15200,0,5000
11374,9300,10000,2900,-16800,0,5400
11375,8400,-2600,-2600,13200,-1200,15200
11376,-5800,100,800,1400,0,-3500
11377,11300,-8300,-1700,13200,-1200,13300
11378,0,-8900,1200,11000,0,3300
11379,-2700,4500,4800,-12000,-950,-6350
11380,100,6700,-12900,5400,0,-700
11381,0,-11200,4300,-1300,750,-7450
11382,-2800,600,6800,14000,-950,17650
11383,0,-5900,-11800,5300,2900,-9500
11384,200,7400,9300,-1800,0,15100
11385,-800,900,-6400,-800,0,-7100
11386,1100,-9200,-3900,13200,0,1200
11387,-2800,1800,16900,-9800,-1200,4900
11388,-3600,6500,4800,-1800,0,5900
11389,12100,-3400,8400,10000,-950,26150
11390,-5800,-5300,3000,13200,-10200,-5100
11391,-4500,-6400,5800,6300,1950,3150
11392,13100,8900,-5600,-2800,12000,25600
11393,-2700,-2600,2800,-9300,1950,-9850
11394,-3400,-6300,2800,-1000,0,-7900
11395,9200,16500,3000,200,-1200,27700
11396,-2800,6700,-11900,10400,-10200,-7800
11397,0,3000,3000,10000,0,16000
11398,-900,1700,4800,-9800,10800,6600
11399,1000,6500,13100,-2800,0,17800
11400,-3800,-6100,-100,3200,-950,-7750
11401,5300,-2800,4800,9200,0,16500
11402,1100,6500,-1200,-12700,1950,-4350
11403,0,18500,-8000,6300,1950,18750
11404,-3700,-2700,2000,-1000,0,-5400
11405,-2600,6500,14000,0,0,17900
11406,7300,-800,-1000,2000,0,7500
11407,2100,200,-3700,7000,0,5600
11408,-3700,-8300,2700,2400,-1200,-8100
11409,9200,9200,2900,11200,-1200,31300
11410,0,6500,1000,-10600,-2400,-5500
11411,-2800,100,100,200,-1200,-3600
11412,100,-2700,1000,10000,-950,7450
11413,-5800,-500,200,-1600,-1200,-8900
11414,-4500,-2600,200,-4900,1950,-9850
11415,9200,-5600,-6400,12400,-3100,6500
11416,9100,12100,-1900,-3900,2900,18300
11417,-2700,-3500,2000,-2700,-200,-7100
11418,0,-2900,10200,2000,-950,8350
11419,0,9200,3800,-8700,1950,6250
11420,0,9200,-11200,-2700,1950,-2750
11421,0,-2600,-5700,12200,-950,2950
11422,-6500,-5500,3900,-4700,2900,-9900
11423,12000,-5500,12200,7100,1950,27750
11424,-900,-5000,8500,-7800,-1200,-6400
11425,1100,-500,-3700,-5900,1950,-7050
11426,-3000,4500,800,4200,0,6500
11427,-3900,3700,1100,-7800,-1200,-8100
11428,5700,-3500,1800,10200,0,14200
11429,1100,7400,-800,-12000,-950,-5250
11430,300,3900,-900,-1000,-950,1350
11431,0,-6200,200,5300,-7300,-8000
11432,-3600,1800,-200,2300,1950,2250
11433,12000,3900,-10600,-2800,12000,14500
11434,-5800,-5300,-7200,23200,0,4900
11435,0,900,4700,-2600,-1200,1800
11436,-3400,-6500,-1200,15200,0,4100
11437,9100,-8200,-100,2200,0,3000
11438,-2800,3700,13800,1200,0,15900
11439,-3500,11300,1100,-3600,-1200,4100
11440,11100,-1100,20600,-800,0,29800
11441,1000,3700,2000,-12000,0,-5300
11442,0,-6300,4800,7200,-950,4750
11443,0,300,-3600,10300,750,7750
11444,-3000,3600,-7100,2200,-1200,-5500
11445,-2800,8500,2900,7100,1950,17650
11446,-800,0,12000,8200,-10200,9200
11447,1200,9400,-5700,-8600,-3350,-7050
11448,200,6700,-800,-1000,11050,16150
11449,0,-11100,5800,9100,1950,5750
11450,0,-6300,1100,-5900,1950,-9150
11451,-800,7200,2900,-15800,-950,-7450
11452,1000,3800,2000,-1900,2900,7800
11453,-3000,-3500,100,-2900,1950,-7350
11454,-3400,100,0,9000,0,5700
11455,5400,21300,-1800,-7800,-1200,15900
11456,6400,-5400,2700,14200,0,17900
11457,0,-5400,200,9000,0,3800
11458,-6500,-4300,-2000,5600,-2400,-9600
11459,9200,2700,1000,2000,0,14900
11460,-2700,-8800,2200,-1000,-950,-11250
11461,-3800,4400,2000,4200,-1200,5600
11462,9200,4100,1300,-18500,750,-3150
11463,-6500,-3200,-1000,14200,-950,2550
11464,9300,4600,1100,-15900,1950,1050
11465,200,-6400,1900,8400,-2150,1950
11466,100,-9000,1800,-7500,2900,-11700
11467,100,13600,4800,-3900,1000,15600
11468,-3700,1100,-7900,0,0,-10500
11469,6500,-6200,800,10300,1950,13350
11470,-5800,7500,11000,-7800,-950,3950
11471,9400,-6400,2900,7100,2900,15900
11472,-1000,1100,-1000,3400,-1200,1300
11473,-3500,10000,2000,-17600,0,-9100
11474,9000,-9100,4800,14200,-1200,17700
11475,-5800,-5500,3900,1000,0,-6400
11476,-3500,6500,1900,0,-950,3950
11477,6200,8500,2000,2000,0,18700
11478,-800,100,-2100,7300,1950,6450
11479,12000,3800,1100,-13900,1950,4950
11480,-2800,9200,2900,12000,0,21300
11481,-3900,9400,-22000,21400,-1200,3700
11482,-1700,300,-4700,-1400,-2400,-9900
11483,4500,-5500,17800,12200,0,29000
11484,-1800,-6200,1900,-1800,-950,-8850
11485,-800,-2500,11300,8400,-1200,15200
11486,12100,-6300,1000,-3900,1950,4850
11487,-2700,5700,2900,11200,-2150,14950
11488,-3000,-5400,1100,-900,1950,-6250
11489,-3800,-3400,200,11200,-950,3250
11490,9200,19300,2000,-12900,2900,20500
11491,0,-3500,1700,6500,1950,6650
11492,-2600,16500,2900,-13000,0,3800
11493,-2700,0,0,12000,0,9300
11494,11200,6400,1900,-11000,0,8500
11495,100,100,-1900,11200,-1200,8300
11496,0,-5500,2000,11000,0,7500
11497,-3000,-2500,-1700,2000,-950,-6150
11498,0,3700,2000,-2000,0,3700
11499,-6400,-5500,2900,-1500,-450,-10950
11500,9300,-6100,-2900,2200,-950,1550
11501,-3900,-6200,1100,8100,2900,2000
11502,1000,11000,2500,-11600,-950,1950
11503,-2500,-6300,-800,8300,-8250,-9550
11504,8300,-6400,1000,13000,0,15900
11505,-2800,7600,-2500,-14900,1950,-10650
11506,-3800,13000,3900,-5800,10800,18100
11507,9000,-6300,2000,12000,0,16700
11508,-6400,100,-1000,-800,0,-8100
11509,12100,-9000,5700,8400,-1200,16000
11510,0,3000,2100,-2800,-1200,1100
11511,-3600,6500,-9200,-600,-1200,-8100
11512,-1900,3700,14900,13000,-950,28750
11513,0,-9400,1700,-1800,-950,-10450
11514,100,9200,-300,-1500,750,8250
11515,-3600,6500,2000,-12900,1950,-6050
11516,12000,5600,2900,-3000,-950,16550
11517,0,10100,-900,-2900,2900,9200
11518,100,6600,-14600,-1700,750,-8850
11519,0,-2800,-2000,11200,0,6400
11520,-1800,-8200,15000,-2000,0,3000
11521,-3600,3600,3700,13200,-11150,5750
11522,0,-6300,800,-800,-950,-7250
11523,-3600,10300,-2600,-900,14900,18100
11524,12100,3700,1000,-2900,1950,15850
11525,-2800,-3500,4800,-4800,0,-6300
11526,-5800,4600,3000,3000,0,4800
11527,-3800,-2700,-100,400,0,-6200
11528,12000,-6300,2900,10000,0,18600
11529,100,12100,-2700,-1800,-1200,6500
11530,0,800,2900,6200,-1200,8700
11531,-2800,-3600,2900,-800,-1200,-5500
11532,0,10000,0,0,-950,9050
11533,-800,300,-2700,6200,-10200,-7200
11534,-5600,200,-1000,9500,1950,5050
11535,6400,500,-600,7800,7450,21550
11536,8400,-5500,3900,-4900,2900,4800
11537,-2800,-2500,200,-1000,-950,-7050
11538,-3600,6700,-2500,-12000,0,-11400
11539,12000,-5500,3900,1300,1000,12700
11540,-2800,3700,6700,-11400,-2400,-6200
11541,-3000,-2600,1000,10100,1950,7450
11542,0,6400,-9200,7300,1950,6450
11543,-3800,-2600,100,2000,-1900,-6200
11544,9000,-3300,8500,9300,1700,25200
11545,0,4600,3900,-18700,1950,-8250
11546,-9500,-2600,3000,15200,-1200,4900
11547,200,-500,-2700,-7700,1950,-8750
11548,9000,-8300,3900,14000,-950,17650
11549,-6700,5600,4800,14200,-2150,15750
11550,12400,-2500,-5600,-2900,2900,4300
11551,-3900,3800,1100,1300,750,3050
11552,-2600,9200,2000,-3000,0,5600
11553,9200,3900,3900,1200,-1200,17000
11554,-900,-3500,-1100,1200,-950,-5250
11555,200,4800,-3500,1000,-950,1550
11556,1100,-10900,3900,-3700,1700,-7900
11557,100,3700,1000,-1900,1950,4850
11558,-900,3700,-9800,-2000,0,-9000
11559,-1800,-8300,7700,7200,-950,3850
11560,-900,6700,-3500,-11000,-950,-9650
11561,-4600,-6400,22400,2300,2900,16600
11562,8300,10200,-14200,500,1950,6750
11563,-6600,6500,2000,4000,0,5900
11564,12000,-2800,1000,5000,0,15200
11565,-3000,6500,13000,-4600,-2400,9500
11566,-3000,-5400,1100,14200,-1200,5700
11567,11200,-2600,-800,-1800,-2150,3850
11568,-3900,900,3900,4000,0,4900
11569,-4700,-600,-2000,-2700,1000,-9000
11570,-700,4400,-1100,2400,-2150,2850
11571,6300,-3600,5600,9300,2900,20500
11572,-800,10100,-900,-15900,1950,-5550
11573,1000,-2800,-1100,9200,-950,5350
11574,0,0,-7400,4500,2900,0
11575,0,9300,-900,-2000,0,6400
11576,100,100,9300,-1000,0,8500
11577,-2900,-5400,1900,14000,0,7600
11578,8300,-2700,-900,13000,0,17700
11579,0,-8100,1200,-2000,0,-8900
11580,-2900,900,3900,3000,0,4900
11581,-2700,-3400,-2900,-1800,0,-10800
11582,8400,1600,5800,2400,-1200,17000
11583,0,6200,100,-12600,-1200,-7500
11584,-2700,6700,1000,-1000,0,4000
11585,-6500,-2600,100,13200,-11150,-6950
11586,12100,3900,-11700,10000,-950,13350
11587,0,-5500,2000,-4900,14900,6500
11588,-5800,-600,15000,6500,1950,17050
11589,11300,4500,2000,-14800,0,3000
11590,0,-5400,1100,10000,0,5700
11591,0,-9400,2900,1000,0,-5500
11592,0,-6200,2000,10000,0,5800
11593,-3000,12000,-900,1000,0,9100
11594,-2900,3800,100,4000,0,5000
11595,-2700,8400,3800,-2000,0,7500
11596,11300,10300,-2700,1000,0,19900
11597,-2900,-5600,2900,0,0,-5600
11598,-900,100,-800,7200,0,5600
11599,-2000,-3600,2800,2000,0,-800
11600,-3000,100,-1800,1000,0,-3700
11601,-2600,9300,2900,-4800,0,4800
11602,11100,-700,-2800,13200,-1200,19600
11603,0,-5500,2000,-2000,0,-5500
11604,-3000,6400,3800,2000,-950,8250
11605,-3000,-800,0,2200,-1200,-2800
11606,11200,100,-900,-4900,1950,7450
11607,0,100,-3000,400,-2150,-4650
11608,-5700,9300,1900,-1900,2900,6500
11609,0,-2800,1000,9200,-11150,-3750
11610,0,-2700,1000,-2000,0,-3700
11611,-9300,-600,-100,-700,13950,3250
11612,9000,7300,-800,-11900,1950,5550
11613,-1700,-5500,-8200,20200,0,4800
11614,10100,-6200,0,2000,0,5900
11615,-900,-5600,800,200,0,-5500
11616,-2900,15700,11800,-7800,0,16800
11617,1000,-6000,-3100,-1600,0,-9700
11618,-9400,10100,3900,2200,0,6800
11619,8400,3800,2100,-10000,0,4300
11620,12100,-5600,100,12000,0,18600
11621,0,-6400,7500,-2800,0,-1700
11622,0,10200,-2700,1000,0,8500
11623,100,3700,2900,-12000,0,-5300
11624,0,-2600,-1700,10000,0,5700
11625,300,-8300,400,12400,0,4800
11626,-2700,6600,200,-13000,0,-8900
11627,0,-8800,300,11000,0,2500
11628,0,1800,2100,-11000,0,-7100
11629,0,900,4800,-1000,0,4700
11630,-2800,9300,-1700,-8800,-1200,-5200
11631,0,100,4700,4400,0,9200
11632,-700,-6200,-3300,-1600,0,-11800
11633,-2700,-2600,-3600,14000,0,5100
11634,12000,13100,4900,-14800,0,15200
11635,-2700,-6300,1700,11400,-1200,2900
11636,-3700,4500,1100,-10000,0,-8100
11637,-8400,-3500,3000,13000,-950,3150
11638,11100,-5400,1100,-2000,0,4800
11639,-4300,15600,-8200,8300,1950,13350
11640,-3500,-600,100,-2800,-950,-7750
11641,5400,7600,10400,1100,2900,27400
11642,12100,-11400,3800,0,0,4500
11643,-3700,3800,2100,-1000,0,1200
11644,1100,-14700,2500,1400,0,-9700
11645,100,4500,100,1200,-1200,4700
11646,-6600,-6300,3000,3000,0,-6900
11647,9000,-6100,1100,13000,0,17000
11648,-900,4500,-2600,-7800,-1200,-8000
11649,1200,15900,3000,-6600,0,13500
11650,-3000,-6100,200,3200,-2150,-7850
11651,11300,-1200,5800,-2000,0,13900
11652,0,3900,-19100,7300,1950,-5950
11653,-5700,100,-1700,11200,-950,2950
11654,0,-9100,17700,7100,2900,18600
11655,-2800,6600,9300,-9800,-1200,2100
11656,11300,5900,200,10000,0,27400
11657,-3800,1700,4800,-9000,0,-6300
11658,-7600,9300,1000,3000,-950,4750
11659,9600,-3500,-900,-5800,-950,-1550
11660,-1000,300,-1700,6500,1700,5800
11661,-2900,900,2700,-11700,1950,-9050
11662,11200,12800,4800,1000,0,29800
11663,-5800,-2800,2600,14200,0,8200
11664,-2900,9400,-1800,-10000,0,-5300
11665,11200,3700,-100,1200,0,16000
11666,-2900,-8000,1200,0,0,-9700
11667,-2900,-3200,-3500,13000,0,3400
11668,-2700,4600,3000,-12000,0,-7100
11669,8200,3600,2900,4000,0,18700
11670,-3900,-6200,3900,11200,0,5000
11671,1100,-5500,1000,-4000,0,-7400
11672,-4700,15800,-2200,13800,-11400,11300
11673,10200,-3400,-3700,0,12000,15100
11674,-2700,1600,8500,-2800,0,4600
11675,-3600,3800,-800,3400,-3350,-550
11676,9300,-8500,1100,2000,-950,2950
11677,-3000,1000,2400,2500,2900,5800
11678,300,-3500,-2700,-6900,1000,-11800
11679,0,-6300,3000,9200,-950,4950
11680,-3800,-8100,3000,-1900,2900,-7900
11681,12100,15500,-900,-900,1950,27750
11682,200,5900,100,-5800,0,400
11683,-7400,-2700,1800,11200,0,2900
11684,-1500,15800,1800,-13800,0,2300
11685,6200,-3400,200,14000,0,17000
11686,-2800,-2700,3900,8200,0,6600
11687,8400,15700,-3300,-4800,0,16000
11688,0,-3700,-900,15000,0,10400
11689,-2900,7200,10800,-8800,0,6300
11690,-2400,100,-2900,6200,0,1000
11691,2800,-2800,4700,1000,0,5700
11692,-3800,-3600,-800,13000,0,4800
11693,12000,-5200,1800,-6200,-2400,0
11694,-3000,8800,-1600,11200,0,15400
11695,100,4800,-900,-16600,0,-12600
11696,100,-5500,-1100,9200,-950,1750
11697,-3600,-11800,4800,2200,-2150,-10550
11698,5600,-2700,1200,7300,2900,14300
11699,1200,15600,4700,-21500,1950,1950
11700,0,-6300,2000,11200,-1200,5700
11701,-3000,7400,-1700,-8000,0,-5300
11702,11200,1000,3000,-1000,-950,13250
11703,-5800,-6300,3000,15000,0,5900
11704,0,1800,3900,-14900,1950,-7250
11705,0,-6500,-800,13000,-950,4750
11706,-3800,-3500,1000,-1900,2900,-5300
11707,12100,16600,800,-800,0,28700
11708,-900,1100,-2100,-9400,-1200,-12500
11709,-1900,6500,-9900,9400,-1200,2900
11710,100,-5500,200,-4200,0,-9400
11711,-2800,3600,1700,1200,-950,2750
11712,100,-9100,14100,-2000,0,3100
11713,200,-1100,5700,-2900,1950,3850
11714,0,3800,1100,1000,-950,4950
11715,100,-9400,2000,-2900,2900,-7300
11716,0,7200,2800,0,0,10000
11717,100,-700,-900,-3000,0,-4500
11718,-2900,10000,-1000,1000,0,7100
11719,11200,9200,-2100,-10800,0,7500
11720,-2900,-6300,1900,12400,-2400,2700
11721,-2900,10000,-3100,-6800,0,-2800
11722,-3600,3600,3800,0,0,3800
11723,9200,-2600,-1700,200,-2150,2950
11724,0,-2400,-700,8200,-950,4150
11725,-2800,4000,1200,-12900,2900,-7600
11726,-8400,-2700,1000,10100,1950,1950
11727,10400,-8900,800,-1800,0,500
11728,-2700,-6400,1100,12200,-1200,3000
11729,6200,-5400,1200,1000,0,3000
11730,0,18700,7700,-10200,0,16200
11731,0,-8300,-700,15000,-950,5050
11732,-3800,15600,3600,-13400,-2150,-150
11733,12000,-6300,2000,8100,2900,18700
11734,0,4600,2000,-14900,1950,-6350
11735,-2800,6400,-900,3000,0,5700
11736,-2900,6500,-10300,1200,0,-5500
11737,0,-2500,-4700,11200,0,4000
11738,-7500,-2600,3900,-1800,0,-8000
11739,7300,6400,13000,2000,0,28700
11740,-3600,-2600,-1000,1200,0,-6000
11741,6200,-6200,4600,10400,0,15000
11742,11300,1700,2000,-12800,-1200,1000
11743,-3900,-400,-2600,11200,0,4300
11744,1000,4400,2000,-12000,-950,-5550
11745,-5800,-6300,7600,10200,0,5700
11746,-800,7200,100,-4900,1950,3550
11747,9000,-3400,-200,4200,-950,8650
11748,-3900,-2500,-2600,10100,2900,4000
11749,-2600,3800,4900,-3000,0,3100
11750,11100,6400,2900,-800,0,19600
11751,200,-6500,-900,0,0,-7200
11752,1000,-5200,-800,9200,-1200,3000
11753,-3000,6600,-3500,-7000,0,-6900
11754,0,3100,2100,8200,-1200,12200
11755,0,4600,1800,-400,-1200,4800
11756,-2900,900,4800,-10000,-950,-8150
11757,-3700,-2700,-1300,12400,0,4700
11758,300,6500,0,-19500,750,-11950
11759,9000,3700,3900,200,-950,15850
11760,-5800,-2800,4500,-4500,2900,-5700
11761,-6300,9300,1000,-2000,-950,1050
11762,8400,-5600,900,3000,-950,5750
11763,12000,-2900,-2700,11100,2900,20400
11764,-2800,-700,3800,3300,1950,5550
11765,-2600,-5600,-1800,3200,-1200,-8000
11766,-3000,6500,1100,13000,0,17600
11767,10300,3600,4700,-12000,0,6600
11768,-1900,-700,-900,11000,0,7500
11769,200,1500,1000,-8800,-1200,-7300
11770,100,100,-1800,8000,0,6400
11771,0,3700,-8000,200,-1200,-5300
11772,-3000,-5500,-7300,23200,-950,6450
11773,0,9300,-900,-12000,-950,-4550
11774,-3800,300,8400,12100,2900,19900
11775,12000,-2600,-1700,-3900,1950,5750
11776,-900,-3400,5800,1600,0,3100
11777,-2000,-8400,16800,12000,0,18400
11778,-2900,-3300,-3900,3200,0,-6900
11779,0,16600,-1000,-800,0,14800
11780,-2900,-6100,1100,9400,-10200,-8700
11781,-6600,7300,2000,4000,0,6700
11782,12100,-6400,2900,-3600,10800,15800
11783,-4700,-8200,3900,14000,0,5000
11784,10000,18700,-11700,1000,0,18000
11785,0,-3500,-1700,10000,-950,3850
11786,100,1700,15600,-14400,-950,2050
11787,-1800,-3400,-1700,8100,2900,4100
11788,-700,-5500,-9400,4500,1950,-9150
11789,-2800,15600,4800,-1800,-1200,14600
11790,5400,-700,13100,-800,0,17000
11791,0,4700,800,1200,0,6700
11792,-6600,-3400,1100,1000,0,-7900
11793,9200,-2700,1100,9000,0,16600
11794,100,-5400,-1000,-600,-1200,-8100
11795,-2700,100,3000,14000,0,14400
11796,400,-5500,-2800,9000,-950,150
11797,11300,-14600,3000,3400,-2400,700
11798,-2800,5600,3000,7100,1950,14850
11799,0,1700,3000,-10800,-950,-7050
11800,100,15600,-10800,7300,1950,14150
11801,0,-5600,4800,6200,-950,4450
11802,-3700,-3800,3800,-4700,2900,-5500
11803,-1900,-500,6200,10500,750,15050
11804,7500,15600,-7500,-2600,0,13000
11805,-2000,4500,2900,4200,-1200,8400
11806,0,-9300,2000,1200,-1200,-7300
11807,-900,7400,12100,1000,-950,18650
11808,-4700,-3500,100,2000,0,-6100
11809,11200,-6300,2900,7300,750,15850
11810,-2600,18600,-3900,-9800,-950,1350
11811,-2900,4500,-6100,6300,1950,3750
11812,8200,6600,-8000,-1800,0,5000
11813,0,-2500,11300,4300,1950,15050
11814,-5600,3700,1900,-9000,0,-9000
11815,6400,1200,1100,11300,1950,21950
11816,2000,-2800,2000,6200,0,7400
11817,-3000,-12000,19600,2200,-1200,5600
11818,-2900,-700,-1900,13000,0,7500
11819,11200,22100,-1800,-13000,0,18500
11820,0,6600,-12000,13200,0,7800
11821,100,-5800,1900,-1800,0,-5600
11822,-2800,-5300,13800,10200,0,15900
11823,0,3500,-800,-8000,0,-5300
11824,-5800,-2600,200,1000,0,-7200
11825,10300,900,3900,0,0,15100
11826,-2000,-6300,3800,15400,-2400,8500
11827,100,4400,-2700,-8800,-1200,-8200
11828,-800,3800,2000,-1600,-2150,1250
11829,-5500,-3400,1100,1200,-2150,-8750
11830,11200,1800,1800,-3700,1950,13050
11831,1100,6500,-800,-18900,1950,-10150
11832,100,-9200,2700,15900,-8250,1250
11833,-900,-8600,2900,1200,-3100,-8500
11834,1000,5700,2900,7500,12500,29600
11835,-3000,-700,-900,100,1950,-2550
11836,-5600,-2900,2000,13000,-1900,4600
11837,8200,21300,-900,-12900,1950,17650
11838,0,-2600,-2600,8100,2900,5800
11839,-700,600,2500,11300,1950,15650
11840,-1900,-6000,-800,0,0,-8700
11841,100,-2800,1000,7200,0,5500
11842,-6600,3700,2700,-7800,0,-8000
11843,3800,8400,2800,11000,0,26000
11844,11300,7300,-900,-11000,0,6700
11845,0,800,-7900,11400,-1200,3100
11846,-3000,-6200,1100,1000,0,-7100
11847,0,4500,1700,2600,-2400,6400
11848,-3800,3700,4000,13000,-950,15950
11849,6200,200,-2900,1400,-2150,2750
11850,0,-3600,13900,9500,-450,19350
11851,100,6600,1000,-2900,1950,6750
11852,200,-9300,2000,9000,-1900,0
11853,0,7600,-3500,-15900,2900,-8900
11854,-3800,800,-5200,12300,750,4850
11855,9000,-6200,2000,13000,-950,16850
11856,100,4600,12100,-13900,1950,4850
11857,-900,6600,-11700,9100,1950,5050
11858,-4800,-6200,3000,-2000,-950,-10950
11859,11200,1600,15600,-700,1950,29650
11860,-4800,6500,1000,-9900,2900,-4300
11861,2100,-600,-3700,8000,0,5800
11862,-2800,-2700,2000,9200,-10200,-4500
11863,-2600,3600,100,13000,0,14100
11864,8400,-3300,-700,-2800,10800,12400
11865,300,-5700,2900,7400,0,4900
11866,-2900,5600,4700,-3800,0,3600
11867,-3600,-6200,1800,-4800,0,-12800
11868,6300,10200,-800,-5600,-2400,7700
11869,8400,2800,3000,14000,0,28200
11870,100,-2700,-800,8000,-950,3650
11871,-5700,16000,2100,-7800,-1200,3400
11872,0,100,-1800,-3900,1950,-3650
11873,0,900,-7000,10000,-1900,2000
11874,-3800,-5300,-1000,-1500,1700,-9900
11875,9200,-12100,5800,-900,1950,3950
11876,-2800,10100,12100,0,-950,18450
11877,0,3800,2000,-14900,2900,-6200
11878,-8600,-800,-400,13400,0,3600
11879,4600,100,-2000,200,0,2900
11880,12400,6500,3700,7200,0,29800
11881,-5800,-2700,2000,3000,0,-3500
11882,5500,6500,1000,3000,0,16000
11883,-3600,100,-2100,-800,0,-6400
11884,-5400,9300,-12800,14000,0,5100
11885,8500,-8300,2100,-3000,0,-700
11886,9300,100,13100,-4800,0,17700
11887,-3000,900,-3300,200,0,-5200
11888,-2800,-2600,-2800,-800,-1200,-10200
11889,11300,3600,13900,-11000,0,17800
11890,-2900,-8400,3800,15000,0,7500
11891,-2900,6600,-1800,3000,-950,3950
11892,100,-6300,2900,-3800,-950,-8050
11893,-3800,10200,-1700,-1700,2900,5900
11894,9000,3700,2900,-11900,1950,5650
11895,-2700,-2600,1100,10000,0,5800
11896,-5700,400,-3800,-400,-1200,-10700
11897,-3600,1100,4900,-1000,0,1400
11898,17500,-2600,100,15200,-1200,29000
11899,-700,6700,-4500,-12000,0,-10500
11900,-2600,-2700,2900,5200,-950,1850
11901,1000,-11300,1800,2200,0,-6300
11902,-3600,3900,-2700,-900,1950,-1350
11903,12400,3800,-9300,-5600,-950,350
11904,-3000,-9100,3900,11100,2900,5800
11905,-2900,4500,3100,1000,0,5700
11906,-3600,800,-3300,9000,0,2900
11907,9000,-11800,16900,4200,-1200,17100
11908,-8600,7500,1200,4000,0,4100
11909,11200,3700,14000,-13000,0,15900
11910,0,-6400,800,12200,0,6600
11911,-3000,4500,3800,3200,-1200,7300
11912,100,9200,-10000,-3000,0,-3700
11913,-900,100,-900,12000,-950,9350
11914,200,9200,10100,-12000,0,7500
11915,1000,6500,2900,-6700,1950,5650
11916,0,-5800,100,3000,-950,-3650
11917,0,-5600,1000,8100,2900,6400
11918,-700,9400,-7100,-8400,-1200,-8000
11919,-3700,-5500,3900,8200,0,2900
11920,13100,-6100,-2900,-800,0,3300
11921,0,7300,1100,-3800,0,4600
11922,-3000,1000,3000,5000,0,6000
11923,-2800,-6200,1800,-800,0,-8000
11924,0,4500,200,1000,0,5700
11925,-6600,3600,8500,-11800,0,-6300
11926,9100,-3400,-900,13000,0,17800
11927,-2800,4600,900,-10800,0,-8100
11928,-3700,-6200,-2900,15200,0,2400
11929,12200,-1100,1000,-10000,0,2100
11930,-3700,-700,-2900,13200,0,5900
11931,1200,1800,3900,-16800,0,-9900
11932,100,800,-8300,11200,0,3800
11933,-6600,-3300,3000,-2800,0,-9700
11934,9000,1900,13200,3000,0,27100
11935,-3700,-3400,-2800,-600,-1200,-11700
11936,6400,-6100,2700,12400,0,15400
11937,0,10600,4800,-8000,-950,6450
11938,0,3800,3900,-3800,0,3900
11939,-6600,6600,-12200,11500,1950,1250
11940,9100,-8300,2000,-1900,1950,2850
11941,0,-9000,3000,10000,0,4000
11942,0,-9200,13800,-400,-1200,3000
11943,-6600,22300,-700,200,0,15200
11944,12000,800,-3600,-3600,0,5600
11945,0,-8400,-1900,14200,0,3900
11946,-3000,900,-4300,2000,0,-4400
11947,-4500,6500,11800,1200,0,15000
11948,10200,-3600,1000,0,0,7600
11949,-2800,7500,-1700,13000,0,16000
11950,-2800,6500,2000,-10000,0,-4300
11951,5400,-6200,15000,12000,0,26200
11952,0,4700,200,-11000,0,-6100
11953,-3600,-9100,0,15200,0,2500
11954,11100,-12000,1200,13200,-1200,12300
11955,-1800,6500,2000,-1000,0,5700
11956,0,1000,1800,2200,-950,4050
11957,-5800,5800,3900,1000,0,4900
11958,10300,4500,2900,-3900,1950,15750
11959,-1700,3900,-1000,-10800,0,-9600
11960,3100,-6300,1100,4100,1950,3950
11961,0,4600,2000,-8800,-1200,-3400
11962,0,-3500,-800,10000,0,5700
11963,-3600,-600,1000,8200,0,5000
11964,-2900,6800,-3500,2000,0,2400
11965,-2200,-6400,2500,7200,0,1100
11966,12000,-3400,200,-2800,0,6000
11967,200,3600,200,9200,0,13200
11968,100,-11800,5800,-3600,-2400,-11900
11969,-6600,6600,3000,21400,-10200,14200
11970,1300,600,-10100,1000,-950,-8150
11971,-900,5800,200,-3000,12000,14100
11972,-5400,-5400,15100,-4700,1950,1550
11973,9100,15800,1800,-12600,-950,13150
11974,-2800,-3300,200,-4900,2900,-7900
11975,5400,-8100,4000,15000,0,16300
11976,-2900,15600,1900,-9000,0,5600
11977,7600,6400,1000,-2000,0,13000
11978,1000,-200,2600,4200,0,7600
11979,-3000,10000,1900,1200,0,10100
11980,100,9400,-1800,-13000,0,-5300
11981,0,-700,-2700,12000,0,8600
11982,-2900,1700,4500,1400,0,4700
11983,-4400,9200,100,-14000,0,-9100
11984,13200,-6200,-3900,13200,0,16300
11985,-5800,7400,1100,-8000,0,-5300
11986,11200,3700,2000,0,0,16900
11987,-2900,-9100,3000,2000,0,-7000
11988,-2900,10000,-900,200,0,6400
11989,0,3700,4800,-13600,-1200,-6300
11990,-4700,0,2800,12400,-1200,9300
11991,12100,9200,0,-12800,-2150,6350
11992,1000,-2900,-1800,14400,-2400,8300
11993,-3800,-5600,3800,-4900,1000,-9500
11994,1000,0,-3300,12400,-950,9150
11995,-3000,3800,1100,2100,2900,6900
11996,-3000,-5600,3800,-1900,1000,-5700
11997,-500,-500,-3700,6100,1950,3350
11998,9200,7000,1000,-8000,0,9200
11999,-3000,-8300,3900,10100,1950,4650
12000,-900,-700,-900,-3000,-950,-6450
12001,1000,4400,-1700,2300,1700,7700
12002,-2800,-3400,2000,-3000,0,-7200
12003,8700,10100,-3800,2400,-2400,15000
12004,-2900,-2700,1100,-2800,0,-7300
12005,0,-11000,6700,11200,-2150,4750
12006,-3800,3700,2000,-9000,0,-7100
12007,9200,6600,-100,-500,-200,15000
12008,0,-2600,-1700,8000,-950,2750
12009,0,3800,600,-15100,1700,-9000
12010,-6500,-3100,-3400,10100,1950,-950
12011,6700,-2600,3900,-6800,-1900,-700
12012,-6400,-5400,4900,7100,2900,3100
12013,9000,12800,4800,-9500,-450,16650
12014,-6600,-700,-200,13200,-950,4750
12015,9200,7200,2900,-14900,2900,7300
12016,-3600,0,-1000,13000,-950,7450
12017,12100,6300,-3700,-10900,1950,5750
12018,-2800,-2600,3900,8200,-950,5750
12019,-2800,-5600,1100,-2900,2900,-7300
12020,-6600,-3400,-1000,14400,-1200,2200
12021,11300,-8200,2900,-2000,0,4000
12022,1000,8300,-4800,14200,0,18700
12023,-3000,4500,4800,1200,0,7500
12024,0,3700,4800,-14600,-1200,-7300
12025,-3600,-3600,2900,12000,0,7700
12026,6400,400,-3600,-1000,0,2200
12027,100,-5500,-200,11400,-2150,3650
12028,-3500,5800,2100,-3000,-950,450
12029,6400,7000,2000,2300,750,18450
12030,0,3700,-6200,-3900,2900,-3500
12031,-3000,300,-3600,14000,-950,6750
12032,5500,3800,-6300,10600,-2150,11450
12033,0,-5200,9200,-4700,2900,2200
12034,-4400,-2800,1700,7300,1950,3750
12035,13100,3600,14000,-14000,0,16700
12036,-2800,-800,4700,8200,0,9300
12037,100,10100,-900,-12000,0,-2700
12038,-5800,0,1000,14000,0,9200
12039,5400,200,100,14000,0,19700
12040,-3500,-2700,1000,-800,-1200,-7200
12041,9000,-5500,2000,14000,0,19500
12042,-3000,100,-900,0,-950,-4750
12043,0,6700,-1700,1200,-1200,5000
12044,-3600,-2500,-1600,-1000,-950,-9650
12045,12000,-8900,4900,3300,2900,14200
12046,-2700,7200,-15400,3500,1950,-5450
12047,0,6300,-900,1000,0,6400
12048,0,-8500,14000,2200,-1200,6500
12049,100,-800,-1900,11000,0,8400
12050,-2900,-5300,1100,-2000,-950,-10050
12051,0,600,14900,3400,-3350,15550
12052,200,12200,-2800,-3700,1700,7600
12053,100,6400,0,-1900,1950,6550
12054,200,-8300,1100,-4000,-950,-11950
12055,-3600,-3500,1100,8300,1950,4250
12056,9000,7300,2000,-11600,-2150,4550
12057,200,3800,-10800,5100,2900,1200
12058,-3000,-8200,3900,15000,0,7700
12059,-7500,9400,10300,-9000,-950,2250
12060,10000,-6000,-800,13000,-950,15250
12061,100,-5500,2900,-6700,2900,-6300
12062,0,-2700,1100,5300,1950,5650
12063,-2800,5800,-700,0,0,2300
12064,8500,-6200,2000,11000,0,15300
12065,-9400,10300,200,-7000,0,-5900
12066,6200,18500,-7900,10200,0,27000
12067,-600,-2800,3700,6400,0,6700
12068,8200,-5400,12200,-1000,0,14000
12069,-1800,-5400,5800,6200,0,4800
12070,-800,9400,-3900,-10800,0,-6100
12071,-5600,6600,1800,8800,-11400,200
12072,9300,-5500,2900,-2000,0,4700
12073,-3700,-2300,-5400,15000,12000,15600
12074,9000,3800,200,-8000,0,5000
12075,-5500,-2600,1100,8000,0,1000
12076,-3700,-11800,2400,3400,0,-9700
12077,6200,-6200,2100,14000,0,16100
12078,-4300,19500,-3800,-800,0,10600
12079,10000,800,5700,-8000,0,8500
12080,100,-8900,1200,10000,0,2400
12081,0,4500,200,-12000,0,-7300
12082,0,700,4800,1200,0,6700
12083,200,-8500,1900,-800,0,-7200
12084,-6400,-3200,0,10200,0,600
12085,5400,-3200,-2500,14000,0,13700
12086,9100,9300,800,-2400,0,16800
12087,-900,-6200,1100,11000,0,5000
12088,-3600,8500,5800,-7600,0,3100
12089,2000,1600,3800,-11800,-1200,-5600
12090,4800,6600,3000,0,0,14400
12091,-1800,8500,1000,11000,-950,17750
12092,-2800,4500,8600,-16600,0,-6300
12093,-1700,9300,-1800,-15900,1950,-8150
12094,13100,-11100,100,20400,-12350,10150
12095,0,-800,-200,6500,2900,8400
12096,0,4400,2000,-10000,0,-3600
12097,-2900,3800,700,1200,12000,14800
12098,0,6500,-10800,-800,-1200,-6300
12099,-3800,-8300,2900,15000,0,5800
12100,1000,700,14900,-10000,-950,5650
12101,100,-3600,0,11000,-950,6550
12102,-3800,7400,-10800,-900,2900,-5200
12103,9000,3800,1100,1300,750,15950
12104,100,-5600,13900,7400,-11400,4400
12105,-5800,6800,-2800,5200,0,3400
12106,2700,-3500,2900,2000,0,4100
12107,-3600,4400,5700,1000,11050,18550
12108,12100,0,-5200,12400,-950,18350
12109,0,1000,3000,-15900,2900,-9000
12110,-2800,-8300,3000,12300,750,4950
12111,100,-6200,1100,-2000,0,-7000
12112,200,6500,-12800,11000,0,4900
12113,-3700,-5300,2100,-3000,0,-9900
12114,-2800,12800,4800,2200,-1200,15800
12115,12000,-3500,13000,12200,-1200,32500
12116,-2700,3600,0,-8800,-2150,-10050
12117,0,4700,-10100,11200,-950,4850
12118,-2700,-3400,200,-4900,2900,-7900
12119,11300,7300,12100,-4700,1000,27000
12120,-2800,-5300,2100,-2000,-950,-8950
12121,-2900,-6300,2900,8300,1700,3700
12122,-3000,6400,-8300,7500,1950,4550
12123,-3600,12000,1900,-2000,0,8300
12124,12000,-2900,11100,14000,0,34200
12125,-2800,0,100,-2000,0,-4700
12126,0,-3800,2800,11200,0,10200
12127,-3000,300,-2700,3200,-1200,-3400
12128,11300,6500,1100,-2800,-1200,14900
12129,-2800,-6500,2900,3000,-950,-4350
12130,-4700,10200,-4000,-7800,0,-6300
12131,-1700,0,-800,-5900,1950,-6450
12132,12300,-5500,5700,3300,1950,17750
12133,-2600,-3500,1000,-2800,-1200,-9100
12134,100,4600,1100,-11000,0,-5200
12135,-2800,100,100,11000,-950,7450
12136,200,6500,0,-2000,0,4700
12137,-3800,100,-1800,0,-950,-6450
12138,9300,-5600,1900,9100,1950,16650
12139,0,-5600,3800,-4900,2900,-3800
12140,-2900,9300,-2800,5000,0,8600
12141,100,-6200,100,-2000,0,-8000
12142,-6600,4500,1800,5200,0,4900
12143,11100,-9200,5700,-1000,0,6600
12144,100,10300,-4500,-2000,0,3900
12145,-2000,-6400,1700,14400,-1200,6500
12146,100,6400,-5300,-5800,0,-4600
12147,0,12200,-2700,10000,0,19500
12148,-3700,-5600,2800,1000,0,-5500
12149,11100,-2900,8100,3400,-1200,18500
12150,-1800,6600,2900,-13000,0,-5300
12151,0,-5500,-3500,1000,0,-8000
12152,0,-6300,4600,5600,-950,2950
12153,-700,-2700,1000,-4800,-950,-8150
12154,-2000,9400,-1100,-15300,1700,-7300
12155,0,3600,1200,-4300,1950,2450
12156,-7500,-2800,-7300,23200,0,5600
12157,7200,9200,2000,-12800,0,5600
12158,8300,-2600,0,13000,0,18700
12159,0,-700,10200,10000,0,19500
12160,-5600,4400,3000,-6800,-1200,-6200
12161,-800,-8200,3000,11000,0,5000
12162,9300,9400,-11700,-1800,-1200,4000
12163,0,-2700,-800,11200,-950,6750
12164,-3000,-8900,2100,1000,-950,-9750
12165,0,-2600,9400,-3900,2900,5800
12166,-10200,18500,5700,-2700,1950,13250
